job_id,workload_name,profile,submission_time,requested_number_of_resources,requested_time,success,final_state,starting_time,execution_time,finish_time,waiting_time,turnaround_time,stretch,allocated_resources,consumed_energy
1,w0,100,10,5,154,0,COMPLETED_WALLTIME_REACHED,10,154,164,0,154,1.0,0 1 2 3 4,-1
2,w0,100,11,3,147,0,COMPLETED_WALLTIME_REACHED,11,147,158,0,147,1.0,5 6 7,-1
3,w0,100,12,4,147,0,COMPLETED_WALLTIME_REACHED,12,147,159,0,147,1.0,8 9 10 11,-1
4,w0,100,19,4,150,0,COMPLETED_WALLTIME_REACHED,19,150,169,0,150,1.0,12 13 14 15,-1
5,w0,100,23,6,147,0,COMPLETED_WALLTIME_REACHED,159,147,306,136,283,1.9251700680272108,5 6 7 8 9 10,-1
6,w0,100,41,3,151,0,COMPLETED_WALLTIME_REACHED,164,151,315,123,274,1.814569536423841,0 1 2,-1
7,w0,100,52,3,158,0,COMPLETED_WALLTIME_REACHED,164,158,322,112,270,1.7088607594936709,3 4 11,-1
11,w0,100,77,4,149,0,COMPLETED_WALLTIME_REACHED,169,149,318,92,241,1.6174496644295302,12 13 14 15,-1
8,w0,100,63,5,147,0,COMPLETED_WALLTIME_REACHED,306,147,453,243,390,2.6530612244897958,5 6 7 8 9,-1
24,w0,100,116,2,149,0,COMPLETED_WALLTIME_REACHED,315,149,464,199,348,2.335570469798658,0 1,-1
9,w0,100,64,6,153,0,COMPLETED_WALLTIME_REACHED,318,153,471,254,407,2.6601307189542482,2 10 12 13 14 15,-1
21,w0,100,111,3,149,0,COMPLETED_WALLTIME_REACHED,322,149,471,211,360,2.4161073825503356,3 4 11,-1
10,w0,100,67,5,150,0,COMPLETED_WALLTIME_REACHED,453,150,603,386,536,3.5733333333333333,5 6 7 8 9,-1
71,w0,100,292,2,147,0,COMPLETED_WALLTIME_REACHED,464,147,611,172,319,2.1700680272108843,0 1,-1
12,w0,100,78,4,148,0,COMPLETED_WALLTIME_REACHED,471,148,619,393,541,3.6554054054054053,2 3 4 10,-1
13,w0,100,79,4,149,0,COMPLETED_WALLTIME_REACHED,471,149,620,392,541,3.6308724832214767,11 12 13 14,-1
14,w0,100,79,5,150,0,COMPLETED_WALLTIME_REACHED,603,150,753,524,674,4.493333333333333,5 6 7 8 9,-1
15,w0,100,88,6,152,0,COMPLETED_WALLTIME_REACHED,619,152,771,531,683,4.493421052631579,0 1 2 3 4 10,-1
16,w0,100,98,5,150,0,COMPLETED_WALLTIME_REACHED,620,150,770,522,672,4.48,11 12 13 14 15,-1
17,w0,100,99,5,151,0,COMPLETED_WALLTIME_REACHED,753,151,904,654,805,5.33112582781457,5 6 7 8 9,-1
18,w0,100,100,4,151,0,COMPLETED_WALLTIME_REACHED,770,151,921,670,821,5.437086092715232,11 12 13 14,-1
19,w0,100,108,5,152,0,COMPLETED_WALLTIME_REACHED,771,152,923,663,815,5.3618421052631575,0 1 2 3 4,-1
20,w0,100,110,5,148,0,COMPLETED_WALLTIME_REACHED,904,148,1052,794,942,6.364864864864865,5 6 7 8 9,-1
22,w0,100,112,6,150,0,COMPLETED_WALLTIME_REACHED,921,150,1071,809,959,6.3933333333333335,10 11 12 13 14 15,-1
25,w0,100,118,4,147,0,COMPLETED_WALLTIME_REACHED,923,147,1070,805,952,6.476190476190476,0 1 2 3,-1
23,w0,100,114,6,152,0,COMPLETED_WALLTIME_REACHED,1052,152,1204,938,1090,7.171052631578948,4 5 6 7 8 9,-1
26,w0,100,120,4,150,0,COMPLETED_WALLTIME_REACHED,1070,150,1220,950,1100,7.333333333333333,0 1 2 3,-1
27,w0,100,122,3,150,0,COMPLETED_WALLTIME_REACHED,1071,150,1221,949,1099,7.326666666666667,10 11 12,-1
32,w0,100,135,3,151,0,COMPLETED_WALLTIME_REACHED,1071,151,1222,936,1087,7.198675496688741,13 14 15,-1
28,w0,100,124,5,150,0,COMPLETED_WALLTIME_REACHED,1204,150,1354,1080,1230,8.2,4 5 6 7 8,-1
29,w0,100,131,5,146,0,COMPLETED_WALLTIME_REACHED,1220,146,1366,1089,1235,8.45890410958904,0 1 2 3 9,-1
231,w0,100,1114,2,153,0,COMPLETED_WALLTIME_REACHED,1221,153,1374,107,260,1.6993464052287581,10 11,-1
30,w0,100,133,4,148,0,COMPLETED_WALLTIME_REACHED,1222,148,1370,1089,1237,8.358108108108109,12 13 14 15,-1
31,w0,100,134,5,150,0,COMPLETED_WALLTIME_REACHED,1354,150,1504,1220,1370,9.133333333333333,4 5 6 7 8,-1
38,w0,100,154,3,152,0,COMPLETED_WALLTIME_REACHED,1366,152,1518,1212,1364,8.973684210526315,0 1 2,-1
33,w0,100,136,6,151,0,COMPLETED_WALLTIME_REACHED,1370,151,1521,1234,1385,9.172185430463577,3 9 12 13 14 15,-1
251,w0,100,1205,2,151,0,COMPLETED_WALLTIME_REACHED,1374,151,1525,169,320,2.119205298013245,10 11,-1
34,w0,100,141,4,147,0,COMPLETED_WALLTIME_REACHED,1504,147,1651,1363,1510,10.272108843537415,4 5 6 7,-1
39,w0,100,154,3,150,0,COMPLETED_WALLTIME_REACHED,1518,150,1668,1364,1514,10.093333333333334,0 1 2,-1
35,w0,100,145,5,150,0,COMPLETED_WALLTIME_REACHED,1521,150,1671,1376,1526,10.173333333333334,3 8 9 12 13,-1
256,w0,100,1221,2,152,0,COMPLETED_WALLTIME_REACHED,1521,152,1673,300,452,2.973684210526316,14 15,-1
36,w0,100,148,5,152,0,COMPLETED_WALLTIME_REACHED,1651,152,1803,1503,1655,10.888157894736842,4 5 6 7 10,-1
55,w0,100,235,3,153,0,COMPLETED_WALLTIME_REACHED,1668,153,1821,1433,1586,10.366013071895425,0 1 2,-1
37,w0,100,148,6,151,0,COMPLETED_WALLTIME_REACHED,1671,151,1822,1523,1674,11.086092715231787,3 8 9 11 12 13,-1
273,w0,100,1320,2,149,0,COMPLETED_WALLTIME_REACHED,1673,149,1822,353,502,3.3691275167785233,14 15,-1
40,w0,100,155,4,150,0,COMPLETED_WALLTIME_REACHED,1803,150,1953,1648,1798,11.986666666666666,4 5 6 7,-1
41,w0,100,160,4,149,0,COMPLETED_WALLTIME_REACHED,1821,149,1970,1661,1810,12.14765100671141,0 1 2 10,-1
42,w0,100,162,4,153,0,COMPLETED_WALLTIME_REACHED,1822,153,1975,1660,1813,11.84967320261438,3 8 9 11,-1
43,w0,100,166,4,153,0,COMPLETED_WALLTIME_REACHED,1822,153,1975,1656,1809,11.823529411764707,12 13 14 15,-1
56,w0,100,237,3,150,0,COMPLETED_WALLTIME_REACHED,1953,150,2103,1716,1866,12.44,4 5 6,-1
44,w0,100,170,5,147,0,COMPLETED_WALLTIME_REACHED,1970,147,2117,1800,1947,13.244897959183673,0 1 2 7 10,-1
45,w0,100,172,5,152,0,COMPLETED_WALLTIME_REACHED,1975,152,2127,1803,1955,12.861842105263158,3 8 9 11 12,-1
286,w0,100,1378,2,151,0,COMPLETED_WALLTIME_REACHED,1975,151,2126,597,748,4.953642384105961,13 14,-1
46,w0,100,183,4,152,0,COMPLETED_WALLTIME_REACHED,2103,152,2255,1920,2072,13.631578947368421,4 5 6 15,-1
47,w0,100,189,5,147,0,COMPLETED_WALLTIME_REACHED,2117,147,2264,1928,2075,14.115646258503402,0 1 2 7 10,-1
296,w0,100,1411,2,153,0,COMPLETED_WALLTIME_REACHED,2126,153,2279,715,868,5.673202614379085,13 14,-1
48,w0,100,192,5,152,0,COMPLETED_WALLTIME_REACHED,2127,152,2279,1935,2087,13.730263157894736,3 8 9 11 12,-1
51,w0,100,216,4,150,0,COMPLETED_WALLTIME_REACHED,2255,150,2405,2039,2189,14.593333333333334,4 5 6 15,-1
49,w0,100,193,5,149,0,COMPLETED_WALLTIME_REACHED,2264,149,2413,2071,2220,14.899328859060402,0 1 2 7 10,-1
50,w0,100,202,5,151,0,COMPLETED_WALLTIME_REACHED,2279,151,2430,2077,2228,14.754966887417218,3 8 9 11 12,-1
52,w0,100,220,5,150,0,COMPLETED_WALLTIME_REACHED,2405,150,2555,2185,2335,15.566666666666666,4 5 6 13 14,-1
53,w0,100,223,4,153,0,COMPLETED_WALLTIME_REACHED,2413,153,2566,2190,2343,15.313725490196079,0 1 2 7,-1
384,w0,100,1812,2,147,0,COMPLETED_WALLTIME_REACHED,2413,147,2560,601,748,5.08843537414966,10 15,-1
54,w0,100,225,4,152,0,COMPLETED_WALLTIME_REACHED,2430,152,2582,2205,2357,15.506578947368421,3 8 9 11,-1
57,w0,100,241,5,151,0,COMPLETED_WALLTIME_REACHED,2555,151,2706,2314,2465,16.32450331125828,4 5 6 12 13,-1
58,w0,100,242,3,152,0,COMPLETED_WALLTIME_REACHED,2560,152,2712,2318,2470,16.25,10 14 15,-1
59,w0,100,243,4,148,0,COMPLETED_WALLTIME_REACHED,2566,148,2714,2323,2471,16.695945945945947,0 1 2 7,-1
60,w0,100,244,4,149,0,COMPLETED_WALLTIME_REACHED,2582,149,2731,2338,2487,16.691275167785236,3 8 9 11,-1
61,w0,100,253,4,150,0,COMPLETED_WALLTIME_REACHED,2706,150,2856,2453,2603,17.35333333333333,4 5 6 12,-1
389,w0,100,1857,2,151,0,COMPLETED_WALLTIME_REACHED,2712,151,2863,855,1006,6.662251655629139,10 13,-1
62,w0,100,254,6,153,0,COMPLETED_WALLTIME_REACHED,2714,153,2867,2460,2613,17.07843137254902,0 1 2 7 14 15,-1
449,w0,100,2160,2,148,0,COMPLETED_WALLTIME_REACHED,2731,148,2879,571,719,4.858108108108108,3 8,-1
63,w0,100,274,6,146,0,COMPLETED_WALLTIME_REACHED,2856,146,3002,2582,2728,18.684931506849313,4 5 6 9 11 12,-1
454,w0,100,2201,2,151,0,COMPLETED_WALLTIME_REACHED,2863,151,3014,662,813,5.3841059602649,10 13,-1
64,w0,100,276,6,150,0,COMPLETED_WALLTIME_REACHED,2867,150,3017,2591,2741,18.273333333333333,0 1 2 7 14 15,-1
536,w0,100,2602,2,148,0,COMPLETED_WALLTIME_REACHED,2879,148,3027,277,425,2.8716216216216215,3 8,-1
65,w0,100,277,4,152,0,COMPLETED_WALLTIME_REACHED,3002,152,3154,2725,2877,18.92763157894737,4 5 6 9,-1
67,w0,100,283,4,152,0,COMPLETED_WALLTIME_REACHED,3014,152,3166,2731,2883,18.967105263157894,10 11 12 13,-1
66,w0,100,279,5,151,0,COMPLETED_WALLTIME_REACHED,3017,151,3168,2738,2889,19.132450331125828,0 1 2 7 14,-1
68,w0,100,283,6,152,0,COMPLETED_WALLTIME_REACHED,3154,152,3306,2871,3023,19.888157894736842,3 4 5 6 8 9,-1
69,w0,100,285,4,150,0,COMPLETED_WALLTIME_REACHED,3166,150,3316,2881,3031,20.206666666666667,10 11 12 13,-1
70,w0,100,291,6,147,0,COMPLETED_WALLTIME_REACHED,3168,147,3315,2877,3024,20.571428571428573,0 1 2 7 14 15,-1
72,w0,100,310,4,151,0,COMPLETED_WALLTIME_REACHED,3306,151,3457,2996,3147,20.841059602649008,3 4 5 6,-1
664,w0,100,3144,2,148,0,COMPLETED_WALLTIME_REACHED,3306,148,3454,162,310,2.0945945945945947,8 9,-1
73,w0,100,325,5,150,0,COMPLETED_WALLTIME_REACHED,3315,150,3465,2990,3140,20.933333333333334,0 1 2 7 14,-1
74,w0,100,334,5,152,0,COMPLETED_WALLTIME_REACHED,3316,152,3468,2982,3134,20.61842105263158,10 11 12 13 15,-1
75,w0,100,336,6,156,0,COMPLETED_WALLTIME_REACHED,3457,156,3613,3121,3277,21.006410256410255,3 4 5 6 8 9,-1
76,w0,100,340,5,149,0,COMPLETED_WALLTIME_REACHED,3465,149,3614,3125,3274,21.973154362416107,0 1 2 7 14,-1
77,w0,100,345,5,149,0,COMPLETED_WALLTIME_REACHED,3468,149,3617,3123,3272,21.959731543624162,10 11 12 13 15,-1
78,w0,100,353,6,147,0,COMPLETED_WALLTIME_REACHED,3613,147,3760,3260,3407,23.17687074829932,3 4 5 6 8 9,-1
79,w0,100,353,4,150,0,COMPLETED_WALLTIME_REACHED,3614,150,3764,3261,3411,22.74,0 1 2 7,-1
690,w0,100,3231,1,152,0,COMPLETED_WALLTIME_REACHED,3614,152,3766,383,535,3.5197368421052633,14,-1
80,w0,100,355,4,152,0,COMPLETED_WALLTIME_REACHED,3617,152,3769,3262,3414,22.460526315789473,10 11 12 13,-1
81,w0,100,357,5,147,0,COMPLETED_WALLTIME_REACHED,3760,147,3907,3403,3550,24.14965986394558,3 4 5 6 8,-1
677,w0,100,3176,2,147,0,COMPLETED_WALLTIME_REACHED,3760,147,3907,584,731,4.9727891156462585,9 15,-1
82,w0,100,373,3,150,0,COMPLETED_WALLTIME_REACHED,3764,150,3914,3391,3541,23.606666666666666,0 1 2,-1
83,w0,100,381,5,150,0,COMPLETED_WALLTIME_REACHED,3769,150,3919,3388,3538,23.586666666666666,7 10 11 12 13,-1
84,w0,100,382,4,150,0,COMPLETED_WALLTIME_REACHED,3907,150,4057,3525,3675,24.5,3 4 5 6,-1
682,w0,100,3191,2,151,0,COMPLETED_WALLTIME_REACHED,3907,151,4058,716,867,5.741721854304636,8 9,-1
85,w0,100,387,5,149,0,COMPLETED_WALLTIME_REACHED,3914,149,4063,3527,3676,24.671140939597315,0 1 2 14 15,-1
86,w0,100,388,3,152,0,COMPLETED_WALLTIME_REACHED,3919,152,4071,3531,3683,24.230263157894736,7 10 11,-1
87,w0,100,390,7,148,0,COMPLETED_WALLTIME_REACHED,4058,148,4206,3668,3816,25.783783783783782,3 4 5 6 8 9 12,-1
88,w0,100,394,4,150,0,COMPLETED_WALLTIME_REACHED,4063,150,4213,3669,3819,25.46,0 1 2 13,-1
805,w0,100,3831,2,148,0,COMPLETED_WALLTIME_REACHED,4063,148,4211,232,380,2.5675675675675675,14 15,-1
89,w0,100,397,3,152,0,COMPLETED_WALLTIME_REACHED,4071,152,4223,3674,3826,25.17105263157895,7 10 11,-1
90,w0,100,401,5,149,0,COMPLETED_WALLTIME_REACHED,4206,149,4355,3805,3954,26.536912751677853,3 4 5 6 8,-1
806,w0,100,3836,2,147,0,COMPLETED_WALLTIME_REACHED,4206,147,4353,370,517,3.5170068027210886,9 12,-1
91,w0,100,407,5,149,0,COMPLETED_WALLTIME_REACHED,4213,149,4362,3806,3955,26.543624161073826,0 1 2 13 14,-1
92,w0,100,407,6,151,0,COMPLETED_WALLTIME_REACHED,4353,151,4504,3946,4097,27.132450331125828,7 9 10 11 12 15,-1
93,w0,100,411,4,148,0,COMPLETED_WALLTIME_REACHED,4355,148,4503,3944,4092,27.64864864864865,3 4 5 6,-1
94,w0,100,417,5,152,0,COMPLETED_WALLTIME_REACHED,4362,152,4514,3945,4097,26.95394736842105,0 1 2 8 13,-1
95,w0,100,418,5,150,0,COMPLETED_WALLTIME_REACHED,4503,150,4653,4085,4235,28.233333333333334,3 4 5 6 14,-1
96,w0,100,429,6,149,0,COMPLETED_WALLTIME_REACHED,4504,149,4653,4075,4224,28.348993288590606,7 9 10 11 12 15,-1
97,w0,100,431,5,152,0,COMPLETED_WALLTIME_REACHED,4514,152,4666,4083,4235,27.861842105263158,0 1 2 8 13,-1
98,w0,100,433,4,148,0,COMPLETED_WALLTIME_REACHED,4653,148,4801,4220,4368,29.513513513513512,3 4 5 6,-1
99,w0,100,436,5,150,0,COMPLETED_WALLTIME_REACHED,4653,150,4803,4217,4367,29.113333333333333,7 9 10 11 12,-1
849,w0,100,4074,2,149,0,COMPLETED_WALLTIME_REACHED,4653,149,4802,579,728,4.885906040268456,14 15,-1
100,w0,100,443,5,150,0,COMPLETED_WALLTIME_REACHED,4666,150,4816,4223,4373,29.153333333333332,0 1 2 8 13,-1
101,w0,100,452,6,145,0,COMPLETED_WALLTIME_REACHED,4802,145,4947,4350,4495,31.0,3 4 5 6 14 15,-1
111,w0,100,500,3,150,0,COMPLETED_WALLTIME_REACHED,4803,150,4953,4303,4453,29.686666666666667,7 9 10,-1
102,w0,100,453,7,152,0,COMPLETED_WALLTIME_REACHED,4816,152,4968,4363,4515,29.70394736842105,0 1 2 8 11 12 13,-1
103,w0,100,454,5,150,0,COMPLETED_WALLTIME_REACHED,4947,150,5097,4493,4643,30.953333333333333,3 4 5 6 14,-1
104,w0,100,469,4,150,0,COMPLETED_WALLTIME_REACHED,4953,150,5103,4484,4634,30.893333333333334,7 9 10 15,-1
105,w0,100,476,7,151,0,COMPLETED_WALLTIME_REACHED,4968,151,5119,4492,4643,30.748344370860927,0 1 2 8 11 12 13,-1
106,w0,100,481,4,148,0,COMPLETED_WALLTIME_REACHED,5097,148,5245,4616,4764,32.189189189189186,3 4 5 6,-1
107,w0,100,486,5,149,0,COMPLETED_WALLTIME_REACHED,5103,149,5252,4617,4766,31.986577181208055,7 9 10 14 15,-1
108,w0,100,491,4,149,0,COMPLETED_WALLTIME_REACHED,5119,149,5268,4628,4777,32.060402684563755,0 1 2 8,-1
882,w0,100,4333,2,147,0,COMPLETED_WALLTIME_REACHED,5119,147,5266,786,933,6.346938775510204,11 12,-1
109,w0,100,493,5,147,0,COMPLETED_WALLTIME_REACHED,5245,147,5392,4752,4899,33.326530612244895,3 4 5 6 13,-1
110,w0,100,495,6,149,0,COMPLETED_WALLTIME_REACHED,5266,149,5415,4771,4920,33.02013422818792,7 9 10 11 12 14,-1
113,w0,100,506,4,147,0,COMPLETED_WALLTIME_REACHED,5268,147,5415,4762,4909,33.394557823129254,0 1 2 8,-1
112,w0,100,503,6,149,0,COMPLETED_WALLTIME_REACHED,5392,149,5541,4889,5038,33.81208053691275,3 4 5 6 13 15,-1
114,w0,100,507,5,151,0,COMPLETED_WALLTIME_REACHED,5415,151,5566,4908,5059,33.503311258278146,0 1 2 7 8,-1
115,w0,100,508,4,147,0,COMPLETED_WALLTIME_REACHED,5415,147,5562,4907,5054,34.38095238095238,9 10 11 12,-1
116,w0,100,516,4,147,0,COMPLETED_WALLTIME_REACHED,5541,147,5688,5025,5172,35.183673469387756,3 4 5 6,-1
129,w0,100,612,3,152,0,COMPLETED_WALLTIME_REACHED,5541,152,5693,4929,5081,33.42763157894737,13 14 15,-1
117,w0,100,519,4,152,0,COMPLETED_WALLTIME_REACHED,5562,152,5714,5043,5195,34.17763157894737,9 10 11 12,-1
118,w0,100,527,4,150,0,COMPLETED_WALLTIME_REACHED,5566,150,5716,5039,5189,34.593333333333334,0 1 2 7,-1
119,w0,100,527,4,150,0,COMPLETED_WALLTIME_REACHED,5688,150,5838,5161,5311,35.406666666666666,3 4 5 6,-1
120,w0,100,530,4,148,0,COMPLETED_WALLTIME_REACHED,5693,148,5841,5163,5311,35.88513513513514,8 13 14 15,-1
121,w0,100,532,4,149,0,COMPLETED_WALLTIME_REACHED,5714,149,5863,5182,5331,35.77852348993289,9 10 11 12,-1
122,w0,100,533,4,149,0,COMPLETED_WALLTIME_REACHED,5716,149,5865,5183,5332,35.785234899328856,0 1 2 7,-1
131,w0,100,618,3,148,0,COMPLETED_WALLTIME_REACHED,5838,148,5986,5220,5368,36.270270270270274,3 4 5,-1
123,w0,100,536,5,150,0,COMPLETED_WALLTIME_REACHED,5841,150,5991,5305,5455,36.36666666666667,6 8 13 14 15,-1
124,w0,100,539,4,149,0,COMPLETED_WALLTIME_REACHED,5863,149,6012,5324,5473,36.73154362416108,9 10 11 12,-1
924,w0,100,4546,2,147,0,COMPLETED_WALLTIME_REACHED,5865,147,6012,1319,1466,9.97278911564626,0 1,-1
125,w0,100,549,5,148,0,COMPLETED_WALLTIME_REACHED,5986,148,6134,5437,5585,37.736486486486484,2 3 4 5 7,-1
126,w0,100,574,5,148,0,COMPLETED_WALLTIME_REACHED,5991,148,6139,5417,5565,37.601351351351354,6 8 13 14 15,-1
127,w0,100,595,4,148,0,COMPLETED_WALLTIME_REACHED,6012,148,6160,5417,5565,37.601351351351354,0 1 9 10,-1
128,w0,100,604,5,151,0,COMPLETED_WALLTIME_REACHED,6134,151,6285,5530,5681,37.62251655629139,2 3 4 5 7,-1
130,w0,100,615,5,147,0,COMPLETED_WALLTIME_REACHED,6139,147,6286,5524,5671,38.57823129251701,6 8 11 12 13,-1
132,w0,100,620,3,154,0,COMPLETED_WALLTIME_REACHED,6160,154,6314,5540,5694,36.97402597402598,0 1 9,-1
133,w0,100,622,6,152,0,COMPLETED_WALLTIME_REACHED,6285,152,6437,5663,5815,38.25657894736842,2 3 4 5 7 10,-1
134,w0,100,622,4,150,0,COMPLETED_WALLTIME_REACHED,6286,150,6436,5664,5814,38.76,6 8 11 12,-1
135,w0,100,624,5,146,0,COMPLETED_WALLTIME_REACHED,6314,146,6460,5690,5836,39.97260273972603,0 1 9 13 14,-1
136,w0,100,632,5,152,0,COMPLETED_WALLTIME_REACHED,6436,152,6588,5804,5956,39.18421052631579,6 8 11 12 15,-1
137,w0,100,641,4,148,0,COMPLETED_WALLTIME_REACHED,6437,148,6585,5796,5944,40.16216216216216,2 3 4 5,-1
138,w0,100,645,6,150,0,COMPLETED_WALLTIME_REACHED,6460,150,6610,5815,5965,39.766666666666666,0 1 7 9 10 13,-1
139,w0,100,650,4,149,0,COMPLETED_WALLTIME_REACHED,6585,149,6734,5935,6084,40.83221476510067,2 3 4 5,-1
140,w0,100,652,5,149,0,COMPLETED_WALLTIME_REACHED,6588,149,6737,5936,6085,40.83892617449664,6 8 11 12 14,-1
141,w0,100,655,5,155,0,COMPLETED_WALLTIME_REACHED,6610,155,6765,5955,6110,39.41935483870968,0 1 7 9 10,-1
142,w0,100,655,4,148,0,COMPLETED_WALLTIME_REACHED,6734,148,6882,6079,6227,42.07432432432432,2 3 4 5,-1
143,w0,100,656,5,149,0,COMPLETED_WALLTIME_REACHED,6737,149,6886,6081,6230,41.81208053691275,6 8 11 12 13,-1
144,w0,100,657,4,151,0,COMPLETED_WALLTIME_REACHED,6765,151,6916,6108,6259,41.450331125827816,0 1 7 9,-1
145,w0,100,662,3,149,0,COMPLETED_WALLTIME_REACHED,6765,149,6914,6103,6252,41.95973154362416,10 14 15,-1
147,w0,100,667,4,150,0,COMPLETED_WALLTIME_REACHED,6882,150,7032,6215,6365,42.43333333333333,2 3 4 5,-1
146,w0,100,667,5,147,0,COMPLETED_WALLTIME_REACHED,6886,147,7033,6219,6366,43.30612244897959,6 8 11 12 13,-1
148,w0,100,673,6,151,0,COMPLETED_WALLTIME_REACHED,6916,151,7067,6243,6394,42.34437086092715,0 1 7 9 10 14,-1
149,w0,100,680,5,148,0,COMPLETED_WALLTIME_REACHED,7032,148,7180,6352,6500,43.91891891891892,2 3 4 5 15,-1
150,w0,100,683,5,150,0,COMPLETED_WALLTIME_REACHED,7033,150,7183,6350,6500,43.333333333333336,6 8 11 12 13,-1
151,w0,100,699,5,152,0,COMPLETED_WALLTIME_REACHED,7067,152,7219,6368,6520,42.89473684210526,0 1 7 9 10,-1
152,w0,100,703,4,151,0,COMPLETED_WALLTIME_REACHED,7180,151,7331,6477,6628,43.89403973509934,2 3 4 5,-1
153,w0,100,708,4,148,0,COMPLETED_WALLTIME_REACHED,7183,148,7331,6475,6623,44.75,6 8 11 12,-1
176,w0,100,864,3,146,0,COMPLETED_WALLTIME_REACHED,7183,146,7329,6319,6465,44.28082191780822,13 14 15,-1
154,w0,100,711,4,149,0,COMPLETED_WALLTIME_REACHED,7219,149,7368,6508,6657,44.67785234899329,0 1 7 9,-1
169,w0,100,820,4,150,0,COMPLETED_WALLTIME_REACHED,7329,150,7479,6509,6659,44.39333333333333,10 13 14 15,-1
155,w0,100,713,5,149,0,COMPLETED_WALLTIME_REACHED,7331,149,7480,6618,6767,45.41610738255034,2 3 4 5 6,-1
156,w0,100,723,5,150,0,COMPLETED_WALLTIME_REACHED,7368,150,7518,6645,6795,45.3,0 1 7 8 9,-1
157,w0,100,728,5,153,0,COMPLETED_WALLTIME_REACHED,7479,153,7632,6751,6904,45.12418300653595,10 11 12 13 14,-1
158,w0,100,741,5,149,0,COMPLETED_WALLTIME_REACHED,7480,149,7629,6739,6888,46.22818791946309,2 3 4 5 6,-1
159,w0,100,744,5,150,0,COMPLETED_WALLTIME_REACHED,7518,150,7668,6774,6924,46.16,0 1 7 8 9,-1
160,w0,100,748,5,151,0,COMPLETED_WALLTIME_REACHED,7629,151,7780,6881,7032,46.56953642384106,2 3 4 5 6,-1
161,w0,100,749,5,151,0,COMPLETED_WALLTIME_REACHED,7632,151,7783,6883,7034,46.58278145695364,10 11 12 13 14,-1
162,w0,100,751,5,150,0,COMPLETED_WALLTIME_REACHED,7668,150,7818,6917,7067,47.11333333333334,0 1 7 8 9,-1
163,w0,100,776,5,148,0,COMPLETED_WALLTIME_REACHED,7780,148,7928,7004,7152,48.32432432432432,2 3 4 5 6,-1
164,w0,100,784,5,150,0,COMPLETED_WALLTIME_REACHED,7783,150,7933,6999,7149,47.66,10 11 12 13 14,-1
165,w0,100,793,5,149,0,COMPLETED_WALLTIME_REACHED,7818,149,7967,7025,7174,48.147651006711406,0 1 7 8 9,-1
166,w0,100,805,5,150,0,COMPLETED_WALLTIME_REACHED,7928,150,8078,7123,7273,48.486666666666665,2 3 4 5 6,-1
167,w0,100,814,6,149,0,COMPLETED_WALLTIME_REACHED,7933,149,8082,7119,7268,48.77852348993289,10 11 12 13 14 15,-1
168,w0,100,816,5,150,0,COMPLETED_WALLTIME_REACHED,7967,150,8117,7151,7301,48.67333333333333,0 1 7 8 9,-1
170,w0,100,835,4,150,0,COMPLETED_WALLTIME_REACHED,8078,150,8228,7243,7393,49.28666666666667,2 3 4 5,-1
171,w0,100,840,5,147,0,COMPLETED_WALLTIME_REACHED,8082,147,8229,7242,7389,50.265306122448976,6 10 11 12 13,-1
172,w0,100,847,5,150,0,COMPLETED_WALLTIME_REACHED,8117,150,8267,7270,7420,49.46666666666667,0 1 7 8 9,-1
173,w0,100,852,4,153,0,COMPLETED_WALLTIME_REACHED,8228,153,8381,7376,7529,49.209150326797385,2 3 4 5,-1
174,w0,100,853,4,152,0,COMPLETED_WALLTIME_REACHED,8229,152,8381,7376,7528,49.526315789473685,6 10 11 12,-1
179,w0,100,869,3,152,0,COMPLETED_WALLTIME_REACHED,8229,152,8381,7360,7512,49.421052631578945,13 14 15,-1
175,w0,100,853,5,151,0,COMPLETED_WALLTIME_REACHED,8267,151,8418,7414,7565,50.09933774834437,0 1 7 8 9,-1
177,w0,100,866,6,149,0,COMPLETED_WALLTIME_REACHED,8381,149,8530,7515,7664,51.43624161073826,2 3 4 5 6 10,-1
178,w0,100,868,5,153,0,COMPLETED_WALLTIME_REACHED,8381,153,8534,7513,7666,50.10457516339869,11 12 13 14 15,-1
181,w0,100,874,3,147,0,COMPLETED_WALLTIME_REACHED,8418,147,8565,7544,7691,52.31972789115646,0 1 7,-1
180,w0,100,872,6,149,0,COMPLETED_WALLTIME_REACHED,8530,149,8679,7658,7807,52.395973154362416,2 3 4 5 6 8,-1
182,w0,100,874,4,151,0,COMPLETED_WALLTIME_REACHED,8534,151,8685,7660,7811,51.728476821192054,9 10 11 12,-1
183,w0,100,894,4,148,0,COMPLETED_WALLTIME_REACHED,8565,148,8713,7671,7819,52.83108108108108,0 1 7 13,-1
184,w0,100,899,3,149,0,COMPLETED_WALLTIME_REACHED,8679,149,8828,7780,7929,53.214765100671144,2 3 4,-1
185,w0,100,905,4,148,0,COMPLETED_WALLTIME_REACHED,8679,148,8827,7774,7922,53.527027027027025,5 6 8 14,-1
186,w0,100,911,4,151,0,COMPLETED_WALLTIME_REACHED,8685,151,8836,7774,7925,52.48344370860927,9 10 11 12,-1
187,w0,100,911,5,151,0,COMPLETED_WALLTIME_REACHED,8713,151,8864,7802,7953,52.66887417218543,0 1 7 13 15,-1
188,w0,100,917,4,149,0,COMPLETED_WALLTIME_REACHED,8827,149,8976,7910,8059,54.08724832214765,5 6 8 14,-1
195,w0,100,960,3,150,0,COMPLETED_WALLTIME_REACHED,8828,150,8978,7868,8018,53.45333333333333,2 3 4,-1
189,w0,100,919,4,151,0,COMPLETED_WALLTIME_REACHED,8836,151,8987,7917,8068,53.43046357615894,9 10 11 12,-1
190,w0,100,921,4,152,0,COMPLETED_WALLTIME_REACHED,8864,152,9016,7943,8095,53.25657894736842,0 1 7 13,-1
191,w0,100,929,5,149,0,COMPLETED_WALLTIME_REACHED,8976,149,9125,8047,8196,55.006711409395976,5 6 8 14 15,-1
202,w0,100,990,3,155,0,COMPLETED_WALLTIME_REACHED,8978,155,9133,7988,8143,52.535483870967745,2 3 4,-1
192,w0,100,933,4,153,0,COMPLETED_WALLTIME_REACHED,8987,153,9140,8054,8207,53.64052287581699,9 10 11 12,-1
193,w0,100,933,4,148,0,COMPLETED_WALLTIME_REACHED,9016,148,9164,8083,8231,55.61486486486486,0 1 7 13,-1
194,w0,100,951,7,148,0,COMPLETED_WALLTIME_REACHED,9133,148,9281,8182,8330,56.28378378378378,2 3 4 5 6 8 14,-1
196,w0,100,965,7,150,0,COMPLETED_WALLTIME_REACHED,9164,150,9314,8199,8349,55.66,0 1 7 9 10 11 12,-1
197,w0,100,968,4,149,0,COMPLETED_WALLTIME_REACHED,9281,149,9430,8313,8462,56.79194630872483,2 3 4 5,-1
199,w0,100,978,5,150,0,COMPLETED_WALLTIME_REACHED,9281,150,9431,8303,8453,56.35333333333333,6 8 13 14 15,-1
198,w0,100,975,6,152,0,COMPLETED_WALLTIME_REACHED,9314,152,9466,8339,8491,55.86184210526316,0 1 7 9 10 11,-1
200,w0,100,988,5,151,0,COMPLETED_WALLTIME_REACHED,9430,151,9581,8442,8593,56.90728476821192,2 3 4 5 12,-1
201,w0,100,989,5,151,0,COMPLETED_WALLTIME_REACHED,9431,151,9582,8442,8593,56.90728476821192,6 8 13 14 15,-1
203,w0,100,991,5,150,0,COMPLETED_WALLTIME_REACHED,9466,150,9616,8475,8625,57.5,0 1 7 9 10,-1
204,w0,100,995,4,148,0,COMPLETED_WALLTIME_REACHED,9581,148,9729,8586,8734,59.013513513513516,2 3 4 5,-1
205,w0,100,997,3,149,0,COMPLETED_WALLTIME_REACHED,9582,149,9731,8585,8734,58.61744966442953,6 8 11,-1
208,w0,100,1031,3,150,0,COMPLETED_WALLTIME_REACHED,9582,150,9732,8551,8701,58.00666666666667,12 13 14,-1
206,w0,100,1010,5,150,0,COMPLETED_WALLTIME_REACHED,9616,150,9766,8606,8756,58.373333333333335,0 1 7 9 10,-1
207,w0,100,1030,6,149,0,COMPLETED_WALLTIME_REACHED,9731,149,9880,8701,8850,59.395973154362416,2 3 4 5 6 8,-1
209,w0,100,1038,5,149,0,COMPLETED_WALLTIME_REACHED,9732,149,9881,8694,8843,59.348993288590606,11 12 13 14 15,-1
210,w0,100,1039,4,154,0,COMPLETED_WALLTIME_REACHED,9766,154,9920,8727,8881,57.66883116883117,0 1 7 9,-1
211,w0,100,1041,4,150,0,COMPLETED_WALLTIME_REACHED,9880,150,10030,8839,8989,59.92666666666667,2 3 4 5,-1
212,w0,100,1043,7,148,0,COMPLETED_WALLTIME_REACHED,9881,148,10029,8838,8986,60.71621621621622,6 8 10 11 12 13 14,-1
213,w0,100,1045,4,151,0,COMPLETED_WALLTIME_REACHED,9920,151,10071,8875,9026,59.77483443708609,0 1 7 9,-1
214,w0,100,1054,4,151,0,COMPLETED_WALLTIME_REACHED,10029,151,10180,8975,9126,60.437086092715234,6 8 10 11,-1
215,w0,100,1059,4,148,0,COMPLETED_WALLTIME_REACHED,10029,148,10177,8970,9118,61.608108108108105,12 13 14 15,-1
216,w0,100,1059,4,152,0,COMPLETED_WALLTIME_REACHED,10030,152,10182,8971,9123,60.01973684210526,2 3 4 5,-1
217,w0,100,1062,3,151,0,COMPLETED_WALLTIME_REACHED,10071,151,10222,9009,9160,60.66225165562914,0 1 7,-1
218,w0,100,1064,5,153,0,COMPLETED_WALLTIME_REACHED,10177,153,10330,9113,9266,60.56209150326797,9 12 13 14 15,-1
222,w0,100,1075,3,152,0,COMPLETED_WALLTIME_REACHED,10180,152,10332,9105,9257,60.901315789473685,6 8 10,-1
219,w0,100,1065,5,149,0,COMPLETED_WALLTIME_REACHED,10182,149,10331,9117,9266,62.18791946308725,2 3 4 5 11,-1
232,w0,100,1122,3,151,0,COMPLETED_WALLTIME_REACHED,10222,151,10373,9100,9251,61.264900662251655,0 1 7,-1
220,w0,100,1068,5,150,0,COMPLETED_WALLTIME_REACHED,10330,150,10480,9262,9412,62.74666666666667,9 12 13 14 15,-1
221,w0,100,1070,7,151,0,COMPLETED_WALLTIME_REACHED,10332,151,10483,9262,9413,62.33774834437086,2 3 4 5 6 8 10,-1
226,w0,100,1082,4,149,0,COMPLETED_WALLTIME_REACHED,10373,149,10522,9291,9440,63.355704697986575,0 1 7 11,-1
223,w0,100,1077,5,152,0,COMPLETED_WALLTIME_REACHED,10480,152,10632,9403,9555,62.86184210526316,9 12 13 14 15,-1
224,w0,100,1079,5,149,0,COMPLETED_WALLTIME_REACHED,10483,149,10632,9404,9553,64.11409395973155,2 3 4 5 6,-1
225,w0,100,1080,5,152,0,COMPLETED_WALLTIME_REACHED,10522,152,10674,9442,9594,63.11842105263158,0 1 7 8 10,-1
227,w0,100,1083,4,151,0,COMPLETED_WALLTIME_REACHED,10632,151,10783,9549,9700,64.23841059602648,2 3 4 5,-1
228,w0,100,1103,4,151,0,COMPLETED_WALLTIME_REACHED,10632,151,10783,9529,9680,64.10596026490066,6 9 11 12,-1
242,w0,100,1160,3,150,0,COMPLETED_WALLTIME_REACHED,10632,150,10782,9472,9622,64.14666666666666,13 14 15,-1
229,w0,100,1105,4,150,0,COMPLETED_WALLTIME_REACHED,10674,150,10824,9569,9719,64.79333333333334,0 1 7 8,-1
233,w0,100,1122,4,149,0,COMPLETED_WALLTIME_REACHED,10782,149,10931,9660,9809,65.83221476510067,10 13 14 15,-1
230,w0,100,1114,5,149,0,COMPLETED_WALLTIME_REACHED,10783,149,10932,9669,9818,65.89261744966443,2 3 4 5 6,-1
234,w0,100,1128,5,150,0,COMPLETED_WALLTIME_REACHED,10824,150,10974,9696,9846,65.64,0 1 7 8 9,-1
235,w0,100,1131,4,146,0,COMPLETED_WALLTIME_REACHED,10931,146,11077,9800,9946,68.12328767123287,10 11 12 13,-1
236,w0,100,1131,5,150,0,COMPLETED_WALLTIME_REACHED,10932,150,11082,9801,9951,66.34,2 3 4 5 6,-1
237,w0,100,1137,6,151,0,COMPLETED_WALLTIME_REACHED,10974,151,11125,9837,9988,66.1456953642384,0 1 7 8 9 14,-1
240,w0,100,1153,4,151,0,COMPLETED_WALLTIME_REACHED,11077,151,11228,9924,10075,66.72185430463576,10 11 12 13,-1
238,w0,100,1145,6,151,0,COMPLETED_WALLTIME_REACHED,11082,151,11233,9937,10088,66.80794701986756,2 3 4 5 6 15,-1
239,w0,100,1151,5,147,0,COMPLETED_WALLTIME_REACHED,11125,147,11272,9974,10121,68.85034013605443,0 1 7 8 9,-1
241,w0,100,1158,5,148,0,COMPLETED_WALLTIME_REACHED,11228,148,11376,10070,10218,69.04054054054055,10 11 12 13 14,-1
243,w0,100,1162,3,151,0,COMPLETED_WALLTIME_REACHED,11233,151,11384,10071,10222,67.69536423841059,2 3 4,-1
253,w0,100,1216,3,149,0,COMPLETED_WALLTIME_REACHED,11233,149,11382,10017,10166,68.22818791946308,5 6 15,-1
244,w0,100,1170,5,145,0,COMPLETED_WALLTIME_REACHED,11272,145,11417,10102,10247,70.66896551724138,0 1 7 8 9,-1
245,w0,100,1176,5,153,0,COMPLETED_WALLTIME_REACHED,11376,153,11529,10200,10353,67.66666666666667,10 11 12 13 14,-1
246,w0,100,1180,4,149,0,COMPLETED_WALLTIME_REACHED,11384,149,11533,10204,10353,69.48322147651007,2 3 4 5,-1
247,w0,100,1194,4,149,0,COMPLETED_WALLTIME_REACHED,11417,149,11566,10223,10372,69.61073825503355,0 1 6 7,-1
270,w0,100,1305,3,147,0,COMPLETED_WALLTIME_REACHED,11417,147,11564,10112,10259,69.78911564625851,8 9 15,-1
248,w0,100,1199,4,150,0,COMPLETED_WALLTIME_REACHED,11529,150,11679,10330,10480,69.86666666666666,10 11 12 13,-1
249,w0,100,1200,4,150,0,COMPLETED_WALLTIME_REACHED,11533,150,11683,10333,10483,69.88666666666667,2 3 4 5,-1
250,w0,100,1200,4,151,0,COMPLETED_WALLTIME_REACHED,11564,151,11715,10364,10515,69.63576158940397,8 9 14 15,-1
252,w0,100,1206,4,148,0,COMPLETED_WALLTIME_REACHED,11566,148,11714,10360,10508,71.0,0 1 6 7,-1
254,w0,100,1217,4,152,0,COMPLETED_WALLTIME_REACHED,11679,152,11831,10462,10614,69.82894736842105,10 11 12 13,-1
271,w0,100,1308,3,147,0,COMPLETED_WALLTIME_REACHED,11683,147,11830,10375,10522,71.578231292517,2 3 4,-1
255,w0,100,1219,5,149,0,COMPLETED_WALLTIME_REACHED,11714,149,11863,10495,10644,71.43624161073825,0 1 5 6 7,-1
257,w0,100,1222,6,150,0,COMPLETED_WALLTIME_REACHED,11830,150,11980,10608,10758,71.72,2 3 4 8 9 14,-1
258,w0,100,1241,5,152,0,COMPLETED_WALLTIME_REACHED,11831,152,11983,10590,10742,70.67105263157895,10 11 12 13 15,-1
261,w0,100,1254,4,152,0,COMPLETED_WALLTIME_REACHED,11863,152,12015,10609,10761,70.79605263157895,0 1 5 6,-1
259,w0,100,1252,6,152,0,COMPLETED_WALLTIME_REACHED,11980,152,12132,10728,10880,71.57894736842105,2 3 4 7 8 9,-1
274,w0,100,1321,3,148,0,COMPLETED_WALLTIME_REACHED,11983,148,12131,10662,10810,73.04054054054055,10 11 12,-1
260,w0,100,1253,7,150,0,COMPLETED_WALLTIME_REACHED,12015,150,12165,10762,10912,72.74666666666667,0 1 5 6 13 14 15,-1
275,w0,100,1322,3,152,0,COMPLETED_WALLTIME_REACHED,12131,152,12283,10809,10961,72.11184210526316,10 11 12,-1
262,w0,100,1254,4,152,0,COMPLETED_WALLTIME_REACHED,12132,152,12284,10878,11030,72.5657894736842,2 3 4 7,-1
263,w0,100,1258,5,149,0,COMPLETED_WALLTIME_REACHED,12165,149,12314,10907,11056,74.20134228187919,0 1 5 6 8,-1
264,w0,100,1273,5,150,0,COMPLETED_WALLTIME_REACHED,12283,150,12433,11010,11160,74.4,9 10 11 12 13,-1
265,w0,100,1284,6,149,0,COMPLETED_WALLTIME_REACHED,12284,149,12433,11000,11149,74.8255033557047,2 3 4 7 14 15,-1
266,w0,100,1286,5,152,0,COMPLETED_WALLTIME_REACHED,12314,152,12466,11028,11180,73.55263157894737,0 1 5 6 8,-1
267,w0,100,1291,7,148,0,COMPLETED_WALLTIME_REACHED,12433,148,12581,11142,11290,76.28378378378379,2 3 4 7 9 10 11,-1
272,w0,100,1314,4,150,0,COMPLETED_WALLTIME_REACHED,12433,150,12583,11119,11269,75.12666666666667,12 13 14 15,-1
268,w0,100,1297,5,150,0,COMPLETED_WALLTIME_REACHED,12466,150,12616,11169,11319,75.46,0 1 5 6 8,-1
269,w0,100,1298,5,148,0,COMPLETED_WALLTIME_REACHED,12581,148,12729,11283,11431,77.23648648648648,2 3 4 7 9,-1
276,w0,100,1325,5,151,0,COMPLETED_WALLTIME_REACHED,12583,151,12734,11258,11409,75.55629139072848,10 11 12 13 14,-1
277,w0,100,1331,4,151,0,COMPLETED_WALLTIME_REACHED,12616,151,12767,11285,11436,75.73509933774834,0 1 5 6,-1
278,w0,100,1338,5,152,0,COMPLETED_WALLTIME_REACHED,12729,152,12881,11391,11543,75.9407894736842,2 3 4 7 8,-1
279,w0,100,1338,3,151,0,COMPLETED_WALLTIME_REACHED,12734,151,12885,11396,11547,76.47019867549669,9 10 11,-1
280,w0,100,1343,6,150,0,COMPLETED_WALLTIME_REACHED,12767,150,12917,11424,11574,77.16,0 1 5 6 12 13,-1
281,w0,100,1347,5,150,0,COMPLETED_WALLTIME_REACHED,12881,150,13031,11534,11684,77.89333333333333,2 3 4 7 8,-1
282,w0,100,1353,5,150,0,COMPLETED_WALLTIME_REACHED,12885,150,13035,11532,11682,77.88,9 10 11 14 15,-1
283,w0,100,1358,6,153,0,COMPLETED_WALLTIME_REACHED,12917,153,13070,11559,11712,76.54901960784314,0 1 5 6 12 13,-1
284,w0,100,1368,4,150,0,COMPLETED_WALLTIME_REACHED,13031,150,13181,11663,11813,78.75333333333333,2 3 4 7,-1
285,w0,100,1370,4,152,0,COMPLETED_WALLTIME_REACHED,13035,152,13187,11665,11817,77.74342105263158,8 9 10 11,-1
287,w0,100,1380,4,149,0,COMPLETED_WALLTIME_REACHED,13070,149,13219,11690,11839,79.45637583892618,0 1 5 6,-1
288,w0,100,1380,4,149,0,COMPLETED_WALLTIME_REACHED,13070,149,13219,11690,11839,79.45637583892618,12 13 14 15,-1
289,w0,100,1385,6,147,0,COMPLETED_WALLTIME_REACHED,13187,147,13334,11802,11949,81.28571428571429,2 3 4 7 8 9,-1
290,w0,100,1385,4,144,0,COMPLETED_WALLTIME_REACHED,13219,144,13363,11834,11978,83.18055555555556,0 1 5 6,-1
291,w0,100,1388,5,150,0,COMPLETED_WALLTIME_REACHED,13219,150,13369,11831,11981,79.87333333333333,10 11 12 13 14,-1
292,w0,100,1394,5,149,0,COMPLETED_WALLTIME_REACHED,13334,149,13483,11940,12089,81.13422818791946,2 3 4 7 8,-1
293,w0,100,1399,3,149,0,COMPLETED_WALLTIME_REACHED,13363,149,13512,11964,12113,81.29530201342281,0 1 5,-1
306,w0,100,1458,3,152,0,COMPLETED_WALLTIME_REACHED,13363,152,13515,11905,12057,79.32236842105263,6 9 15,-1
294,w0,100,1401,5,148,0,COMPLETED_WALLTIME_REACHED,13369,148,13517,11968,12116,81.86486486486487,10 11 12 13 14,-1
295,w0,100,1402,4,153,0,COMPLETED_WALLTIME_REACHED,13483,153,13636,12081,12234,79.96078431372548,2 3 4 7,-1
297,w0,100,1414,6,149,0,COMPLETED_WALLTIME_REACHED,13515,149,13664,12101,12250,82.21476510067114,0 1 5 6 8 9,-1
298,w0,100,1426,5,147,0,COMPLETED_WALLTIME_REACHED,13517,147,13664,12091,12238,83.25170068027211,10 11 12 13 14,-1
299,w0,100,1429,4,151,0,COMPLETED_WALLTIME_REACHED,13636,151,13787,12207,12358,81.84105960264901,2 3 4 7,-1
300,w0,100,1430,4,150,0,COMPLETED_WALLTIME_REACHED,13664,150,13814,12234,12384,82.56,0 1 5 6,-1
301,w0,100,1432,4,148,0,COMPLETED_WALLTIME_REACHED,13664,148,13812,12232,12380,83.64864864864865,8 9 10 11,-1
302,w0,100,1434,4,149,0,COMPLETED_WALLTIME_REACHED,13664,149,13813,12230,12379,83.08053691275168,12 13 14 15,-1
307,w0,100,1459,3,147,0,COMPLETED_WALLTIME_REACHED,13787,147,13934,12328,12475,84.8639455782313,2 3 4,-1
303,w0,100,1434,5,148,0,COMPLETED_WALLTIME_REACHED,13812,148,13960,12378,12526,84.63513513513513,7 8 9 10 11,-1
304,w0,100,1446,6,149,0,COMPLETED_WALLTIME_REACHED,13814,149,13963,12368,12517,84.00671140939598,0 1 5 6 12 13,-1
308,w0,100,1463,4,149,0,COMPLETED_WALLTIME_REACHED,13934,149,14083,12471,12620,84.69798657718121,2 3 4 14,-1
305,w0,100,1452,6,148,0,COMPLETED_WALLTIME_REACHED,13960,148,14108,12508,12656,85.51351351351352,7 8 9 10 11 15,-1
309,w0,100,1464,4,150,0,COMPLETED_WALLTIME_REACHED,13963,150,14113,12499,12649,84.32666666666667,0 1 5 6,-1
310,w0,100,1469,5,153,0,COMPLETED_WALLTIME_REACHED,14083,153,14236,12614,12767,83.44444444444444,2 3 4 12 13,-1
311,w0,100,1470,4,150,0,COMPLETED_WALLTIME_REACHED,14108,150,14258,12638,12788,85.25333333333333,7 8 9 10,-1
337,w0,100,1592,3,151,0,COMPLETED_WALLTIME_REACHED,14108,151,14259,12516,12667,83.88741721854305,11 14 15,-1
312,w0,100,1476,4,151,0,COMPLETED_WALLTIME_REACHED,14113,151,14264,12637,12788,84.6887417218543,0 1 5 6,-1
313,w0,100,1478,5,150,0,COMPLETED_WALLTIME_REACHED,14236,150,14386,12758,12908,86.05333333333333,2 3 4 12 13,-1
314,w0,100,1482,4,151,0,COMPLETED_WALLTIME_REACHED,14258,151,14409,12776,12927,85.6092715231788,7 8 9 10,-1
341,w0,100,1615,3,149,0,COMPLETED_WALLTIME_REACHED,14259,149,14408,12644,12793,85.85906040268456,11 14 15,-1
315,w0,100,1486,4,146,0,COMPLETED_WALLTIME_REACHED,14264,146,14410,12778,12924,88.52054794520548,0 1 5 6,-1
316,w0,100,1490,4,149,0,COMPLETED_WALLTIME_REACHED,14386,149,14535,12896,13045,87.5503355704698,2 3 4 12,-1
347,w0,100,1651,3,151,0,COMPLETED_WALLTIME_REACHED,14408,151,14559,12757,12908,85.48344370860927,11 13 14,-1
317,w0,100,1506,5,149,0,COMPLETED_WALLTIME_REACHED,14409,149,14558,12903,13052,87.59731543624162,7 8 9 10 15,-1
352,w0,100,1663,3,151,0,COMPLETED_WALLTIME_REACHED,14410,151,14561,12747,12898,85.41721854304636,0 1 5,-1
318,w0,100,1516,5,147,0,COMPLETED_WALLTIME_REACHED,14535,147,14682,13019,13166,89.56462585034014,2 3 4 6 12,-1
319,w0,100,1528,4,149,0,COMPLETED_WALLTIME_REACHED,14558,149,14707,13030,13179,88.4496644295302,7 8 9 10,-1
320,w0,100,1529,4,154,0,COMPLETED_WALLTIME_REACHED,14559,154,14713,13030,13184,85.6103896103896,11 13 14 15,-1
353,w0,100,1665,3,148,0,COMPLETED_WALLTIME_REACHED,14561,148,14709,12896,13044,88.13513513513513,0 1 5,-1
321,w0,100,1531,4,150,0,COMPLETED_WALLTIME_REACHED,14682,150,14832,13151,13301,88.67333333333333,2 3 4 6,-1
322,w0,100,1532,4,152,0,COMPLETED_WALLTIME_REACHED,14707,152,14859,13175,13327,87.67763157894737,7 8 9 10,-1
323,w0,100,1534,4,149,0,COMPLETED_WALLTIME_REACHED,14709,149,14858,13175,13324,89.42281879194631,0 1 5 12,-1
324,w0,100,1535,4,150,0,COMPLETED_WALLTIME_REACHED,14713,150,14863,13178,13328,88.85333333333334,11 13 14 15,-1
325,w0,100,1538,6,150,0,COMPLETED_WALLTIME_REACHED,14858,150,15008,13320,13470,89.8,0 1 2 3 4 5,-1
326,w0,100,1539,5,150,0,COMPLETED_WALLTIME_REACHED,14859,150,15009,13320,13470,89.8,6 7 8 9 10,-1
327,w0,100,1544,5,150,0,COMPLETED_WALLTIME_REACHED,14863,150,15013,13319,13469,89.79333333333334,11 12 13 14 15,-1
328,w0,100,1551,6,148,0,COMPLETED_WALLTIME_REACHED,15008,148,15156,13457,13605,91.92567567567568,0 1 2 3 4 5,-1
329,w0,100,1552,5,152,0,COMPLETED_WALLTIME_REACHED,15009,152,15161,13457,13609,89.53289473684211,6 7 8 9 10,-1
330,w0,100,1560,4,153,0,COMPLETED_WALLTIME_REACHED,15013,153,15166,13453,13606,88.9281045751634,11 12 13 14,-1
331,w0,100,1561,6,148,0,COMPLETED_WALLTIME_REACHED,15156,148,15304,13595,13743,92.85810810810811,0 1 2 3 4 5,-1
332,w0,100,1573,4,150,0,COMPLETED_WALLTIME_REACHED,15161,150,15311,13588,13738,91.58666666666667,6 7 8 9,-1
333,w0,100,1573,5,154,0,COMPLETED_WALLTIME_REACHED,15166,154,15320,13593,13747,89.26623376623377,10 11 12 13 14,-1
334,w0,100,1576,4,150,0,COMPLETED_WALLTIME_REACHED,15304,150,15454,13728,13878,92.52,0 1 2 3,-1
366,w0,100,1718,3,151,0,COMPLETED_WALLTIME_REACHED,15304,151,15455,13586,13737,90.97350993377484,4 5 15,-1
335,w0,100,1585,4,154,0,COMPLETED_WALLTIME_REACHED,15311,154,15465,13726,13880,90.12987012987013,6 7 8 9,-1
336,w0,100,1585,4,150,0,COMPLETED_WALLTIME_REACHED,15320,150,15470,13735,13885,92.56666666666666,10 11 12 13,-1
338,w0,100,1600,5,151,0,COMPLETED_WALLTIME_REACHED,15454,151,15605,13854,14005,92.74834437086092,0 1 2 3 14,-1
339,w0,100,1609,5,151,0,COMPLETED_WALLTIME_REACHED,15465,151,15616,13856,14007,92.76158940397352,4 5 6 7 8,-1
340,w0,100,1613,6,149,0,COMPLETED_WALLTIME_REACHED,15470,149,15619,13857,14006,94.0,9 10 11 12 13 15,-1
342,w0,100,1618,4,149,0,COMPLETED_WALLTIME_REACHED,15605,149,15754,13987,14136,94.87248322147651,0 1 2 3,-1
343,w0,100,1634,4,155,0,COMPLETED_WALLTIME_REACHED,15616,155,15771,13982,14137,91.20645161290322,4 5 6 7,-1
344,w0,100,1642,4,149,0,COMPLETED_WALLTIME_REACHED,15619,149,15768,13977,14126,94.80536912751678,8 9 10 11,-1
345,w0,100,1645,4,150,0,COMPLETED_WALLTIME_REACHED,15619,150,15769,13974,14124,94.16,12 13 14 15,-1
371,w0,100,1738,3,151,0,COMPLETED_WALLTIME_REACHED,15754,151,15905,14016,14167,93.82119205298014,0 1 2,-1
346,w0,100,1649,5,152,0,COMPLETED_WALLTIME_REACHED,15768,152,15920,14119,14271,93.88815789473684,3 8 9 10 11,-1
348,w0,100,1653,4,149,0,COMPLETED_WALLTIME_REACHED,15769,149,15918,14116,14265,95.73825503355705,12 13 14 15,-1
349,w0,100,1656,5,147,0,COMPLETED_WALLTIME_REACHED,15905,147,16052,14249,14396,97.93197278911565,0 1 2 4 5,-1
350,w0,100,1658,5,147,0,COMPLETED_WALLTIME_REACHED,15918,147,16065,14260,14407,98.00680272108843,6 7 12 13 14,-1
351,w0,100,1661,4,148,0,COMPLETED_WALLTIME_REACHED,15920,148,16068,14259,14407,97.3445945945946,3 8 9 10,-1
354,w0,100,1667,4,148,0,COMPLETED_WALLTIME_REACHED,16052,148,16200,14385,14533,98.19594594594595,0 1 2 4,-1
375,w0,100,1760,3,150,0,COMPLETED_WALLTIME_REACHED,16052,150,16202,14292,14442,96.28,5 11 15,-1
355,w0,100,1673,4,151,0,COMPLETED_WALLTIME_REACHED,16065,151,16216,14392,14543,96.3112582781457,6 7 12 13,-1
356,w0,100,1673,5,151,0,COMPLETED_WALLTIME_REACHED,16068,151,16219,14395,14546,96.33112582781457,3 8 9 10 14,-1
357,w0,100,1684,4,153,0,COMPLETED_WALLTIME_REACHED,16200,153,16353,14516,14669,95.87581699346406,0 1 2 4,-1
387,w0,100,1833,3,149,0,COMPLETED_WALLTIME_REACHED,16202,149,16351,14369,14518,97.43624161073825,5 11 15,-1
358,w0,100,1685,4,149,0,COMPLETED_WALLTIME_REACHED,16216,149,16365,14531,14680,98.52348993288591,6 7 12 13,-1
359,w0,100,1690,4,150,0,COMPLETED_WALLTIME_REACHED,16219,150,16369,14529,14679,97.86,3 8 9 10,-1
390,w0,100,1873,3,149,0,COMPLETED_WALLTIME_REACHED,16351,149,16500,14478,14627,98.16778523489933,5 11 14,-1
360,w0,100,1697,5,152,0,COMPLETED_WALLTIME_REACHED,16353,152,16505,14656,14808,97.42105263157895,0 1 2 4 15,-1
392,w0,100,1888,3,150,0,COMPLETED_WALLTIME_REACHED,16365,150,16515,14477,14627,97.51333333333334,6 7 12,-1
361,w0,100,1699,5,152,0,COMPLETED_WALLTIME_REACHED,16369,152,16521,14670,14822,97.51315789473684,3 8 9 10 13,-1
404,w0,100,1965,3,149,0,COMPLETED_WALLTIME_REACHED,16500,149,16649,14535,14684,98.5503355704698,5 11 14,-1
362,w0,100,1705,4,150,0,COMPLETED_WALLTIME_REACHED,16505,150,16655,14800,14950,99.66666666666667,0 1 2 4,-1
363,w0,100,1706,4,149,0,COMPLETED_WALLTIME_REACHED,16515,149,16664,14809,14958,100.38926174496645,6 7 12 15,-1
364,w0,100,1708,4,150,0,COMPLETED_WALLTIME_REACHED,16521,150,16671,14813,14963,99.75333333333333,3 8 9 10,-1
365,w0,100,1714,4,150,0,COMPLETED_WALLTIME_REACHED,16649,150,16799,14935,15085,100.56666666666666,5 11 13 14,-1
367,w0,100,1720,4,150,0,COMPLETED_WALLTIME_REACHED,16655,150,16805,14935,15085,100.56666666666666,0 1 2 4,-1
405,w0,100,1975,3,148,0,COMPLETED_WALLTIME_REACHED,16664,148,16812,14689,14837,100.25,6 7 12,-1
368,w0,100,1729,5,152,0,COMPLETED_WALLTIME_REACHED,16671,152,16823,14942,15094,99.30263157894737,3 8 9 10 15,-1
410,w0,100,1986,3,151,0,COMPLETED_WALLTIME_REACHED,16799,151,16950,14813,14964,99.09933774834437,5 11 13,-1
369,w0,100,1733,5,152,0,COMPLETED_WALLTIME_REACHED,16805,152,16957,15072,15224,100.15789473684211,0 1 2 4 14,-1
411,w0,100,1989,3,152,0,COMPLETED_WALLTIME_REACHED,16812,152,16964,14823,14975,98.51973684210526,6 7 12,-1
370,w0,100,1737,5,148,0,COMPLETED_WALLTIME_REACHED,16823,148,16971,15086,15234,102.93243243243244,3 8 9 10 15,-1
372,w0,100,1746,6,149,0,COMPLETED_WALLTIME_REACHED,16957,149,17106,15211,15360,103.08724832214764,0 1 2 4 5 11,-1
373,w0,100,1747,5,151,0,COMPLETED_WALLTIME_REACHED,16964,151,17115,15217,15368,101.7748344370861,6 7 12 13 14,-1
374,w0,100,1749,5,149,0,COMPLETED_WALLTIME_REACHED,16971,149,17120,15222,15371,103.16107382550335,3 8 9 10 15,-1
376,w0,100,1761,5,148,0,COMPLETED_WALLTIME_REACHED,17106,148,17254,15345,15493,104.68243243243244,0 1 2 4 5,-1
377,w0,100,1762,6,150,0,COMPLETED_WALLTIME_REACHED,17115,150,17265,15353,15503,103.35333333333334,6 7 11 12 13 14,-1
378,w0,100,1765,4,149,0,COMPLETED_WALLTIME_REACHED,17120,149,17269,15355,15504,104.05369127516778,3 8 9 10,-1
379,w0,100,1766,5,150,0,COMPLETED_WALLTIME_REACHED,17254,150,17404,15488,15638,104.25333333333333,0 1 2 4 5,-1
380,w0,100,1766,6,147,0,COMPLETED_WALLTIME_REACHED,17265,147,17412,15499,15646,106.43537414965986,6 7 11 12 13 14,-1
381,w0,100,1788,4,150,0,COMPLETED_WALLTIME_REACHED,17269,150,17419,15481,15631,104.20666666666666,3 8 9 10,-1
382,w0,100,1805,4,151,0,COMPLETED_WALLTIME_REACHED,17404,151,17555,15599,15750,104.30463576158941,0 1 2 4,-1
383,w0,100,1810,4,148,0,COMPLETED_WALLTIME_REACHED,17412,148,17560,15602,15750,106.41891891891892,5 6 7 11,-1
385,w0,100,1815,4,151,0,COMPLETED_WALLTIME_REACHED,17412,151,17563,15597,15748,104.29139072847683,12 13 14 15,-1
386,w0,100,1824,4,151,0,COMPLETED_WALLTIME_REACHED,17419,151,17570,15595,15746,104.27814569536424,3 8 9 10,-1
417,w0,100,2008,3,149,0,COMPLETED_WALLTIME_REACHED,17555,149,17704,15547,15696,105.34228187919463,0 1 2,-1
388,w0,100,1845,5,149,0,COMPLETED_WALLTIME_REACHED,17560,149,17709,15715,15864,106.46979865771812,4 5 6 7 11,-1
421,w0,100,2025,3,147,0,COMPLETED_WALLTIME_REACHED,17563,147,17710,15538,15685,106.70068027210884,12 13 14,-1
391,w0,100,1884,5,152,0,COMPLETED_WALLTIME_REACHED,17570,152,17722,15686,15838,104.19736842105263,3 8 9 10 15,-1
428,w0,100,2044,3,153,0,COMPLETED_WALLTIME_REACHED,17704,153,17857,15660,15813,103.3529411764706,0 1 2,-1
393,w0,100,1889,5,147,0,COMPLETED_WALLTIME_REACHED,17709,147,17856,15820,15967,108.61904761904762,4 5 6 7 11,-1
439,w0,100,2108,3,153,0,COMPLETED_WALLTIME_REACHED,17710,153,17863,15602,15755,102.97385620915033,12 13 14,-1
394,w0,100,1893,4,154,0,COMPLETED_WALLTIME_REACHED,17722,154,17876,15829,15983,103.78571428571429,3 8 9 10,-1
395,w0,100,1908,5,151,0,COMPLETED_WALLTIME_REACHED,17856,151,18007,15948,16099,106.6158940397351,4 5 6 7 11,-1
396,w0,100,1918,4,151,0,COMPLETED_WALLTIME_REACHED,17857,151,18008,15939,16090,106.55629139072848,0 1 2 15,-1
445,w0,100,2144,3,152,0,COMPLETED_WALLTIME_REACHED,17863,152,18015,15719,15871,104.41447368421052,12 13 14,-1
397,w0,100,1932,4,149,0,COMPLETED_WALLTIME_REACHED,17876,149,18025,15944,16093,108.00671140939598,3 8 9 10,-1
398,w0,100,1935,4,147,0,COMPLETED_WALLTIME_REACHED,18007,147,18154,16072,16219,110.33333333333333,4 5 6 7,-1
399,w0,100,1940,5,152,0,COMPLETED_WALLTIME_REACHED,18008,152,18160,16068,16220,106.71052631578948,0 1 2 11 15,-1
400,w0,100,1944,6,150,0,COMPLETED_WALLTIME_REACHED,18025,150,18175,16081,16231,108.20666666666666,3 8 9 10 12 13,-1
401,w0,100,1958,5,151,0,COMPLETED_WALLTIME_REACHED,18154,151,18305,16196,16347,108.25827814569537,4 5 6 7 14,-1
402,w0,100,1963,5,152,0,COMPLETED_WALLTIME_REACHED,18160,152,18312,16197,16349,107.5592105263158,0 1 2 11 15,-1
403,w0,100,1963,4,147,0,COMPLETED_WALLTIME_REACHED,18175,147,18322,16212,16359,111.28571428571429,3 8 9 10,-1
406,w0,100,1979,4,147,0,COMPLETED_WALLTIME_REACHED,18305,147,18452,16326,16473,112.06122448979592,4 5 6 7,-1
453,w0,100,2199,3,152,0,COMPLETED_WALLTIME_REACHED,18305,152,18457,16106,16258,106.96052631578948,12 13 14,-1
407,w0,100,1980,4,150,0,COMPLETED_WALLTIME_REACHED,18312,150,18462,16332,16482,109.88,0 1 2 11,-1
408,w0,100,1985,4,152,0,COMPLETED_WALLTIME_REACHED,18322,152,18474,16337,16489,108.48026315789474,3 8 9 10,-1
409,w0,100,1985,4,148,0,COMPLETED_WALLTIME_REACHED,18452,148,18600,16467,16615,112.26351351351352,4 5 6 7,-1
412,w0,100,1993,4,150,0,COMPLETED_WALLTIME_REACHED,18457,150,18607,16464,16614,110.76,12 13 14 15,-1
463,w0,100,2226,3,149,0,COMPLETED_WALLTIME_REACHED,18462,149,18611,16236,16385,109.96644295302013,0 1 2,-1
413,w0,100,1993,5,150,0,COMPLETED_WALLTIME_REACHED,18474,150,18624,16481,16631,110.87333333333333,3 8 9 10 11,-1
414,w0,100,2003,7,152,0,COMPLETED_WALLTIME_REACHED,18607,152,18759,16604,16756,110.23684210526316,4 5 6 7 12 13 14,-1
415,w0,100,2004,4,152,0,COMPLETED_WALLTIME_REACHED,18611,152,18763,16607,16759,110.25657894736842,0 1 2 15,-1
416,w0,100,2007,4,151,0,COMPLETED_WALLTIME_REACHED,18624,151,18775,16617,16768,111.04635761589404,3 8 9 10,-1
418,w0,100,2008,4,150,0,COMPLETED_WALLTIME_REACHED,18759,150,18909,16751,16901,112.67333333333333,4 5 6 7,-1
419,w0,100,2011,4,151,0,COMPLETED_WALLTIME_REACHED,18759,151,18910,16748,16899,111.91390728476821,11 12 13 14,-1
420,w0,100,2018,4,150,0,COMPLETED_WALLTIME_REACHED,18763,150,18913,16745,16895,112.63333333333334,0 1 2 15,-1
464,w0,100,2232,3,146,0,COMPLETED_WALLTIME_REACHED,18775,146,18921,16543,16689,114.3082191780822,3 8 9,-1
422,w0,100,2026,5,150,0,COMPLETED_WALLTIME_REACHED,18909,150,19059,16883,17033,113.55333333333333,4 5 6 7 10,-1
469,w0,100,2274,3,151,0,COMPLETED_WALLTIME_REACHED,18910,151,19061,16636,16787,111.17218543046357,11 12 13,-1
423,w0,100,2026,5,152,0,COMPLETED_WALLTIME_REACHED,18913,152,19065,16887,17039,112.09868421052632,0 1 2 14 15,-1
475,w0,100,2311,3,149,0,COMPLETED_WALLTIME_REACHED,18921,149,19070,16610,16759,112.47651006711409,3 8 9,-1
424,w0,100,2028,5,150,0,COMPLETED_WALLTIME_REACHED,19059,150,19209,17031,17181,114.54,4 5 6 7 10,-1
489,w0,100,2369,3,154,0,COMPLETED_WALLTIME_REACHED,19061,154,19215,16692,16846,109.3896103896104,11 12 13,-1
425,w0,100,2036,4,150,0,COMPLETED_WALLTIME_REACHED,19065,150,19215,17029,17179,114.52666666666667,0 1 2 14,-1
426,w0,100,2039,4,151,0,COMPLETED_WALLTIME_REACHED,19070,151,19221,17031,17182,113.78807947019868,3 8 9 15,-1
430,w0,100,2063,4,153,0,COMPLETED_WALLTIME_REACHED,19209,153,19362,17146,17299,113.06535947712419,4 5 6 7,-1
427,w0,100,2040,6,149,0,COMPLETED_WALLTIME_REACHED,19215,149,19364,17175,17324,116.26845637583892,0 1 2 10 11 12,-1
429,w0,100,2060,6,151,0,COMPLETED_WALLTIME_REACHED,19221,151,19372,17161,17312,114.64900662251655,3 8 9 13 14 15,-1
431,w0,100,2073,4,151,0,COMPLETED_WALLTIME_REACHED,19362,151,19513,17289,17440,115.49668874172185,4 5 6 7,-1
432,w0,100,2079,4,154,0,COMPLETED_WALLTIME_REACHED,19364,154,19518,17285,17439,113.24025974025975,0 1 2 10,-1
433,w0,100,2083,4,147,0,COMPLETED_WALLTIME_REACHED,19372,147,19519,17289,17436,118.61224489795919,3 8 9 11,-1
434,w0,100,2084,4,150,0,COMPLETED_WALLTIME_REACHED,19372,150,19522,17288,17438,116.25333333333333,12 13 14 15,-1
490,w0,100,2370,3,149,0,COMPLETED_WALLTIME_REACHED,19513,149,19662,17143,17292,116.05369127516778,4 5 6,-1
435,w0,100,2088,5,154,0,COMPLETED_WALLTIME_REACHED,19518,154,19672,17430,17584,114.18181818181819,0 1 2 7 10,-1
436,w0,100,2094,4,152,0,COMPLETED_WALLTIME_REACHED,19519,152,19671,17425,17577,115.63815789473684,3 8 9 11,-1
437,w0,100,2095,4,147,0,COMPLETED_WALLTIME_REACHED,19522,147,19669,17427,17574,119.55102040816327,12 13 14 15,-1
438,w0,100,2103,5,148,0,COMPLETED_WALLTIME_REACHED,19669,148,19817,17566,17714,119.6891891891892,4 5 6 12 13,-1
440,w0,100,2109,4,150,0,COMPLETED_WALLTIME_REACHED,19671,150,19821,17562,17712,118.08,3 8 9 11,-1
441,w0,100,2118,4,150,0,COMPLETED_WALLTIME_REACHED,19672,150,19822,17554,17704,118.02666666666667,0 1 2 7,-1
492,w0,100,2376,3,148,0,COMPLETED_WALLTIME_REACHED,19672,148,19820,17296,17444,117.86486486486487,10 14 15,-1
442,w0,100,2139,5,152,0,COMPLETED_WALLTIME_REACHED,19817,152,19969,17678,17830,117.30263157894737,4 5 6 12 13,-1
493,w0,100,2377,3,146,0,COMPLETED_WALLTIME_REACHED,19820,146,19966,17443,17589,120.47260273972603,10 14 15,-1
443,w0,100,2140,4,153,0,COMPLETED_WALLTIME_REACHED,19821,153,19974,17681,17834,116.56209150326798,3 8 9 11,-1
986,w0,100,4887,4,144,0,COMPLETED_WALLTIME_REACHED,19822,144,19966,14935,15079,104.71527777777777,0 1 2 7,-1
444,w0,100,2141,5,151,0,COMPLETED_WALLTIME_REACHED,19966,151,20117,17825,17976,119.04635761589404,0 1 2 7 10,-1
446,w0,100,2145,4,148,0,COMPLETED_WALLTIME_REACHED,19969,148,20117,17824,17972,121.43243243243244,4 5 6 12,-1
447,w0,100,2147,5,150,0,COMPLETED_WALLTIME_REACHED,19974,150,20124,17827,17977,119.84666666666666,3 8 9 11 13,-1
448,w0,100,2152,4,150,0,COMPLETED_WALLTIME_REACHED,20117,150,20267,17965,18115,120.76666666666667,0 1 2 4,-1
450,w0,100,2169,6,151,0,COMPLETED_WALLTIME_REACHED,20117,151,20268,17948,18099,119.86092715231788,5 6 7 10 12 14,-1
451,w0,100,2175,6,149,0,COMPLETED_WALLTIME_REACHED,20124,149,20273,17949,18098,121.46308724832215,3 8 9 11 13 15,-1
455,w0,100,2202,4,153,0,COMPLETED_WALLTIME_REACHED,20267,153,20420,18065,18218,119.0718954248366,0 1 2 4,-1
452,w0,100,2183,6,151,0,COMPLETED_WALLTIME_REACHED,20268,151,20419,18085,18236,120.76821192052981,5 6 7 10 12 14,-1
456,w0,100,2210,6,150,0,COMPLETED_WALLTIME_REACHED,20273,150,20423,18063,18213,121.42,3 8 9 11 13 15,-1
457,w0,100,2212,4,147,0,COMPLETED_WALLTIME_REACHED,20419,147,20566,18207,18354,124.85714285714286,5 6 7 10,-1
458,w0,100,2214,4,148,0,COMPLETED_WALLTIME_REACHED,20420,148,20568,18206,18354,124.01351351351352,0 1 2 4,-1
459,w0,100,2217,5,153,0,COMPLETED_WALLTIME_REACHED,20423,153,20576,18206,18359,119.99346405228758,3 8 9 11 12,-1
503,w0,100,2433,3,147,0,COMPLETED_WALLTIME_REACHED,20423,147,20570,17990,18137,123.38095238095238,13 14 15,-1
460,w0,100,2220,4,148,0,COMPLETED_WALLTIME_REACHED,20566,148,20714,18346,18494,124.95945945945945,5 6 7 10,-1
461,w0,100,2224,5,153,0,COMPLETED_WALLTIME_REACHED,20570,153,20723,18346,18499,120.90849673202614,0 1 2 4 13,-1
462,w0,100,2224,6,153,0,COMPLETED_WALLTIME_REACHED,20576,153,20729,18352,18505,120.94771241830065,3 8 9 11 12 14,-1
465,w0,100,2237,5,150,0,COMPLETED_WALLTIME_REACHED,20714,150,20864,18477,18627,124.18,5 6 7 10 15,-1
466,w0,100,2243,5,150,0,COMPLETED_WALLTIME_REACHED,20723,150,20873,18480,18630,124.2,0 1 2 4 13,-1
467,w0,100,2254,5,150,0,COMPLETED_WALLTIME_REACHED,20729,150,20879,18475,18625,124.16666666666667,3 8 9 11 12,-1
468,w0,100,2264,5,148,0,COMPLETED_WALLTIME_REACHED,20864,148,21012,18600,18748,126.67567567567568,5 6 7 10 14,-1
470,w0,100,2283,4,149,0,COMPLETED_WALLTIME_REACHED,20873,149,21022,18590,18739,125.76510067114094,0 1 2 4,-1
471,w0,100,2292,5,150,0,COMPLETED_WALLTIME_REACHED,20879,150,21029,18587,18737,124.91333333333333,3 8 9 11 12,-1
472,w0,100,2299,7,149,0,COMPLETED_WALLTIME_REACHED,21012,149,21161,18713,18862,126.59060402684564,5 6 7 10 13 14 15,-1
476,w0,100,2313,4,151,0,COMPLETED_WALLTIME_REACHED,21022,151,21173,18709,18860,124.90066225165563,0 1 2 4,-1
473,w0,100,2299,5,151,0,COMPLETED_WALLTIME_REACHED,21029,151,21180,18730,18881,125.03973509933775,3 8 9 11 12,-1
474,w0,100,2300,5,148,0,COMPLETED_WALLTIME_REACHED,21161,148,21309,18861,19009,128.4391891891892,5 6 7 10 13,-1
477,w0,100,2316,5,151,0,COMPLETED_WALLTIME_REACHED,21173,151,21324,18857,19008,125.88079470198676,0 1 2 4 14,-1
478,w0,100,2316,5,148,0,COMPLETED_WALLTIME_REACHED,21180,148,21328,18864,19012,128.45945945945945,3 8 9 11 12,-1
479,w0,100,2317,4,150,0,COMPLETED_WALLTIME_REACHED,21309,150,21459,18992,19142,127.61333333333333,5 6 7 10,-1
480,w0,100,2318,5,151,0,COMPLETED_WALLTIME_REACHED,21324,151,21475,19006,19157,126.86754966887418,0 1 2 4 13,-1
481,w0,100,2319,6,150,0,COMPLETED_WALLTIME_REACHED,21328,150,21478,19009,19159,127.72666666666667,3 8 9 11 12 14,-1
485,w0,100,2332,4,149,0,COMPLETED_WALLTIME_REACHED,21459,149,21608,19127,19276,129.36912751677852,5 6 7 10,-1
482,w0,100,2323,6,148,0,COMPLETED_WALLTIME_REACHED,21475,148,21623,19152,19300,130.40540540540542,0 1 2 4 13 15,-1
483,w0,100,2324,5,151,0,COMPLETED_WALLTIME_REACHED,21478,151,21629,19154,19305,127.8476821192053,3 8 9 11 12,-1
484,w0,100,2330,5,151,0,COMPLETED_WALLTIME_REACHED,21608,151,21759,19278,19429,128.66887417218544,5 6 7 10 14,-1
486,w0,100,2334,4,152,0,COMPLETED_WALLTIME_REACHED,21623,152,21775,19289,19441,127.90131578947368,0 1 2 4,-1
487,w0,100,2343,4,149,0,COMPLETED_WALLTIME_REACHED,21629,149,21778,19286,19435,130.43624161073825,3 8 9 11,-1
509,w0,100,2458,3,150,0,COMPLETED_WALLTIME_REACHED,21629,150,21779,19171,19321,128.80666666666667,12 13 15,-1
488,w0,100,2345,5,154,0,COMPLETED_WALLTIME_REACHED,21759,154,21913,19414,19568,127.06493506493507,5 6 7 10 14,-1
491,w0,100,2373,4,151,0,COMPLETED_WALLTIME_REACHED,21775,151,21926,19402,19553,129.49006622516555,0 1 2 4,-1
494,w0,100,2390,4,151,0,COMPLETED_WALLTIME_REACHED,21778,151,21929,19388,19539,129.39735099337747,3 8 9 11,-1
527,w0,100,2553,3,150,0,COMPLETED_WALLTIME_REACHED,21779,150,21929,19226,19376,129.17333333333335,12 13 15,-1
495,w0,100,2395,5,149,0,COMPLETED_WALLTIME_REACHED,21913,149,22062,19518,19667,131.99328859060404,5 6 7 10 14,-1
496,w0,100,2395,4,152,0,COMPLETED_WALLTIME_REACHED,21926,152,22078,19531,19683,129.4934210526316,0 1 2 4,-1
497,w0,100,2398,5,151,0,COMPLETED_WALLTIME_REACHED,21929,151,22080,19531,19682,130.34437086092714,3 8 9 11 12,-1
498,w0,100,2417,6,148,0,COMPLETED_WALLTIME_REACHED,22062,148,22210,19645,19793,133.73648648648648,5 6 7 10 13 14,-1
499,w0,100,2419,5,150,0,COMPLETED_WALLTIME_REACHED,22078,150,22228,19659,19809,132.06,0 1 2 4 15,-1
500,w0,100,2422,5,150,0,COMPLETED_WALLTIME_REACHED,22080,150,22230,19658,19808,132.05333333333334,3 8 9 11 12,-1
501,w0,100,2431,6,151,0,COMPLETED_WALLTIME_REACHED,22210,151,22361,19779,19930,131.98675496688742,5 6 7 10 13 14,-1
504,w0,100,2438,4,152,0,COMPLETED_WALLTIME_REACHED,22228,152,22380,19790,19942,131.19736842105263,0 1 2 4,-1
502,w0,100,2432,6,149,0,COMPLETED_WALLTIME_REACHED,22230,149,22379,19798,19947,133.8724832214765,3 8 9 11 12 15,-1
505,w0,100,2445,4,152,0,COMPLETED_WALLTIME_REACHED,22361,152,22513,19916,20068,132.02631578947367,5 6 7 10,-1
506,w0,100,2446,4,151,0,COMPLETED_WALLTIME_REACHED,22379,151,22530,19933,20084,133.0066225165563,3 8 9 11,-1
533,w0,100,2589,3,152,0,COMPLETED_WALLTIME_REACHED,22379,152,22531,19790,19942,131.19736842105263,12 13 14,-1
507,w0,100,2454,5,150,0,COMPLETED_WALLTIME_REACHED,22380,150,22530,19926,20076,133.84,0 1 2 4 15,-1
512,w0,100,2484,4,152,0,COMPLETED_WALLTIME_REACHED,22513,152,22665,20029,20181,132.76973684210526,5 6 7 10,-1
508,w0,100,2456,5,153,0,COMPLETED_WALLTIME_REACHED,22530,153,22683,20074,20227,132.20261437908496,0 1 2 3 4,-1
510,w0,100,2466,5,148,0,COMPLETED_WALLTIME_REACHED,22531,148,22679,20065,20213,136.57432432432432,8 9 11 12 13,-1
511,w0,100,2479,5,154,0,COMPLETED_WALLTIME_REACHED,22665,154,22819,20186,20340,132.07792207792207,5 6 7 10 14,-1
513,w0,100,2493,5,146,0,COMPLETED_WALLTIME_REACHED,22679,146,22825,20186,20332,139.26027397260273,8 9 11 12 13,-1
514,w0,100,2494,6,151,0,COMPLETED_WALLTIME_REACHED,22683,151,22834,20189,20340,134.7019867549669,0 1 2 3 4 15,-1
515,w0,100,2494,4,148,0,COMPLETED_WALLTIME_REACHED,22819,148,22967,20325,20473,138.3310810810811,5 6 7 10,-1
516,w0,100,2504,4,149,0,COMPLETED_WALLTIME_REACHED,22825,149,22974,20321,20470,137.38255033557047,8 9 11 12,-1
517,w0,100,2507,5,148,0,COMPLETED_WALLTIME_REACHED,22834,148,22982,20327,20475,138.34459459459458,0 1 2 3 4,-1
518,w0,100,2510,5,150,0,COMPLETED_WALLTIME_REACHED,22967,150,23117,20457,20607,137.38,5 6 7 10 13,-1
519,w0,100,2512,4,151,0,COMPLETED_WALLTIME_REACHED,22974,151,23125,20462,20613,136.50993377483445,8 9 11 12,-1
520,w0,100,2519,4,149,0,COMPLETED_WALLTIME_REACHED,22982,149,23131,20463,20612,138.33557046979865,0 1 2 3,-1
547,w0,100,2680,3,148,0,COMPLETED_WALLTIME_REACHED,22982,148,23130,20302,20450,138.17567567567568,4 14 15,-1
521,w0,100,2524,4,152,0,COMPLETED_WALLTIME_REACHED,23117,152,23269,20593,20745,136.48026315789474,5 6 7 10,-1
522,w0,100,2527,5,149,0,COMPLETED_WALLTIME_REACHED,23125,149,23274,20598,20747,139.24161073825502,8 9 11 12 13,-1
523,w0,100,2527,6,153,0,COMPLETED_WALLTIME_REACHED,23131,153,23284,20604,20757,135.66666666666666,0 1 2 3 4 14,-1
524,w0,100,2539,5,147,0,COMPLETED_WALLTIME_REACHED,23269,147,23416,20730,20877,142.0204081632653,5 6 7 10 15,-1
525,w0,100,2547,5,149,0,COMPLETED_WALLTIME_REACHED,23274,149,23423,20727,20876,140.10738255033556,8 9 11 12 13,-1
526,w0,100,2549,5,152,0,COMPLETED_WALLTIME_REACHED,23284,152,23436,20735,20887,137.41447368421052,0 1 2 3 4,-1
528,w0,100,2555,4,149,0,COMPLETED_WALLTIME_REACHED,23416,149,23565,20861,21010,141.00671140939596,5 6 7 10,-1
529,w0,100,2557,4,151,0,COMPLETED_WALLTIME_REACHED,23423,151,23574,20866,21017,139.18543046357615,8 9 11 12,-1
565,w0,100,2748,3,149,0,COMPLETED_WALLTIME_REACHED,23423,149,23572,20675,20824,139.75838926174498,13 14 15,-1
530,w0,100,2564,4,151,0,COMPLETED_WALLTIME_REACHED,23436,151,23587,20872,21023,139.2251655629139,0 1 2 3,-1
531,w0,100,2569,4,152,0,COMPLETED_WALLTIME_REACHED,23565,152,23717,20996,21148,139.1315789473684,4 5 6 7,-1
532,w0,100,2576,4,150,0,COMPLETED_WALLTIME_REACHED,23572,150,23722,20996,21146,140.97333333333333,10 13 14 15,-1
534,w0,100,2590,4,153,0,COMPLETED_WALLTIME_REACHED,23574,153,23727,20984,21137,138.15032679738562,8 9 11 12,-1
580,w0,100,2818,3,150,0,COMPLETED_WALLTIME_REACHED,23587,150,23737,20769,20919,139.46,0 1 2,-1
535,w0,100,2592,5,151,0,COMPLETED_WALLTIME_REACHED,23717,151,23868,21125,21276,140.90066225165563,3 4 5 6 7,-1
537,w0,100,2606,4,153,0,COMPLETED_WALLTIME_REACHED,23722,153,23875,21116,21269,139.01307189542484,10 13 14 15,-1
538,w0,100,2610,5,148,0,COMPLETED_WALLTIME_REACHED,23737,148,23885,21127,21275,143.75,0 1 2 8 9,-1
539,w0,100,2612,4,151,0,COMPLETED_WALLTIME_REACHED,23868,151,24019,21256,21407,141.7682119205298,3 4 5 6,-1
581,w0,100,2822,3,151,0,COMPLETED_WALLTIME_REACHED,23868,151,24019,21046,21197,140.3774834437086,7 11 12,-1
540,w0,100,2619,4,151,0,COMPLETED_WALLTIME_REACHED,23875,151,24026,21256,21407,141.7682119205298,10 13 14 15,-1
542,w0,100,2636,4,152,0,COMPLETED_WALLTIME_REACHED,23885,152,24037,21249,21401,140.79605263157896,0 1 2 8,-1
541,w0,100,2629,6,152,0,COMPLETED_WALLTIME_REACHED,24019,152,24171,21390,21542,141.72368421052633,3 4 5 6 7 9,-1
543,w0,100,2642,5,156,0,COMPLETED_WALLTIME_REACHED,24026,156,24182,21384,21540,138.07692307692307,10 11 12 13 14,-1
544,w0,100,2651,4,148,0,COMPLETED_WALLTIME_REACHED,24037,148,24185,21386,21534,145.5,0 1 2 8,-1
545,w0,100,2673,5,149,0,COMPLETED_WALLTIME_REACHED,24171,149,24320,21498,21647,145.28187919463087,3 4 5 6 7,-1
546,w0,100,2680,4,148,0,COMPLETED_WALLTIME_REACHED,24182,148,24330,21502,21650,146.28378378378378,9 10 11 12,-1
548,w0,100,2682,5,148,0,COMPLETED_WALLTIME_REACHED,24185,148,24333,21503,21651,146.29054054054055,0 1 2 8 13,-1
549,w0,100,2688,6,151,0,COMPLETED_WALLTIME_REACHED,24320,151,24471,21632,21783,144.25827814569536,3 4 5 6 7 14,-1
550,w0,100,2690,4,148,0,COMPLETED_WALLTIME_REACHED,24330,148,24478,21640,21788,147.21621621621622,9 10 11 12,-1
551,w0,100,2694,5,153,0,COMPLETED_WALLTIME_REACHED,24333,153,24486,21639,21792,142.4313725490196,0 1 2 8 13,-1
552,w0,100,2695,6,148,0,COMPLETED_WALLTIME_REACHED,24471,148,24619,21776,21924,148.13513513513513,3 4 5 6 7 14,-1
561,w0,100,2723,4,148,0,COMPLETED_WALLTIME_REACHED,24478,148,24626,21755,21903,147.99324324324326,9 10 11 12,-1
553,w0,100,2698,6,153,0,COMPLETED_WALLTIME_REACHED,24486,153,24639,21788,21941,143.40522875816993,0 1 2 8 13 15,-1
554,w0,100,2702,6,152,0,COMPLETED_WALLTIME_REACHED,24619,152,24771,21917,22069,145.19078947368422,3 4 5 6 7 14,-1
571,w0,100,2776,4,149,0,COMPLETED_WALLTIME_REACHED,24626,149,24775,21850,21999,147.64429530201343,9 10 11 12,-1
555,w0,100,2704,5,149,0,COMPLETED_WALLTIME_REACHED,24639,149,24788,21935,22084,148.21476510067114,0 1 2 8 13,-1
556,w0,100,2710,5,150,0,COMPLETED_WALLTIME_REACHED,24771,150,24921,22061,22211,148.07333333333332,3 4 5 6 7,-1
557,w0,100,2714,6,149,0,COMPLETED_WALLTIME_REACHED,24775,149,24924,22061,22210,149.06040268456377,9 10 11 12 14 15,-1
573,w0,100,2783,4,151,0,COMPLETED_WALLTIME_REACHED,24788,151,24939,22005,22156,146.72847682119206,0 1 2 8,-1
558,w0,100,2714,6,149,0,COMPLETED_WALLTIME_REACHED,24921,149,25070,22207,22356,150.04026845637583,3 4 5 6 7 13,-1
559,w0,100,2718,5,147,0,COMPLETED_WALLTIME_REACHED,24924,147,25071,22206,22353,152.0612244897959,9 10 11 12 14,-1
560,w0,100,2719,5,149,0,COMPLETED_WALLTIME_REACHED,24939,149,25088,22220,22369,150.1275167785235,0 1 2 8 15,-1
562,w0,100,2732,5,150,0,COMPLETED_WALLTIME_REACHED,25070,150,25220,22338,22488,149.92,3 4 5 6 7,-1
563,w0,100,2740,5,149,0,COMPLETED_WALLTIME_REACHED,25071,149,25220,22331,22480,150.8724832214765,9 10 11 12 13,-1
564,w0,100,2744,5,150,0,COMPLETED_WALLTIME_REACHED,25088,150,25238,22344,22494,149.96,0 1 2 8 14,-1
566,w0,100,2763,5,149,0,COMPLETED_WALLTIME_REACHED,25220,149,25369,22457,22606,151.71812080536913,3 4 5 6 7,-1
567,w0,100,2764,5,149,0,COMPLETED_WALLTIME_REACHED,25220,149,25369,22456,22605,151.71140939597316,9 10 11 12 13,-1
568,w0,100,2767,5,149,0,COMPLETED_WALLTIME_REACHED,25238,149,25387,22471,22620,151.81208053691276,0 1 2 8 14,-1
569,w0,100,2770,5,151,0,COMPLETED_WALLTIME_REACHED,25369,151,25520,22599,22750,150.66225165562915,3 4 5 6 7,-1
570,w0,100,2773,5,151,0,COMPLETED_WALLTIME_REACHED,25369,151,25520,22596,22747,150.64238410596028,9 10 11 12 13,-1
572,w0,100,2776,5,153,0,COMPLETED_WALLTIME_REACHED,25387,153,25540,22611,22764,148.7843137254902,0 1 2 8 14,-1
574,w0,100,2783,4,153,0,COMPLETED_WALLTIME_REACHED,25520,153,25673,22737,22890,149.6078431372549,3 4 5 6,-1
575,w0,100,2788,6,149,0,COMPLETED_WALLTIME_REACHED,25520,149,25669,22732,22881,153.56375838926175,7 9 10 11 12 13,-1
576,w0,100,2792,6,153,0,COMPLETED_WALLTIME_REACHED,25540,153,25693,22748,22901,149.6797385620915,0 1 2 8 14 15,-1
577,w0,100,2794,4,146,0,COMPLETED_WALLTIME_REACHED,25669,146,25815,22875,23021,157.67808219178082,7 9 10 11,-1
578,w0,100,2795,4,149,0,COMPLETED_WALLTIME_REACHED,25673,149,25822,22878,23027,154.54362416107384,3 4 5 6,-1
579,w0,100,2795,5,154,0,COMPLETED_WALLTIME_REACHED,25693,154,25847,22898,23052,149.6883116883117,0 1 2 8 12,-1
585,w0,100,2837,3,149,0,COMPLETED_WALLTIME_REACHED,25693,149,25842,22856,23005,154.39597315436242,13 14 15,-1
582,w0,100,2835,4,150,0,COMPLETED_WALLTIME_REACHED,25815,150,25965,22980,23130,154.2,7 9 10 11,-1
583,w0,100,2835,4,149,0,COMPLETED_WALLTIME_REACHED,25822,149,25971,22987,23136,155.2751677852349,3 4 5 6,-1
591,w0,100,2861,3,151,0,COMPLETED_WALLTIME_REACHED,25842,151,25993,22981,23132,153.19205298013244,13 14 15,-1
584,w0,100,2837,5,153,0,COMPLETED_WALLTIME_REACHED,25847,153,26000,23010,23163,151.3921568627451,0 1 2 8 12,-1
586,w0,100,2838,4,155,0,COMPLETED_WALLTIME_REACHED,25965,155,26120,23127,23282,150.20645161290324,7 9 10 11,-1
587,w0,100,2840,4,150,0,COMPLETED_WALLTIME_REACHED,25971,150,26121,23131,23281,155.20666666666668,3 4 5 6,-1
599,w0,100,2890,3,150,0,COMPLETED_WALLTIME_REACHED,25993,150,26143,23103,23253,155.02,13 14 15,-1
588,w0,100,2843,5,154,0,COMPLETED_WALLTIME_REACHED,26000,154,26154,23157,23311,151.37012987012986,0 1 2 8 12,-1
603,w0,100,2906,3,149,0,COMPLETED_WALLTIME_REACHED,26120,149,26269,23214,23363,156.7986577181208,7 9 10,-1
589,w0,100,2851,5,151,0,COMPLETED_WALLTIME_REACHED,26121,151,26272,23270,23421,155.10596026490066,3 4 5 6 11,-1
608,w0,100,2919,3,149,0,COMPLETED_WALLTIME_REACHED,26143,149,26292,23224,23373,156.86577181208054,13 14 15,-1
590,w0,100,2856,5,150,0,COMPLETED_WALLTIME_REACHED,26154,150,26304,23298,23448,156.32,0 1 2 8 12,-1
609,w0,100,2919,3,148,0,COMPLETED_WALLTIME_REACHED,26269,148,26417,23350,23498,158.77027027027026,7 9 10,-1
592,w0,100,2862,5,151,0,COMPLETED_WALLTIME_REACHED,26272,151,26423,23410,23561,156.03311258278146,3 4 5 6 11,-1
593,w0,100,2867,6,150,0,COMPLETED_WALLTIME_REACHED,26304,150,26454,23437,23587,157.24666666666667,0 1 2 8 12 13,-1
594,w0,100,2870,4,150,0,COMPLETED_WALLTIME_REACHED,26417,150,26567,23547,23697,157.98,7 9 10 14,-1
595,w0,100,2872,6,150,0,COMPLETED_WALLTIME_REACHED,26423,150,26573,23551,23701,158.00666666666666,3 4 5 6 11 15,-1
596,w0,100,2876,6,150,0,COMPLETED_WALLTIME_REACHED,26454,150,26604,23578,23728,158.18666666666667,0 1 2 8 12 13,-1
600,w0,100,2894,4,153,0,COMPLETED_WALLTIME_REACHED,26567,153,26720,23673,23826,155.72549019607843,7 9 10 14,-1
597,w0,100,2876,5,150,0,COMPLETED_WALLTIME_REACHED,26573,150,26723,23697,23847,158.98,3 4 5 6 11,-1
598,w0,100,2890,5,154,0,COMPLETED_WALLTIME_REACHED,26604,154,26758,23714,23868,154.98701298701297,0 1 2 8 12,-1
601,w0,100,2895,6,148,0,COMPLETED_WALLTIME_REACHED,26720,148,26868,23825,23973,161.97972972972974,7 9 10 13 14 15,-1
602,w0,100,2905,5,148,0,COMPLETED_WALLTIME_REACHED,26723,148,26871,23818,23966,161.93243243243242,3 4 5 6 11,-1
604,w0,100,2912,4,147,0,COMPLETED_WALLTIME_REACHED,26758,147,26905,23846,23993,163.21768707482994,0 1 2 8,-1
605,w0,100,2913,5,149,0,COMPLETED_WALLTIME_REACHED,26868,149,27017,23955,24104,161.7718120805369,7 9 10 12 13,-1
606,w0,100,2916,4,151,0,COMPLETED_WALLTIME_REACHED,26871,151,27022,23955,24106,159.64238410596028,3 4 5 6,-1
613,w0,100,2931,3,152,0,COMPLETED_WALLTIME_REACHED,26871,152,27023,23940,24092,158.5,11 14 15,-1
607,w0,100,2918,4,151,0,COMPLETED_WALLTIME_REACHED,26905,151,27056,23987,24138,159.8543046357616,0 1 2 8,-1
610,w0,100,2924,5,151,0,COMPLETED_WALLTIME_REACHED,27017,151,27168,24093,24244,160.5562913907285,7 9 10 12 13,-1
611,w0,100,2927,5,151,0,COMPLETED_WALLTIME_REACHED,27023,151,27174,24096,24247,160.57615894039736,3 4 5 6 11,-1
612,w0,100,2930,4,153,0,COMPLETED_WALLTIME_REACHED,27056,153,27209,24126,24279,158.68627450980392,0 1 2 8,-1
614,w0,100,2934,3,149,0,COMPLETED_WALLTIME_REACHED,27168,149,27317,24234,24383,163.64429530201343,7 9 10,-1
615,w0,100,2936,4,151,0,COMPLETED_WALLTIME_REACHED,27168,151,27319,24232,24383,161.47682119205297,12 13 14 15,-1
616,w0,100,2944,3,151,0,COMPLETED_WALLTIME_REACHED,27174,151,27325,24230,24381,161.46357615894038,3 4 5,-1
617,w0,100,2947,5,152,0,COMPLETED_WALLTIME_REACHED,27209,152,27361,24262,24414,160.6184210526316,0 1 2 6 8,-1
618,w0,100,2948,6,147,0,COMPLETED_WALLTIME_REACHED,27319,147,27466,24371,24518,166.7891156462585,7 9 10 11 12 13,-1
619,w0,100,2954,5,150,0,COMPLETED_WALLTIME_REACHED,27325,150,27475,24371,24521,163.47333333333333,3 4 5 14 15,-1
620,w0,100,2970,5,146,0,COMPLETED_WALLTIME_REACHED,27361,146,27507,24391,24537,168.06164383561645,0 1 2 6 8,-1
621,w0,100,2974,5,153,0,COMPLETED_WALLTIME_REACHED,27466,153,27619,24492,24645,161.07843137254903,7 9 10 11 12,-1
622,w0,100,2976,5,150,0,COMPLETED_WALLTIME_REACHED,27475,150,27625,24499,24649,164.32666666666665,3 4 5 13 14,-1
623,w0,100,2979,5,152,0,COMPLETED_WALLTIME_REACHED,27507,152,27659,24528,24680,162.3684210526316,0 1 2 6 8,-1
624,w0,100,2979,5,150,0,COMPLETED_WALLTIME_REACHED,27619,150,27769,24640,24790,165.26666666666668,7 9 10 11 12,-1
625,w0,100,2983,5,153,0,COMPLETED_WALLTIME_REACHED,27625,153,27778,24642,24795,162.05882352941177,3 4 5 13 14,-1
626,w0,100,2988,4,151,0,COMPLETED_WALLTIME_REACHED,27659,151,27810,24671,24822,164.3841059602649,0 1 2 6,-1
627,w0,100,2990,4,151,0,COMPLETED_WALLTIME_REACHED,27769,151,27920,24779,24930,165.09933774834437,7 8 9 10,-1
628,w0,100,3000,3,147,0,COMPLETED_WALLTIME_REACHED,27769,147,27916,24769,24916,169.49659863945578,11 12 15,-1
629,w0,100,3003,4,151,0,COMPLETED_WALLTIME_REACHED,27778,151,27929,24775,24926,165.0728476821192,3 4 5 13,-1
630,w0,100,3005,5,152,0,COMPLETED_WALLTIME_REACHED,27810,152,27962,24805,24957,164.19078947368422,0 1 2 6 14,-1
631,w0,100,3006,6,152,0,COMPLETED_WALLTIME_REACHED,27920,152,28072,24914,25066,164.9078947368421,7 8 9 10 11 12,-1
632,w0,100,3007,5,149,0,COMPLETED_WALLTIME_REACHED,27929,149,28078,24922,25071,168.26174496644296,3 4 5 13 15,-1
633,w0,100,3011,3,149,0,COMPLETED_WALLTIME_REACHED,27962,149,28111,24951,25100,168.45637583892616,0 1 2,-1
634,w0,100,3011,3,150,0,COMPLETED_WALLTIME_REACHED,28072,150,28222,25061,25211,168.07333333333332,6 7 8,-1
635,w0,100,3024,5,146,0,COMPLETED_WALLTIME_REACHED,28072,146,28218,25048,25194,172.56164383561645,9 10 11 12 14,-1
636,w0,100,3027,4,148,0,COMPLETED_WALLTIME_REACHED,28078,148,28226,25051,25199,170.26351351351352,3 4 5 13,-1
642,w0,100,3043,3,146,0,COMPLETED_WALLTIME_REACHED,28111,146,28257,25068,25214,172.6986301369863,0 1 2,-1
637,w0,100,3027,6,150,0,COMPLETED_WALLTIME_REACHED,28218,150,28368,25191,25341,168.94,9 10 11 12 14 15,-1
638,w0,100,3028,5,148,0,COMPLETED_WALLTIME_REACHED,28226,148,28374,25198,25346,171.25675675675674,3 4 5 6 7,-1
639,w0,100,3032,5,153,0,COMPLETED_WALLTIME_REACHED,28257,153,28410,25225,25378,165.86928104575162,0 1 2 8 13,-1
640,w0,100,3036,6,152,0,COMPLETED_WALLTIME_REACHED,28368,152,28520,25332,25484,167.6578947368421,9 10 11 12 14 15,-1
641,w0,100,3039,5,150,0,COMPLETED_WALLTIME_REACHED,28374,150,28524,25335,25485,169.9,3 4 5 6 7,-1
643,w0,100,3048,4,147,0,COMPLETED_WALLTIME_REACHED,28410,147,28557,25362,25509,173.53061224489795,0 1 2 8,-1
644,w0,100,3052,4,150,0,COMPLETED_WALLTIME_REACHED,28520,150,28670,25468,25618,170.78666666666666,9 10 11 12,-1
646,w0,100,3059,3,150,0,COMPLETED_WALLTIME_REACHED,28520,150,28670,25461,25611,170.74,13 14 15,-1
645,w0,100,3057,5,149,0,COMPLETED_WALLTIME_REACHED,28524,149,28673,25467,25616,171.91946308724832,3 4 5 6 7,-1
648,w0,100,3061,4,151,0,COMPLETED_WALLTIME_REACHED,28557,151,28708,25496,25647,169.8476821192053,0 1 2 8,-1
647,w0,100,3060,6,151,0,COMPLETED_WALLTIME_REACHED,28670,151,28821,25610,25761,170.60264900662253,9 10 11 12 13 14,-1
649,w0,100,3063,5,151,0,COMPLETED_WALLTIME_REACHED,28673,151,28824,25610,25761,170.60264900662253,3 4 5 6 7,-1
650,w0,100,3066,4,149,0,COMPLETED_WALLTIME_REACHED,28708,149,28857,25642,25791,173.09395973154363,0 1 2 8,-1
651,w0,100,3069,6,150,0,COMPLETED_WALLTIME_REACHED,28821,150,28971,25752,25902,172.68,9 10 11 12 13 14,-1
652,w0,100,3072,3,152,0,COMPLETED_WALLTIME_REACHED,28824,152,28976,25752,25904,170.42105263157896,3 4 5,-1
653,w0,100,3088,3,150,0,COMPLETED_WALLTIME_REACHED,28824,150,28974,25736,25886,172.57333333333332,6 7 15,-1
654,w0,100,3091,3,152,0,COMPLETED_WALLTIME_REACHED,28857,152,29009,25766,25918,170.51315789473685,0 1 2,-1
655,w0,100,3098,4,152,0,COMPLETED_WALLTIME_REACHED,28971,152,29123,25873,26025,171.2171052631579,8 9 10 11,-1
656,w0,100,3101,5,150,0,COMPLETED_WALLTIME_REACHED,28974,150,29124,25873,26023,173.48666666666668,6 7 12 13 14,-1
657,w0,100,3106,4,149,0,COMPLETED_WALLTIME_REACHED,28976,149,29125,25870,26019,174.6241610738255,3 4 5 15,-1
658,w0,100,3107,5,151,0,COMPLETED_WALLTIME_REACHED,29123,151,29274,26016,26167,173.2913907284768,0 1 2 8 9,-1
659,w0,100,3108,4,153,0,COMPLETED_WALLTIME_REACHED,29124,153,29277,26016,26169,171.0392156862745,6 7 10 11,-1
660,w0,100,3112,3,149,0,COMPLETED_WALLTIME_REACHED,29124,149,29273,26012,26161,175.5771812080537,12 13 14,-1
672,w0,100,3163,4,146,0,COMPLETED_WALLTIME_REACHED,29125,146,29271,25962,26108,178.82191780821918,3 4 5 15,-1
661,w0,100,3116,5,148,0,COMPLETED_WALLTIME_REACHED,29273,148,29421,26157,26305,177.73648648648648,3 4 5 12 13,-1
662,w0,100,3125,6,155,0,COMPLETED_WALLTIME_REACHED,29274,155,29429,26149,26304,169.70322580645163,0 1 2 8 9 14,-1
663,w0,100,3133,4,151,0,COMPLETED_WALLTIME_REACHED,29277,151,29428,26144,26295,174.13907284768212,6 7 10 11,-1
665,w0,100,3144,4,151,0,COMPLETED_WALLTIME_REACHED,29421,151,29572,26277,26428,175.01986754966887,3 4 5 12,-1
666,w0,100,3148,4,152,0,COMPLETED_WALLTIME_REACHED,29428,152,29580,26280,26432,173.89473684210526,6 7 10 11,-1
667,w0,100,3152,4,149,0,COMPLETED_WALLTIME_REACHED,29429,149,29578,26277,26426,177.35570469798657,0 1 2 8,-1
668,w0,100,3155,7,147,0,COMPLETED_WALLTIME_REACHED,29572,147,29719,26417,26564,180.7074829931973,3 4 5 9 12 13 14,-1
669,w0,100,3156,4,150,0,COMPLETED_WALLTIME_REACHED,29578,150,29728,26422,26572,177.14666666666668,0 1 2 8,-1
670,w0,100,3158,5,149,0,COMPLETED_WALLTIME_REACHED,29580,149,29729,26422,26571,178.3288590604027,6 7 10 11 15,-1
671,w0,100,3162,7,150,0,COMPLETED_WALLTIME_REACHED,29719,150,29869,26557,26707,178.04666666666665,3 4 5 9 12 13 14,-1
673,w0,100,3165,4,148,0,COMPLETED_WALLTIME_REACHED,29728,148,29876,26563,26711,180.47972972972974,0 1 2 8,-1
674,w0,100,3168,4,148,0,COMPLETED_WALLTIME_REACHED,29729,148,29877,26561,26709,180.46621621621622,6 7 10 11,-1
675,w0,100,3168,6,149,0,COMPLETED_WALLTIME_REACHED,29869,149,30018,26701,26850,180.2013422818792,3 4 5 9 12 13,-1
676,w0,100,3171,4,145,0,COMPLETED_WALLTIME_REACHED,29876,145,30021,26705,26850,185.17241379310346,0 1 2 8,-1
678,w0,100,3186,6,150,0,COMPLETED_WALLTIME_REACHED,29877,150,30027,26691,26841,178.94,6 7 10 11 14 15,-1
679,w0,100,3187,5,152,0,COMPLETED_WALLTIME_REACHED,30018,152,30170,26831,26983,177.51973684210526,3 4 5 9 12,-1
680,w0,100,3187,4,150,0,COMPLETED_WALLTIME_REACHED,30021,150,30171,26834,26984,179.89333333333335,0 1 2 8,-1
681,w0,100,3187,3,150,0,COMPLETED_WALLTIME_REACHED,30027,150,30177,26840,26990,179.93333333333334,6 7 10,-1
683,w0,100,3198,3,150,0,COMPLETED_WALLTIME_REACHED,30027,150,30177,26829,26979,179.86,11 13 14,-1
684,w0,100,3201,6,152,0,COMPLETED_WALLTIME_REACHED,30170,152,30322,26969,27121,178.42763157894737,3 4 5 9 12 15,-1
685,w0,100,3205,4,155,0,COMPLETED_WALLTIME_REACHED,30171,155,30326,26966,27121,174.9741935483871,0 1 2 8,-1
686,w0,100,3210,4,146,0,COMPLETED_WALLTIME_REACHED,30177,146,30323,26967,27113,185.7054794520548,6 7 10 11,-1
687,w0,100,3210,3,150,0,COMPLETED_WALLTIME_REACHED,30322,150,30472,27112,27262,181.74666666666667,3 4 5,-1
688,w0,100,3213,4,149,0,COMPLETED_WALLTIME_REACHED,30322,149,30471,27109,27258,182.93959731543623,9 12 13 14,-1
700,w0,100,3264,3,148,0,COMPLETED_WALLTIME_REACHED,30323,148,30471,27059,27207,183.8310810810811,6 7 10,-1
689,w0,100,3227,6,151,0,COMPLETED_WALLTIME_REACHED,30326,151,30477,27099,27250,180.46357615894038,0 1 2 8 11 15,-1
691,w0,100,3238,4,150,0,COMPLETED_WALLTIME_REACHED,30471,150,30621,27233,27383,182.55333333333334,6 7 9 10,-1
692,w0,100,3241,4,148,0,COMPLETED_WALLTIME_REACHED,30472,148,30620,27231,27379,184.99324324324326,3 4 5 12,-1
693,w0,100,3243,4,146,0,COMPLETED_WALLTIME_REACHED,30477,146,30623,27234,27380,187.53424657534248,0 1 2 8,-1
694,w0,100,3246,4,150,0,COMPLETED_WALLTIME_REACHED,30477,150,30627,27231,27381,182.54,11 13 14 15,-1
708,w0,100,3301,3,146,0,COMPLETED_WALLTIME_REACHED,30620,146,30766,27319,27465,188.1164383561644,3 4 5,-1
695,w0,100,3248,5,156,0,COMPLETED_WALLTIME_REACHED,30621,156,30777,27373,27529,176.46794871794873,6 7 9 10 12,-1
696,w0,100,3259,4,146,0,COMPLETED_WALLTIME_REACHED,30623,146,30769,27364,27510,188.42465753424656,0 1 2 8,-1
697,w0,100,3260,5,151,0,COMPLETED_WALLTIME_REACHED,30766,151,30917,27506,27657,183.158940397351,3 4 5 11 13,-1
698,w0,100,3261,5,148,0,COMPLETED_WALLTIME_REACHED,30769,148,30917,27508,27656,186.86486486486487,0 1 2 8 14,-1
699,w0,100,3262,4,148,0,COMPLETED_WALLTIME_REACHED,30777,148,30925,27515,27663,186.91216216216216,6 7 9 10,-1
701,w0,100,3267,6,151,0,COMPLETED_WALLTIME_REACHED,30917,151,31068,27650,27801,184.11258278145695,0 1 2 3 4 5,-1
702,w0,100,3269,4,147,0,COMPLETED_WALLTIME_REACHED,30917,147,31064,27648,27795,189.08163265306123,8 11 12 13,-1
703,w0,100,3283,6,153,0,COMPLETED_WALLTIME_REACHED,30925,153,31078,27642,27795,181.66666666666666,6 7 9 10 14 15,-1
704,w0,100,3286,4,151,0,COMPLETED_WALLTIME_REACHED,31064,151,31215,27778,27929,184.96026490066225,8 11 12 13,-1
705,w0,100,3289,6,153,0,COMPLETED_WALLTIME_REACHED,31068,153,31221,27779,27932,182.56209150326796,0 1 2 3 4 5,-1
706,w0,100,3293,4,150,0,COMPLETED_WALLTIME_REACHED,31078,150,31228,27785,27935,186.23333333333332,6 7 9 10,-1
707,w0,100,3300,4,150,0,COMPLETED_WALLTIME_REACHED,31215,150,31365,27915,28065,187.1,8 11 12 13,-1
709,w0,100,3301,6,149,0,COMPLETED_WALLTIME_REACHED,31221,149,31370,27920,28069,188.38255033557047,0 1 2 3 4 5,-1
710,w0,100,3303,4,151,0,COMPLETED_WALLTIME_REACHED,31228,151,31379,27925,28076,185.9337748344371,6 7 9 10,-1
711,w0,100,3312,5,150,0,COMPLETED_WALLTIME_REACHED,31365,150,31515,28053,28203,188.02,8 11 12 13 14,-1
712,w0,100,3316,5,152,0,COMPLETED_WALLTIME_REACHED,31370,152,31522,28054,28206,185.56578947368422,0 1 2 3 4,-1
718,w0,100,3361,3,153,0,COMPLETED_WALLTIME_REACHED,31379,153,31532,28018,28171,184.12418300653596,5 6 7,-1
713,w0,100,3326,7,151,0,COMPLETED_WALLTIME_REACHED,31515,151,31666,28189,28340,187.68211920529802,8 9 10 11 12 13 14,-1
714,w0,100,3330,5,148,0,COMPLETED_WALLTIME_REACHED,31522,148,31670,28192,28340,191.48648648648648,0 1 2 3 4,-1
719,w0,100,3371,4,148,0,COMPLETED_WALLTIME_REACHED,31532,148,31680,28161,28309,191.27702702702703,5 6 7 15,-1
715,w0,100,3342,5,152,0,COMPLETED_WALLTIME_REACHED,31666,152,31818,28324,28476,187.3421052631579,8 9 10 11 12,-1
716,w0,100,3352,5,152,0,COMPLETED_WALLTIME_REACHED,31670,152,31822,28318,28470,187.30263157894737,0 1 2 3 4,-1
717,w0,100,3356,5,150,0,COMPLETED_WALLTIME_REACHED,31680,150,31830,28324,28474,189.82666666666665,5 6 7 13 14,-1
720,w0,100,3376,4,153,0,COMPLETED_WALLTIME_REACHED,31818,153,31971,28442,28595,186.8954248366013,8 9 10 11,-1
721,w0,100,3376,3,149,0,COMPLETED_WALLTIME_REACHED,31822,149,31971,28446,28595,191.91275167785236,0 1 2,-1
722,w0,100,3386,4,149,0,COMPLETED_WALLTIME_REACHED,31822,149,31971,28436,28585,191.84563758389262,3 4 12 15,-1
723,w0,100,3387,4,147,0,COMPLETED_WALLTIME_REACHED,31830,147,31977,28443,28590,194.48979591836735,5 6 7 13,-1
724,w0,100,3400,4,151,0,COMPLETED_WALLTIME_REACHED,31971,151,32122,28571,28722,190.21192052980132,0 1 2 3,-1
725,w0,100,3404,5,154,0,COMPLETED_WALLTIME_REACHED,31971,154,32125,28567,28721,186.5,4 8 9 10 11,-1
726,w0,100,3405,5,148,0,COMPLETED_WALLTIME_REACHED,31977,148,32125,28572,28720,194.05405405405406,5 6 7 12 13,-1
727,w0,100,3408,4,150,0,COMPLETED_WALLTIME_REACHED,32122,150,32272,28714,28864,192.42666666666668,0 1 2 3,-1
728,w0,100,3412,5,151,0,COMPLETED_WALLTIME_REACHED,32125,151,32276,28713,28864,191.1523178807947,4 5 6 7 8,-1
729,w0,100,3446,6,152,0,COMPLETED_WALLTIME_REACHED,32125,152,32277,28679,28831,189.67763157894737,9 10 11 12 13 14,-1
733,w0,100,3482,3,151,0,COMPLETED_WALLTIME_REACHED,32272,151,32423,28790,28941,191.66225165562915,0 1 2,-1
730,w0,100,3461,6,153,0,COMPLETED_WALLTIME_REACHED,32276,153,32429,28815,28968,189.33333333333334,3 4 5 6 7 8,-1
731,w0,100,3462,5,152,0,COMPLETED_WALLTIME_REACHED,32277,152,32429,28815,28967,190.57236842105263,9 10 11 12 13,-1
732,w0,100,3479,5,149,0,COMPLETED_WALLTIME_REACHED,32423,149,32572,28944,29093,195.25503355704697,0 1 2 14 15,-1
734,w0,100,3487,6,148,0,COMPLETED_WALLTIME_REACHED,32429,148,32577,28942,29090,196.55405405405406,3 4 5 6 7 8,-1
735,w0,100,3492,4,152,0,COMPLETED_WALLTIME_REACHED,32429,152,32581,28937,29089,191.375,9 10 11 12,-1
736,w0,100,3503,4,148,0,COMPLETED_WALLTIME_REACHED,32572,148,32720,29069,29217,197.41216216216216,0 1 2 13,-1
737,w0,100,3503,5,152,0,COMPLETED_WALLTIME_REACHED,32577,152,32729,29074,29226,192.27631578947367,3 4 5 6 7,-1
738,w0,100,3510,6,152,0,COMPLETED_WALLTIME_REACHED,32581,152,32733,29071,29223,192.2565789473684,8 9 10 11 12 14,-1
739,w0,100,3514,5,152,0,COMPLETED_WALLTIME_REACHED,32720,152,32872,29206,29358,193.14473684210526,0 1 2 13 15,-1
740,w0,100,3524,4,153,0,COMPLETED_WALLTIME_REACHED,32729,153,32882,29205,29358,191.88235294117646,3 4 5 6,-1
741,w0,100,3529,3,150,0,COMPLETED_WALLTIME_REACHED,32733,150,32883,29204,29354,195.69333333333333,7 8 9,-1
742,w0,100,3531,3,146,0,COMPLETED_WALLTIME_REACHED,32733,146,32879,29202,29348,201.013698630137,10 11 12,-1
743,w0,100,3547,5,149,0,COMPLETED_WALLTIME_REACHED,32872,149,33021,29325,29474,197.81208053691276,0 1 2 13 14,-1
745,w0,100,3557,3,149,0,COMPLETED_WALLTIME_REACHED,32879,149,33028,29322,29471,197.79194630872485,10 11 12,-1
744,w0,100,3548,5,149,0,COMPLETED_WALLTIME_REACHED,32882,149,33031,29334,29483,197.8724832214765,3 4 5 6 15,-1
747,w0,100,3565,3,151,0,COMPLETED_WALLTIME_REACHED,32883,151,33034,29318,29469,195.158940397351,7 8 9,-1
746,w0,100,3563,5,148,0,COMPLETED_WALLTIME_REACHED,33021,148,33169,29458,29606,200.04054054054055,0 1 2 13 14,-1
748,w0,100,3570,6,146,0,COMPLETED_WALLTIME_REACHED,33031,146,33177,29461,29607,202.7876712328767,3 4 5 6 10 11,-1
749,w0,100,3571,3,151,0,COMPLETED_WALLTIME_REACHED,33034,151,33185,29463,29614,196.11920529801324,7 8 9,-1
750,w0,100,3571,3,149,0,COMPLETED_WALLTIME_REACHED,33169,149,33318,29598,29747,199.64429530201343,0 1 2,-1
751,w0,100,3577,3,150,0,COMPLETED_WALLTIME_REACHED,33169,150,33319,29592,29742,198.28,12 13 14,-1
752,w0,100,3581,6,149,0,COMPLETED_WALLTIME_REACHED,33177,149,33326,29596,29745,199.63087248322148,3 4 5 6 10 11,-1
753,w0,100,3581,5,151,0,COMPLETED_WALLTIME_REACHED,33318,151,33469,29737,29888,197.9337748344371,0 1 2 7 8,-1
754,w0,100,3611,3,149,0,COMPLETED_WALLTIME_REACHED,33319,149,33468,29708,29857,200.38255033557047,9 12 13,-1
755,w0,100,3619,4,149,0,COMPLETED_WALLTIME_REACHED,33326,149,33475,29707,29856,200.3758389261745,3 4 5 6,-1
756,w0,100,3640,4,150,0,COMPLETED_WALLTIME_REACHED,33326,150,33476,29686,29836,198.90666666666667,10 11 14 15,-1
761,w0,100,3671,3,150,0,COMPLETED_WALLTIME_REACHED,33468,150,33618,29797,29947,199.64666666666668,9 12 13,-1
757,w0,100,3647,5,147,0,COMPLETED_WALLTIME_REACHED,33469,147,33616,29822,29969,203.87074829931973,0 1 2 7 8,-1
763,w0,100,3679,3,152,0,COMPLETED_WALLTIME_REACHED,33475,152,33627,29796,29948,197.02631578947367,3 4 5,-1
758,w0,100,3661,5,150,0,COMPLETED_WALLTIME_REACHED,33476,150,33626,29815,29965,199.76666666666668,6 10 11 14 15,-1
759,w0,100,3662,4,152,0,COMPLETED_WALLTIME_REACHED,33616,152,33768,29954,30106,198.06578947368422,0 1 2 7,-1
760,w0,100,3662,4,151,0,COMPLETED_WALLTIME_REACHED,33618,151,33769,29956,30107,199.3841059602649,8 9 12 13,-1
762,w0,100,3676,6,150,0,COMPLETED_WALLTIME_REACHED,33627,150,33777,29951,30101,200.67333333333335,3 4 5 6 10 11,-1
764,w0,100,3680,3,151,0,COMPLETED_WALLTIME_REACHED,33768,151,33919,30088,30239,200.25827814569536,0 1 2,-1
765,w0,100,3690,3,148,0,COMPLETED_WALLTIME_REACHED,33768,148,33916,30078,30226,204.22972972972974,7 14 15,-1
767,w0,100,3702,3,149,0,COMPLETED_WALLTIME_REACHED,33769,149,33918,30067,30216,202.79194630872485,8 9 12,-1
766,w0,100,3700,5,150,0,COMPLETED_WALLTIME_REACHED,33777,150,33927,30077,30227,201.51333333333332,3 4 5 6 10,-1
768,w0,100,3703,3,151,0,COMPLETED_WALLTIME_REACHED,33916,151,34067,30213,30364,201.08609271523179,7 11 13,-1
769,w0,100,3705,4,151,0,COMPLETED_WALLTIME_REACHED,33918,151,34069,30213,30364,201.08609271523179,8 9 12 14,-1
770,w0,100,3709,4,151,0,COMPLETED_WALLTIME_REACHED,33919,151,34070,30210,30361,201.0662251655629,0 1 2 15,-1
771,w0,100,3713,3,147,0,COMPLETED_WALLTIME_REACHED,33927,147,34074,30214,30361,206.5374149659864,3 4 5,-1
772,w0,100,3716,3,150,0,COMPLETED_WALLTIME_REACHED,34067,150,34217,30351,30501,203.34,6 7 10,-1
773,w0,100,3719,5,148,0,COMPLETED_WALLTIME_REACHED,34069,148,34217,30350,30498,206.06756756756758,8 9 11 12 13,-1
774,w0,100,3725,4,151,0,COMPLETED_WALLTIME_REACHED,34070,151,34221,30345,30496,201.96026490066225,0 1 2 14,-1
779,w0,100,3737,4,151,0,COMPLETED_WALLTIME_REACHED,34074,151,34225,30337,30488,201.90728476821192,3 4 5 15,-1
775,w0,100,3726,5,151,0,COMPLETED_WALLTIME_REACHED,34217,151,34368,30491,30642,202.9271523178808,6 7 8 9 10,-1
776,w0,100,3732,5,152,0,COMPLETED_WALLTIME_REACHED,34221,152,34373,30489,30641,201.58552631578948,0 1 2 11 12,-1
777,w0,100,3733,5,153,0,COMPLETED_WALLTIME_REACHED,34225,153,34378,30492,30645,200.2941176470588,3 4 5 13 14,-1
778,w0,100,3734,6,152,0,COMPLETED_WALLTIME_REACHED,34368,152,34520,30634,30786,202.53947368421052,6 7 8 9 10 15,-1
780,w0,100,3738,5,149,0,COMPLETED_WALLTIME_REACHED,34373,149,34522,30635,30784,206.60402684563758,0 1 2 11 12,-1
781,w0,100,3738,3,146,0,COMPLETED_WALLTIME_REACHED,34378,146,34524,30640,30786,210.86301369863014,3 4 5,-1
782,w0,100,3738,3,152,0,COMPLETED_WALLTIME_REACHED,34520,152,34672,30782,30934,203.51315789473685,6 7 8,-1
785,w0,100,3744,4,151,0,COMPLETED_WALLTIME_REACHED,34520,151,34671,30776,30927,204.81456953642385,9 10 13 14,-1
783,w0,100,3740,6,152,0,COMPLETED_WALLTIME_REACHED,34522,152,34674,30782,30934,203.51315789473685,0 1 2 11 12 15,-1
862,w0,100,4210,3,146,0,COMPLETED_WALLTIME_REACHED,34524,146,34670,30314,30460,208.63013698630138,3 4 5,-1
784,w0,100,3741,5,149,0,COMPLETED_WALLTIME_REACHED,34671,149,34820,30930,31079,208.58389261744966,3 4 5 9 10,-1
786,w0,100,3750,5,151,0,COMPLETED_WALLTIME_REACHED,34672,151,34823,30922,31073,205.7814569536424,6 7 8 13 14,-1
787,w0,100,3751,4,154,0,COMPLETED_WALLTIME_REACHED,34674,154,34828,30923,31077,201.7987012987013,0 1 2 11,-1
788,w0,100,3754,5,153,0,COMPLETED_WALLTIME_REACHED,34820,153,34973,31066,31219,204.04575163398692,3 4 5 9 10,-1
789,w0,100,3774,4,151,0,COMPLETED_WALLTIME_REACHED,34823,151,34974,31049,31200,206.6225165562914,6 7 8 12,-1
790,w0,100,3776,5,150,0,COMPLETED_WALLTIME_REACHED,34828,150,34978,31052,31202,208.01333333333332,0 1 2 11 13,-1
791,w0,100,3779,4,149,0,COMPLETED_WALLTIME_REACHED,34973,149,35122,31194,31343,210.35570469798657,3 4 5 9,-1
792,w0,100,3787,3,150,0,COMPLETED_WALLTIME_REACHED,34973,150,35123,31186,31336,208.90666666666667,10 14 15,-1
794,w0,100,3793,4,151,0,COMPLETED_WALLTIME_REACHED,34974,151,35125,31181,31332,207.49668874172184,6 7 8 12,-1
793,w0,100,3791,5,150,0,COMPLETED_WALLTIME_REACHED,34978,150,35128,31187,31337,208.91333333333333,0 1 2 11 13,-1
795,w0,100,3796,7,149,0,COMPLETED_WALLTIME_REACHED,35123,149,35272,31327,31476,211.248322147651,3 4 5 9 10 14 15,-1
796,w0,100,3798,4,149,0,COMPLETED_WALLTIME_REACHED,35125,149,35274,31327,31476,211.248322147651,6 7 8 12,-1
797,w0,100,3800,4,151,0,COMPLETED_WALLTIME_REACHED,35128,151,35279,31328,31479,208.47019867549668,0 1 2 11,-1
798,w0,100,3800,4,151,0,COMPLETED_WALLTIME_REACHED,35272,151,35423,31472,31623,209.42384105960264,3 4 5 9,-1
799,w0,100,3801,3,155,0,COMPLETED_WALLTIME_REACHED,35272,155,35427,31471,31626,204.03870967741935,10 13 14,-1
800,w0,100,3803,4,151,0,COMPLETED_WALLTIME_REACHED,35274,151,35425,31471,31622,209.41721854304635,6 7 8 12,-1
801,w0,100,3805,5,151,0,COMPLETED_WALLTIME_REACHED,35279,151,35430,31474,31625,209.43708609271522,0 1 2 11 15,-1
802,w0,100,3813,3,152,0,COMPLETED_WALLTIME_REACHED,35423,152,35575,31610,31762,208.96052631578948,3 4 5,-1
803,w0,100,3817,5,152,0,COMPLETED_WALLTIME_REACHED,35425,152,35577,31608,31760,208.94736842105263,6 7 8 9 12,-1
813,w0,100,3888,3,154,0,COMPLETED_WALLTIME_REACHED,35427,154,35581,31539,31693,205.7987012987013,10 13 14,-1
804,w0,100,3831,5,152,0,COMPLETED_WALLTIME_REACHED,35430,152,35582,31599,31751,208.88815789473685,0 1 2 11 15,-1
814,w0,100,3899,3,149,0,COMPLETED_WALLTIME_REACHED,35575,149,35724,31676,31825,213.59060402684563,3 4 5,-1
807,w0,100,3859,4,152,0,COMPLETED_WALLTIME_REACHED,35577,152,35729,31718,31870,209.67105263157896,6 7 8 9,-1
809,w0,100,3870,4,150,0,COMPLETED_WALLTIME_REACHED,35581,150,35731,31711,31861,212.40666666666667,10 12 13 14,-1
808,w0,100,3868,5,152,0,COMPLETED_WALLTIME_REACHED,35582,152,35734,31714,31866,209.64473684210526,0 1 2 11 15,-1
824,w0,100,3942,3,152,0,COMPLETED_WALLTIME_REACHED,35724,152,35876,31782,31934,210.0921052631579,3 4 5,-1
810,w0,100,3872,4,150,0,COMPLETED_WALLTIME_REACHED,35729,150,35879,31857,32007,213.38,6 7 8 9,-1
812,w0,100,3887,4,149,0,COMPLETED_WALLTIME_REACHED,35731,149,35880,31844,31993,214.71812080536913,10 12 13 14,-1
811,w0,100,3884,5,151,0,COMPLETED_WALLTIME_REACHED,35734,151,35885,31850,32001,211.9271523178808,0 1 2 11 15,-1
815,w0,100,3907,6,149,0,COMPLETED_WALLTIME_REACHED,35879,149,36028,31972,32121,215.5771812080537,3 4 5 6 7 8,-1
816,w0,100,3908,4,151,0,COMPLETED_WALLTIME_REACHED,35880,151,36031,31972,32123,212.73509933774835,9 10 12 13,-1
817,w0,100,3919,5,150,0,COMPLETED_WALLTIME_REACHED,35885,150,36035,31966,32116,214.10666666666665,0 1 2 11 14,-1
818,w0,100,3929,4,153,0,COMPLETED_WALLTIME_REACHED,36028,153,36181,32099,32252,210.79738562091504,3 4 5 6,-1
819,w0,100,3929,5,145,0,COMPLETED_WALLTIME_REACHED,36031,145,36176,32102,32247,222.39310344827587,7 8 9 10 12,-1
820,w0,100,3934,5,148,0,COMPLETED_WALLTIME_REACHED,36035,148,36183,32101,32249,217.89864864864865,0 1 2 11 13,-1
821,w0,100,3935,4,150,0,COMPLETED_WALLTIME_REACHED,36176,150,36326,32241,32391,215.94,7 8 9 10,-1
822,w0,100,3939,6,151,0,COMPLETED_WALLTIME_REACHED,36181,151,36332,32242,32393,214.52317880794703,3 4 5 6 12 14,-1
823,w0,100,3940,5,148,0,COMPLETED_WALLTIME_REACHED,36183,148,36331,32243,32391,218.8581081081081,0 1 2 11 13,-1
826,w0,100,3952,4,153,0,COMPLETED_WALLTIME_REACHED,36326,153,36479,32374,32527,212.59477124183007,7 8 9 10,-1
825,w0,100,3948,6,152,0,COMPLETED_WALLTIME_REACHED,36331,152,36483,32383,32535,214.04605263157896,0 1 2 11 13 15,-1
832,w0,100,3979,4,147,0,COMPLETED_WALLTIME_REACHED,36332,147,36479,32353,32500,221.08843537414967,3 4 5 6,-1
827,w0,100,3954,7,154,0,COMPLETED_WALLTIME_REACHED,36479,154,36633,32525,32679,212.2012987012987,3 4 5 6 7 8 9,-1
836,w0,100,4003,3,149,0,COMPLETED_WALLTIME_REACHED,36479,149,36628,32476,32625,218.95973154362417,10 12 14,-1
828,w0,100,3955,6,149,0,COMPLETED_WALLTIME_REACHED,36483,149,36632,32528,32677,219.30872483221478,0 1 2 11 13 15,-1
837,w0,100,4008,3,149,0,COMPLETED_WALLTIME_REACHED,36628,149,36777,32620,32769,219.9261744966443,10 12 14,-1
829,w0,100,3972,4,151,0,COMPLETED_WALLTIME_REACHED,36632,151,36783,32660,32811,217.2913907284768,0 1 2 11,-1
830,w0,100,3972,5,152,0,COMPLETED_WALLTIME_REACHED,36633,152,36785,32661,32813,215.875,3 4 5 6 7,-1
831,w0,100,3977,4,154,0,COMPLETED_WALLTIME_REACHED,36633,154,36787,32656,32810,213.05194805194805,8 9 13 15,-1
833,w0,100,3988,5,152,0,COMPLETED_WALLTIME_REACHED,36783,152,36935,32795,32947,216.7565789473684,0 1 2 10 11,-1
834,w0,100,3999,4,151,0,COMPLETED_WALLTIME_REACHED,36785,151,36936,32786,32937,218.12582781456953,3 4 5 6,-1
835,w0,100,4003,7,149,0,COMPLETED_WALLTIME_REACHED,36787,149,36936,32784,32933,221.0268456375839,7 8 9 12 13 14 15,-1
838,w0,100,4011,4,149,0,COMPLETED_WALLTIME_REACHED,36935,149,37084,32924,33073,221.96644295302013,0 1 2 10,-1
839,w0,100,4016,5,148,0,COMPLETED_WALLTIME_REACHED,36936,148,37084,32920,33068,223.43243243243242,3 4 5 6 7,-1
840,w0,100,4029,5,152,0,COMPLETED_WALLTIME_REACHED,36936,152,37088,32907,33059,217.4934210526316,8 9 11 12 13,-1
841,w0,100,4031,4,148,0,COMPLETED_WALLTIME_REACHED,37084,148,37232,33053,33201,224.3310810810811,0 1 2 3,-1
842,w0,100,4035,4,146,0,COMPLETED_WALLTIME_REACHED,37084,146,37230,33049,33195,227.36301369863014,4 5 6 7,-1
863,w0,100,4212,3,152,0,COMPLETED_WALLTIME_REACHED,37084,152,37236,32872,33024,217.26315789473685,10 14 15,-1
843,w0,100,4045,5,149,0,COMPLETED_WALLTIME_REACHED,37088,149,37237,33043,33192,222.76510067114094,8 9 11 12 13,-1
867,w0,100,4256,3,150,0,COMPLETED_WALLTIME_REACHED,37230,150,37380,32974,33124,220.82666666666665,4 5 6,-1
844,w0,100,4045,5,151,0,COMPLETED_WALLTIME_REACHED,37232,151,37383,33187,33338,220.7814569536424,0 1 2 3 7,-1
872,w0,100,4286,3,150,0,COMPLETED_WALLTIME_REACHED,37236,150,37386,32950,33100,220.66666666666666,10 14 15,-1
845,w0,100,4051,4,148,0,COMPLETED_WALLTIME_REACHED,37237,148,37385,33186,33334,225.22972972972974,8 9 11 12,-1
848,w0,100,4065,4,149,0,COMPLETED_WALLTIME_REACHED,37380,149,37529,33315,33464,224.59060402684563,4 5 6 13,-1
846,w0,100,4058,5,150,0,COMPLETED_WALLTIME_REACHED,37383,150,37533,33325,33475,223.16666666666666,0 1 2 3 7,-1
847,w0,100,4059,5,150,0,COMPLETED_WALLTIME_REACHED,37386,150,37536,33327,33477,223.18,8 9 10 11 12,-1
850,w0,100,4078,5,151,0,COMPLETED_WALLTIME_REACHED,37529,151,37680,33451,33602,222.52980132450332,4 5 6 13 14,-1
851,w0,100,4097,4,150,0,COMPLETED_WALLTIME_REACHED,37533,150,37683,33436,33586,223.90666666666667,0 1 2 3,-1
852,w0,100,4099,5,152,0,COMPLETED_WALLTIME_REACHED,37536,152,37688,33437,33589,220.98026315789474,7 8 9 10 11,-1
853,w0,100,4109,4,151,0,COMPLETED_WALLTIME_REACHED,37680,151,37831,33571,33722,223.32450331125827,4 5 6 12,-1
854,w0,100,4124,5,149,0,COMPLETED_WALLTIME_REACHED,37683,149,37832,33559,33708,226.2281879194631,0 1 2 3 13,-1
855,w0,100,4133,4,149,0,COMPLETED_WALLTIME_REACHED,37688,149,37837,33555,33704,226.2013422818792,7 8 9 10,-1
875,w0,100,4293,3,153,0,COMPLETED_WALLTIME_REACHED,37688,153,37841,33395,33548,219.26797385620915,11 14 15,-1
856,w0,100,4155,4,149,0,COMPLETED_WALLTIME_REACHED,37831,149,37980,33676,33825,227.01342281879195,4 5 6 12,-1
857,w0,100,4167,4,150,0,COMPLETED_WALLTIME_REACHED,37832,150,37982,33665,33815,225.43333333333334,0 1 2 3,-1
858,w0,100,4180,4,152,0,COMPLETED_WALLTIME_REACHED,37837,152,37989,33657,33809,222.42763157894737,7 8 9 10,-1
878,w0,100,4312,3,149,0,COMPLETED_WALLTIME_REACHED,37841,149,37990,33529,33678,226.0268456375839,11 13 14,-1
859,w0,100,4194,5,149,0,COMPLETED_WALLTIME_REACHED,37980,149,38129,33786,33935,227.751677852349,4 5 6 12 15,-1
860,w0,100,4197,6,154,0,COMPLETED_WALLTIME_REACHED,37989,154,38143,33792,33946,220.42857142857142,0 1 2 3 7 8,-1
861,w0,100,4198,5,152,0,COMPLETED_WALLTIME_REACHED,37990,152,38142,33792,33944,223.31578947368422,9 10 11 13 14,-1
864,w0,100,4224,5,148,0,COMPLETED_WALLTIME_REACHED,38129,148,38277,33905,34053,230.08783783783784,4 5 6 12 15,-1
866,w0,100,4254,5,150,0,COMPLETED_WALLTIME_REACHED,38142,150,38292,33888,34038,226.92,9 10 11 13 14,-1
865,w0,100,4235,6,146,0,COMPLETED_WALLTIME_REACHED,38143,146,38289,33908,34054,233.24657534246575,0 1 2 3 7 8,-1
869,w0,100,4269,4,156,0,COMPLETED_WALLTIME_REACHED,38277,156,38433,34008,34164,219.0,4 5 6 12,-1
868,w0,100,4259,6,148,0,COMPLETED_WALLTIME_REACHED,38289,148,38437,34030,34178,230.93243243243242,0 1 2 3 7 8,-1
870,w0,100,4280,4,154,0,COMPLETED_WALLTIME_REACHED,38292,154,38446,34012,34166,221.85714285714286,9 10 11 13,-1
871,w0,100,4281,6,150,0,COMPLETED_WALLTIME_REACHED,38433,150,38583,34152,34302,228.68,4 5 6 12 14 15,-1
873,w0,100,4289,4,151,0,COMPLETED_WALLTIME_REACHED,38437,151,38588,34148,34299,227.1456953642384,0 1 2 3,-1
874,w0,100,4293,4,153,0,COMPLETED_WALLTIME_REACHED,38446,153,38599,34153,34306,224.22222222222223,7 8 9 10,-1
876,w0,100,4308,6,154,0,COMPLETED_WALLTIME_REACHED,38583,154,38737,34275,34429,223.56493506493507,4 5 6 11 12 13,-1
877,w0,100,4309,4,153,0,COMPLETED_WALLTIME_REACHED,38588,153,38741,34279,34432,225.04575163398692,0 1 2 3,-1
879,w0,100,4315,5,149,0,COMPLETED_WALLTIME_REACHED,38599,149,38748,34284,34433,231.09395973154363,7 8 9 10 14,-1
880,w0,100,4316,3,155,0,COMPLETED_WALLTIME_REACHED,38737,155,38892,34421,34576,223.07096774193548,4 5 6,-1
881,w0,100,4324,6,152,0,COMPLETED_WALLTIME_REACHED,38741,152,38893,34417,34569,227.42763157894737,0 1 2 3 11 12,-1
883,w0,100,4335,5,152,0,COMPLETED_WALLTIME_REACHED,38748,152,38900,34413,34565,227.40131578947367,7 8 9 10 13,-1
884,w0,100,4356,4,149,0,COMPLETED_WALLTIME_REACHED,38892,149,39041,34536,34685,232.78523489932886,4 5 6 14,-1
885,w0,100,4370,5,149,0,COMPLETED_WALLTIME_REACHED,38893,149,39042,34523,34672,232.6979865771812,0 1 2 3 11,-1
886,w0,100,4371,5,149,0,COMPLETED_WALLTIME_REACHED,38900,149,39049,34529,34678,232.73825503355704,7 8 9 10 12,-1
887,w0,100,4371,4,152,0,COMPLETED_WALLTIME_REACHED,39041,152,39193,34670,34822,229.0921052631579,4 5 6 13,-1
888,w0,100,4372,5,148,0,COMPLETED_WALLTIME_REACHED,39042,148,39190,34670,34818,235.25675675675674,0 1 2 3 11,-1
889,w0,100,4374,3,148,0,COMPLETED_WALLTIME_REACHED,39049,148,39197,34675,34823,235.29054054054055,7 8 9,-1
890,w0,100,4380,4,150,0,COMPLETED_WALLTIME_REACHED,39049,150,39199,34669,34819,232.12666666666667,10 12 14 15,-1
891,w0,100,4388,4,155,0,COMPLETED_WALLTIME_REACHED,39190,155,39345,34802,34957,225.52903225806452,0 1 2 3,-1
892,w0,100,4388,5,145,0,COMPLETED_WALLTIME_REACHED,39193,145,39338,34805,34950,241.0344827586207,4 5 6 11 13,-1
893,w0,100,4390,3,151,0,COMPLETED_WALLTIME_REACHED,39197,151,39348,34807,34958,231.50993377483445,7 8 9,-1
894,w0,100,4390,3,152,0,COMPLETED_WALLTIME_REACHED,39199,152,39351,34809,34961,230.0065789473684,10 12 14,-1
895,w0,100,4398,4,157,0,COMPLETED_WALLTIME_REACHED,39338,157,39495,34940,35097,223.54777070063693,4 5 6 11,-1
896,w0,100,4398,4,152,0,COMPLETED_WALLTIME_REACHED,39345,152,39497,34947,35099,230.91447368421052,0 1 2 3,-1
897,w0,100,4417,5,152,0,COMPLETED_WALLTIME_REACHED,39348,152,39500,34931,35083,230.80921052631578,7 8 9 13 15,-1
898,w0,100,4418,5,151,0,COMPLETED_WALLTIME_REACHED,39495,151,39646,35077,35228,233.2980132450331,4 5 6 10 11,-1
899,w0,100,4420,4,148,0,COMPLETED_WALLTIME_REACHED,39497,148,39645,35077,35225,238.00675675675674,0 1 2 3,-1
900,w0,100,4423,5,150,0,COMPLETED_WALLTIME_REACHED,39500,150,39650,35077,35227,234.84666666666666,7 8 9 12 13,-1
901,w0,100,4429,5,149,0,COMPLETED_WALLTIME_REACHED,39645,149,39794,35216,35365,237.3489932885906,0 1 2 3 14,-1
902,w0,100,4435,5,151,0,COMPLETED_WALLTIME_REACHED,39646,151,39797,35211,35362,234.18543046357615,4 5 6 10 11,-1
903,w0,100,4437,3,148,0,COMPLETED_WALLTIME_REACHED,39650,148,39798,35213,35361,238.92567567567568,7 8 9,-1
933,w0,100,4600,3,148,0,COMPLETED_WALLTIME_REACHED,39650,148,39798,35050,35198,237.82432432432432,12 13 15,-1
904,w0,100,4450,4,151,0,COMPLETED_WALLTIME_REACHED,39794,151,39945,35344,35495,235.0662251655629,0 1 2 3,-1
905,w0,100,4452,5,148,0,COMPLETED_WALLTIME_REACHED,39797,148,39945,35345,35493,239.81756756756758,4 5 6 10 11,-1
906,w0,100,4455,7,152,0,COMPLETED_WALLTIME_REACHED,39798,152,39950,35343,35495,233.51973684210526,7 8 9 12 13 14 15,-1
907,w0,100,4462,5,152,0,COMPLETED_WALLTIME_REACHED,39945,152,40097,35483,35635,234.44078947368422,0 1 2 3 4,-1
911,w0,100,4471,4,146,0,COMPLETED_WALLTIME_REACHED,39945,146,40091,35474,35620,243.97260273972603,5 6 10 11,-1
908,w0,100,4463,5,152,0,COMPLETED_WALLTIME_REACHED,39950,152,40102,35487,35639,234.4671052631579,7 8 9 12 13,-1
909,w0,100,4465,5,148,0,COMPLETED_WALLTIME_REACHED,40091,148,40239,35626,35774,241.71621621621622,5 6 10 11 14,-1
910,w0,100,4467,6,150,0,COMPLETED_WALLTIME_REACHED,40097,150,40247,35630,35780,238.53333333333333,0 1 2 3 4 15,-1
912,w0,100,4477,5,153,0,COMPLETED_WALLTIME_REACHED,40102,153,40255,35625,35778,233.84313725490196,7 8 9 12 13,-1
913,w0,100,4478,5,148,0,COMPLETED_WALLTIME_REACHED,40239,148,40387,35761,35909,242.6283783783784,5 6 10 11 14,-1
914,w0,100,4482,5,148,0,COMPLETED_WALLTIME_REACHED,40247,148,40395,35765,35913,242.65540540540542,0 1 2 3 4,-1
915,w0,100,4486,6,147,0,COMPLETED_WALLTIME_REACHED,40255,147,40402,35769,35916,244.3265306122449,7 8 9 12 13 15,-1
916,w0,100,4504,4,147,0,COMPLETED_WALLTIME_REACHED,40387,147,40534,35883,36030,245.10204081632654,5 6 10 11,-1
917,w0,100,4518,5,149,0,COMPLETED_WALLTIME_REACHED,40395,149,40544,35877,36026,241.78523489932886,0 1 2 3 4,-1
918,w0,100,4524,4,153,0,COMPLETED_WALLTIME_REACHED,40402,153,40555,35878,36031,235.4967320261438,7 8 9 12,-1
938,w0,100,4614,3,150,0,COMPLETED_WALLTIME_REACHED,40402,150,40552,35788,35938,239.58666666666667,13 14 15,-1
919,w0,100,4531,4,152,0,COMPLETED_WALLTIME_REACHED,40534,152,40686,36003,36155,237.86184210526315,5 6 10 11,-1
920,w0,100,4535,6,148,0,COMPLETED_WALLTIME_REACHED,40552,148,40700,36017,36165,244.3581081081081,0 1 2 3 4 13,-1
921,w0,100,4540,4,151,0,COMPLETED_WALLTIME_REACHED,40555,151,40706,36015,36166,239.50993377483445,7 8 9 12,-1
922,w0,100,4541,6,154,0,COMPLETED_WALLTIME_REACHED,40686,154,40840,36145,36299,235.7077922077922,5 6 10 11 14 15,-1
923,w0,100,4542,4,147,0,COMPLETED_WALLTIME_REACHED,40700,147,40847,36158,36305,246.97278911564626,0 1 2 3,-1
925,w0,100,4551,4,152,0,COMPLETED_WALLTIME_REACHED,40706,152,40858,36155,36307,238.86184210526315,4 7 8 9,-1
926,w0,100,4557,5,151,0,COMPLETED_WALLTIME_REACHED,40840,151,40991,36283,36434,241.28476821192052,5 6 10 11 12,-1
939,w0,100,4647,3,154,0,COMPLETED_WALLTIME_REACHED,40840,154,40994,36193,36347,236.0194805194805,13 14 15,-1
927,w0,100,4565,4,151,0,COMPLETED_WALLTIME_REACHED,40847,151,40998,36282,36433,241.27814569536423,0 1 2 3,-1
941,w0,100,4670,3,148,0,COMPLETED_WALLTIME_REACHED,40858,148,41006,36188,36336,245.51351351351352,4 7 8,-1
928,w0,100,4576,6,152,0,COMPLETED_WALLTIME_REACHED,40991,152,41143,36415,36567,240.57236842105263,5 6 9 10 11 12,-1
929,w0,100,4582,5,150,0,COMPLETED_WALLTIME_REACHED,40998,150,41148,36416,36566,243.77333333333334,0 1 2 3 13,-1
930,w0,100,4587,4,150,0,COMPLETED_WALLTIME_REACHED,41006,150,41156,36419,36569,243.79333333333332,4 7 8 14,-1
931,w0,100,4588,5,150,0,COMPLETED_WALLTIME_REACHED,41143,150,41293,36555,36705,244.7,5 6 9 10 11,-1
932,w0,100,4588,4,154,0,COMPLETED_WALLTIME_REACHED,41148,154,41302,36560,36714,238.4025974025974,0 1 2 3,-1
950,w0,100,4709,3,150,0,COMPLETED_WALLTIME_REACHED,41148,150,41298,36439,36589,243.92666666666668,12 13 15,-1
934,w0,100,4602,4,151,0,COMPLETED_WALLTIME_REACHED,41156,151,41307,36554,36705,243.0794701986755,4 7 8 14,-1
935,w0,100,4603,4,149,0,COMPLETED_WALLTIME_REACHED,41293,149,41442,36690,36839,247.24161073825502,5 6 9 10,-1
936,w0,100,4611,4,148,0,COMPLETED_WALLTIME_REACHED,41298,148,41446,36687,36835,248.88513513513513,11 12 13 15,-1
937,w0,100,4611,4,155,0,COMPLETED_WALLTIME_REACHED,41302,155,41457,36691,36846,237.71612903225807,0 1 2 3,-1
954,w0,100,4715,3,149,0,COMPLETED_WALLTIME_REACHED,41307,149,41456,36592,36741,246.58389261744966,4 7 8,-1
940,w0,100,4667,5,151,0,COMPLETED_WALLTIME_REACHED,41442,151,41593,36775,36926,244.5430463576159,5 6 9 10 14,-1
942,w0,100,4678,4,150,0,COMPLETED_WALLTIME_REACHED,41446,150,41596,36768,36918,246.12,11 12 13 15,-1
974,w0,100,4828,3,150,0,COMPLETED_WALLTIME_REACHED,41456,150,41606,36628,36778,245.18666666666667,4 7 8,-1
943,w0,100,4681,4,148,0,COMPLETED_WALLTIME_REACHED,41457,148,41605,36776,36924,249.48648648648648,0 1 2 3,-1
944,w0,100,4688,5,151,0,COMPLETED_WALLTIME_REACHED,41593,151,41744,36905,37056,245.40397350993376,5 6 9 10 14,-1
945,w0,100,4694,4,149,0,COMPLETED_WALLTIME_REACHED,41596,149,41745,36902,37051,248.66442953020135,11 12 13 15,-1
946,w0,100,4696,6,149,0,COMPLETED_WALLTIME_REACHED,41606,149,41755,36910,37059,248.71812080536913,0 1 2 3 4 7,-1
947,w0,100,4697,5,150,0,COMPLETED_WALLTIME_REACHED,41744,150,41894,37047,37197,247.98,5 6 8 9 10,-1
948,w0,100,4701,4,152,0,COMPLETED_WALLTIME_REACHED,41745,152,41897,37044,37196,244.71052631578948,11 12 13 14,-1
949,w0,100,4707,5,147,0,COMPLETED_WALLTIME_REACHED,41755,147,41902,37048,37195,253.02721088435374,0 1 2 3 4,-1
951,w0,100,4710,5,149,0,COMPLETED_WALLTIME_REACHED,41894,149,42043,37184,37333,250.55704697986576,5 6 7 8 9,-1
952,w0,100,4710,6,151,0,COMPLETED_WALLTIME_REACHED,41897,151,42048,37187,37338,247.27152317880794,10 11 12 13 14 15,-1
975,w0,100,4832,3,148,0,COMPLETED_WALLTIME_REACHED,41902,148,42050,37070,37218,251.47297297297297,0 1 2,-1
953,w0,100,4713,7,145,0,COMPLETED_WALLTIME_REACHED,42043,145,42188,37330,37475,258.44827586206895,3 4 5 6 7 8 9,-1
955,w0,100,4716,4,150,0,COMPLETED_WALLTIME_REACHED,42048,150,42198,37332,37482,249.88,10 11 12 13,-1
958,w0,100,4728,4,151,0,COMPLETED_WALLTIME_REACHED,42050,151,42201,37322,37473,248.16556291390728,0 1 2 14,-1
956,w0,100,4727,8,150,0,COMPLETED_WALLTIME_REACHED,42188,150,42338,37461,37611,250.74,3 4 5 6 7 8 9 15,-1
981,w0,100,4873,3,150,0,COMPLETED_WALLTIME_REACHED,42198,150,42348,37325,37475,249.83333333333334,10 11 12,-1
957,w0,100,4728,5,149,0,COMPLETED_WALLTIME_REACHED,42201,149,42350,37473,37622,252.49664429530202,0 1 2 13 14,-1
959,w0,100,4737,5,150,0,COMPLETED_WALLTIME_REACHED,42338,150,42488,37601,37751,251.67333333333335,3 4 5 6 7,-1
976,w0,100,4845,4,151,0,COMPLETED_WALLTIME_REACHED,42348,151,42499,37503,37654,249.36423841059602,8 9 10 11,-1
960,w0,100,4742,7,147,0,COMPLETED_WALLTIME_REACHED,42350,147,42497,37608,37755,256.83673469387753,0 1 2 12 13 14 15,-1
961,w0,100,4754,5,151,0,COMPLETED_WALLTIME_REACHED,42488,151,42639,37734,37885,250.89403973509934,3 4 5 6 7,-1
962,w0,100,4755,5,150,0,COMPLETED_WALLTIME_REACHED,42497,150,42647,37742,37892,252.61333333333334,0 1 2 12 13,-1
963,w0,100,4767,5,149,0,COMPLETED_WALLTIME_REACHED,42499,149,42648,37732,37881,254.23489932885906,8 9 10 11 14,-1
964,w0,100,4771,5,147,0,COMPLETED_WALLTIME_REACHED,42639,147,42786,37868,38015,258.6054421768707,3 4 5 6 7,-1
965,w0,100,4786,5,149,0,COMPLETED_WALLTIME_REACHED,42647,149,42796,37861,38010,255.1006711409396,0 1 2 12 13,-1
966,w0,100,4796,5,150,0,COMPLETED_WALLTIME_REACHED,42648,150,42798,37852,38002,253.34666666666666,8 9 10 11 14,-1
967,w0,100,4805,5,149,0,COMPLETED_WALLTIME_REACHED,42786,149,42935,37981,38130,255.90604026845637,3 4 5 6 7,-1
968,w0,100,4809,5,148,0,COMPLETED_WALLTIME_REACHED,42796,148,42944,37987,38135,257.6689189189189,0 1 2 12 13,-1
969,w0,100,4810,5,152,0,COMPLETED_WALLTIME_REACHED,42798,152,42950,37988,38140,250.92105263157896,8 9 10 11 14,-1
970,w0,100,4810,5,151,0,COMPLETED_WALLTIME_REACHED,42935,151,43086,38125,38276,253.48344370860926,3 4 5 6 7,-1
971,w0,100,4811,6,151,0,COMPLETED_WALLTIME_REACHED,42944,151,43095,38133,38284,253.53642384105962,0 1 2 12 13 15,-1
978,w0,100,4854,4,151,0,COMPLETED_WALLTIME_REACHED,42950,151,43101,38096,38247,253.2913907284768,8 9 10 11,-1
972,w0,100,4817,6,150,0,COMPLETED_WALLTIME_REACHED,43086,150,43236,38269,38419,256.12666666666667,3 4 5 6 7 14,-1
973,w0,100,4821,5,147,0,COMPLETED_WALLTIME_REACHED,43095,147,43242,38274,38421,261.3673469387755,0 1 2 12 13,-1
977,w0,100,4845,5,149,0,COMPLETED_WALLTIME_REACHED,43101,149,43250,38256,38405,257.751677852349,8 9 10 11 15,-1
979,w0,100,4866,4,149,0,COMPLETED_WALLTIME_REACHED,43236,149,43385,38370,38519,258.51677852348996,3 4 5 6,-1
980,w0,100,4871,4,150,0,COMPLETED_WALLTIME_REACHED,43242,150,43392,38371,38521,256.8066666666667,0 1 2 7,-1
982,w0,100,4877,4,148,0,COMPLETED_WALLTIME_REACHED,43250,148,43398,38373,38521,260.27702702702703,8 9 10 11,-1
983,w0,100,4878,4,150,0,COMPLETED_WALLTIME_REACHED,43250,150,43400,38372,38522,256.81333333333333,12 13 14 15,-1
984,w0,100,4880,4,150,0,COMPLETED_WALLTIME_REACHED,43385,150,43535,38505,38655,257.7,3 4 5 6,-1
985,w0,100,4886,4,149,0,COMPLETED_WALLTIME_REACHED,43392,149,43541,38506,38655,259.4295302013423,0 1 2 7,-1
987,w0,100,4895,5,149,0,COMPLETED_WALLTIME_REACHED,43400,149,43549,38505,38654,259.4228187919463,8 9 10 11 12,-1
988,w0,100,4898,5,149,0,COMPLETED_WALLTIME_REACHED,43535,149,43684,38637,38786,260.30872483221475,3 4 5 6 13,-1
989,w0,100,4899,5,149,0,COMPLETED_WALLTIME_REACHED,43541,149,43690,38642,38791,260.3422818791946,0 1 2 7 14,-1
993,w0,100,4920,4,146,0,COMPLETED_WALLTIME_REACHED,43549,146,43695,38629,38775,265.5821917808219,8 9 10 11,-1
990,w0,100,4901,7,150,0,COMPLETED_WALLTIME_REACHED,43684,150,43834,38783,38933,259.55333333333334,3 4 5 6 12 13 15,-1
991,w0,100,4904,6,148,0,COMPLETED_WALLTIME_REACHED,43695,148,43843,38791,38939,263.10135135135135,0 1 2 7 8 9,-1
992,w0,100,4915,6,148,0,COMPLETED_WALLTIME_REACHED,43834,148,43982,38919,39067,263.9662162162162,3 4 5 6 10 11,-1
995,w0,100,4923,4,153,0,COMPLETED_WALLTIME_REACHED,43834,153,43987,38911,39064,255.3202614379085,12 13 14 15,-1
994,w0,100,4922,5,150,0,COMPLETED_WALLTIME_REACHED,43843,150,43993,38921,39071,260.47333333333336,0 1 2 7 8,-1
996,w0,100,4931,4,149,0,COMPLETED_WALLTIME_REACHED,43982,149,44131,39051,39200,263.0872483221477,3 4 5 6,-1
997,w0,100,4932,4,149,0,COMPLETED_WALLTIME_REACHED,43987,149,44136,39055,39204,263.1140939597315,9 10 11 12,-1
998,w0,100,4933,4,150,0,COMPLETED_WALLTIME_REACHED,43993,150,44143,39060,39210,261.4,0 1 2 7,-1
999,w0,100,4938,5,151,0,COMPLETED_WALLTIME_REACHED,44131,151,44282,39193,39344,260.55629139072846,3 4 5 6 8,-1
1000,w0,100,4943,4,154,0,COMPLETED_WALLTIME_REACHED,44136,154,44290,39193,39347,255.5,9 10 11 12,-1
