job_id,workload_name,profile,submission_time,requested_number_of_resources,requested_time,success,final_state,starting_time,execution_time,finish_time,waiting_time,turnaround_time,stretch,allocated_resources,consumed_energy
1,w0,100,2,6,151,0,COMPLETED_WALLTIME_REACHED,2,151,153,0,151,1.0,0 1 2 3 4 5,-1
2,w0,100,3,4,152,0,COMPLETED_WALLTIME_REACHED,3,152,155,0,152,1.0,6 7 8 9,-1
3,w0,100,11,4,149,0,COMPLETED_WALLTIME_REACHED,11,149,160,0,149,1.0,10 11 12 13,-1
4,w0,100,20,5,146,0,COMPLETED_WALLTIME_REACHED,153,146,299,133,279,1.9109589041095891,0 1 2 3 4,-1
21,w0,100,132,3,151,0,COMPLETED_WALLTIME_REACHED,153,151,304,21,172,1.1390728476821192,5 14 15,-1
5,w0,100,34,4,152,0,COMPLETED_WALLTIME_REACHED,155,152,307,121,273,1.7960526315789473,6 7 8 9,-1
23,w0,100,144,3,149,0,COMPLETED_WALLTIME_REACHED,160,149,309,16,165,1.1073825503355705,10 11 12,-1
6,w0,100,35,6,153,0,COMPLETED_WALLTIME_REACHED,299,153,452,264,417,2.7254901960784315,0 1 2 3 4 13,-1
25,w0,100,159,3,149,0,COMPLETED_WALLTIME_REACHED,304,149,453,145,294,1.9731543624161074,5 14 15,-1
7,w0,100,36,4,149,0,COMPLETED_WALLTIME_REACHED,307,149,456,271,420,2.8187919463087248,6 7 8 9,-1
27,w0,100,168,3,149,0,COMPLETED_WALLTIME_REACHED,309,149,458,141,290,1.9463087248322148,10 11 12,-1
8,w0,100,38,4,151,0,COMPLETED_WALLTIME_REACHED,452,151,603,414,565,3.7417218543046356,0 1 2 3,-1
43,w0,100,216,1,150,0,COMPLETED_WALLTIME_REACHED,452,150,602,236,386,2.5733333333333333,4,-1
9,w0,100,49,4,147,0,COMPLETED_WALLTIME_REACHED,453,147,600,404,551,3.748299319727891,5 13 14 15,-1
10,w0,100,57,5,149,0,COMPLETED_WALLTIME_REACHED,458,149,607,401,550,3.6912751677852347,6 7 8 9 10,-1
11,w0,100,60,5,151,0,COMPLETED_WALLTIME_REACHED,600,151,751,540,691,4.576158940397351,5 11 12 13 14,-1
12,w0,100,66,6,150,0,COMPLETED_WALLTIME_REACHED,603,150,753,537,687,4.58,0 1 2 3 4 15,-1
13,w0,100,67,5,150,0,COMPLETED_WALLTIME_REACHED,607,150,757,540,690,4.6,6 7 8 9 10,-1
14,w0,100,68,4,151,0,COMPLETED_WALLTIME_REACHED,751,151,902,683,834,5.52317880794702,5 11 12 13,-1
15,w0,100,118,4,152,0,COMPLETED_WALLTIME_REACHED,753,152,905,635,787,5.177631578947368,0 1 2 3,-1
30,w0,100,173,3,151,0,COMPLETED_WALLTIME_REACHED,753,151,904,580,731,4.841059602649007,4 14 15,-1
16,w0,100,120,4,149,0,COMPLETED_WALLTIME_REACHED,757,149,906,637,786,5.275167785234899,6 7 8 9,-1
17,w0,100,128,4,152,0,COMPLETED_WALLTIME_REACHED,902,152,1054,774,926,6.092105263157895,5 10 11 12,-1
118,w0,100,560,2,152,0,COMPLETED_WALLTIME_REACHED,904,152,1056,344,496,3.263157894736842,4 13,-1
18,w0,100,130,6,150,0,COMPLETED_WALLTIME_REACHED,905,150,1055,775,925,6.166666666666667,0 1 2 3 14 15,-1
31,w0,100,177,4,147,0,COMPLETED_WALLTIME_REACHED,906,147,1053,729,876,5.959183673469388,6 7 8 9,-1
32,w0,100,178,3,151,0,COMPLETED_WALLTIME_REACHED,1053,151,1204,875,1026,6.7947019867549665,6 7 8,-1
19,w0,100,131,5,150,0,COMPLETED_WALLTIME_REACHED,1054,150,1204,923,1073,7.153333333333333,5 9 10 11 12,-1
20,w0,100,131,4,151,0,COMPLETED_WALLTIME_REACHED,1055,151,1206,924,1075,7.119205298013245,0 1 2 3,-1
119,w0,100,561,2,148,0,COMPLETED_WALLTIME_REACHED,1055,148,1203,494,642,4.337837837837838,14 15,-1
168,w0,100,810,2,152,0,COMPLETED_WALLTIME_REACHED,1056,152,1208,246,398,2.6184210526315788,4 13,-1
170,w0,100,822,2,151,0,COMPLETED_WALLTIME_REACHED,1203,151,1354,381,532,3.5231788079470197,14 15,-1
22,w0,100,133,5,150,0,COMPLETED_WALLTIME_REACHED,1204,150,1354,1071,1221,8.14,5 6 7 8 9,-1
47,w0,100,233,3,149,0,COMPLETED_WALLTIME_REACHED,1204,149,1353,971,1120,7.516778523489933,10 11 12,-1
24,w0,100,144,4,149,0,COMPLETED_WALLTIME_REACHED,1206,149,1355,1062,1211,8.12751677852349,0 1 2 3,-1
26,w0,100,166,5,151,0,COMPLETED_WALLTIME_REACHED,1353,151,1504,1187,1338,8.860927152317881,4 10 11 12 13,-1
28,w0,100,169,5,150,0,COMPLETED_WALLTIME_REACHED,1354,150,1504,1185,1335,8.9,5 6 7 8 9,-1
172,w0,100,827,2,151,0,COMPLETED_WALLTIME_REACHED,1354,151,1505,527,678,4.490066225165563,14 15,-1
29,w0,100,169,4,151,0,COMPLETED_WALLTIME_REACHED,1355,151,1506,1186,1337,8.85430463576159,0 1 2 3,-1
33,w0,100,181,5,152,0,COMPLETED_WALLTIME_REACHED,1504,152,1656,1323,1475,9.703947368421053,4 5 6 7 8,-1
34,w0,100,183,5,152,0,COMPLETED_WALLTIME_REACHED,1504,152,1656,1321,1473,9.69078947368421,9 10 11 12 13,-1
35,w0,100,184,5,153,0,COMPLETED_WALLTIME_REACHED,1506,153,1659,1322,1475,9.640522875816993,0 1 2 3 14,-1
36,w0,100,186,6,145,0,COMPLETED_WALLTIME_REACHED,1656,145,1801,1470,1615,11.137931034482758,4 5 6 7 8 9,-1
37,w0,100,193,4,151,0,COMPLETED_WALLTIME_REACHED,1656,151,1807,1463,1614,10.688741721854305,10 11 12 13,-1
38,w0,100,195,5,149,0,COMPLETED_WALLTIME_REACHED,1659,149,1808,1464,1613,10.825503355704697,0 1 2 3 14,-1
39,w0,100,198,5,151,0,COMPLETED_WALLTIME_REACHED,1801,151,1952,1603,1754,11.6158940397351,4 5 6 7 8,-1
254,w0,100,1272,2,146,0,COMPLETED_WALLTIME_REACHED,1801,146,1947,529,675,4.623287671232877,9 15,-1
40,w0,100,198,4,151,0,COMPLETED_WALLTIME_REACHED,1807,151,1958,1609,1760,11.655629139072847,10 11 12 13,-1
41,w0,100,209,6,153,0,COMPLETED_WALLTIME_REACHED,1947,153,2100,1738,1891,12.359477124183007,0 1 2 3 9 14,-1
42,w0,100,209,5,148,0,COMPLETED_WALLTIME_REACHED,1952,148,2100,1743,1891,12.777027027027026,4 5 6 7 8,-1
44,w0,100,219,4,152,0,COMPLETED_WALLTIME_REACHED,1958,152,2110,1739,1891,12.44078947368421,10 11 12 13,-1
45,w0,100,222,4,152,0,COMPLETED_WALLTIME_REACHED,2100,152,2252,1878,2030,13.355263157894736,0 1 2 3,-1
46,w0,100,227,4,148,0,COMPLETED_WALLTIME_REACHED,2100,148,2248,1873,2021,13.655405405405405,4 5 6 7,-1
48,w0,100,239,4,150,0,COMPLETED_WALLTIME_REACHED,2100,150,2250,1861,2011,13.406666666666666,8 9 14 15,-1
49,w0,100,242,4,151,0,COMPLETED_WALLTIME_REACHED,2110,151,2261,1868,2019,13.370860927152318,10 11 12 13,-1
53,w0,100,259,3,151,0,COMPLETED_WALLTIME_REACHED,2248,151,2399,1989,2140,14.172185430463577,4 5 6,-1
50,w0,100,244,5,152,0,COMPLETED_WALLTIME_REACHED,2250,152,2402,2006,2158,14.197368421052632,7 8 9 14 15,-1
51,w0,100,249,4,155,0,COMPLETED_WALLTIME_REACHED,2252,155,2407,2003,2158,13.92258064516129,0 1 2 3,-1
264,w0,100,1323,2,150,0,COMPLETED_WALLTIME_REACHED,2261,150,2411,938,1088,7.253333333333333,10 11,-1
52,w0,100,259,5,149,0,COMPLETED_WALLTIME_REACHED,2399,149,2548,2140,2289,15.36241610738255,4 5 6 12 13,-1
54,w0,100,259,5,150,0,COMPLETED_WALLTIME_REACHED,2402,150,2552,2143,2293,15.286666666666667,7 8 9 14 15,-1
55,w0,100,264,6,153,0,COMPLETED_WALLTIME_REACHED,2411,153,2564,2147,2300,15.032679738562091,0 1 2 3 10 11,-1
56,w0,100,275,4,148,0,COMPLETED_WALLTIME_REACHED,2548,148,2696,2273,2421,16.35810810810811,4 5 6 12,-1
57,w0,100,276,6,149,0,COMPLETED_WALLTIME_REACHED,2552,149,2701,2276,2425,16.2751677852349,7 8 9 13 14 15,-1
58,w0,100,277,4,147,0,COMPLETED_WALLTIME_REACHED,2564,147,2711,2287,2434,16.5578231292517,0 1 2 3,-1
470,w0,100,2305,1,151,0,COMPLETED_WALLTIME_REACHED,2564,151,2715,259,410,2.7152317880794703,10,-1
59,w0,100,279,5,148,0,COMPLETED_WALLTIME_REACHED,2696,148,2844,2417,2565,17.33108108108108,4 5 6 11 12,-1
60,w0,100,280,4,149,0,COMPLETED_WALLTIME_REACHED,2701,149,2850,2421,2570,17.248322147651006,7 8 9 13,-1
266,w0,100,1329,2,148,0,COMPLETED_WALLTIME_REACHED,2701,148,2849,1372,1520,10.27027027027027,14 15,-1
61,w0,100,283,4,149,0,COMPLETED_WALLTIME_REACHED,2711,149,2860,2428,2577,17.29530201342282,0 1 2 3,-1
62,w0,100,288,3,151,0,COMPLETED_WALLTIME_REACHED,2844,151,2995,2556,2707,17.927152317880793,4 5 6,-1
66,w0,100,294,3,151,0,COMPLETED_WALLTIME_REACHED,2844,151,2995,2550,2701,17.887417218543046,10 11 12,-1
63,w0,100,288,6,152,0,COMPLETED_WALLTIME_REACHED,2850,152,3002,2562,2714,17.855263157894736,7 8 9 13 14 15,-1
65,w0,100,293,4,149,0,COMPLETED_WALLTIME_REACHED,2860,149,3009,2567,2716,18.22818791946309,0 1 2 3,-1
64,w0,100,288,5,149,0,COMPLETED_WALLTIME_REACHED,2995,149,3144,2707,2856,19.16778523489933,4 5 6 10 11,-1
67,w0,100,299,5,149,0,COMPLETED_WALLTIME_REACHED,3002,149,3151,2703,2852,19.140939597315437,7 8 9 12 13,-1
335,w0,100,1665,2,151,0,COMPLETED_WALLTIME_REACHED,3002,151,3153,1337,1488,9.85430463576159,14 15,-1
68,w0,100,301,4,147,0,COMPLETED_WALLTIME_REACHED,3009,147,3156,2708,2855,19.421768707482993,0 1 2 3,-1
69,w0,100,302,3,150,0,COMPLETED_WALLTIME_REACHED,3144,150,3294,2842,2992,19.946666666666665,4 5 6,-1
375,w0,100,1839,2,146,0,COMPLETED_WALLTIME_REACHED,3144,146,3290,1305,1451,9.938356164383562,10 11,-1
70,w0,100,307,5,147,0,COMPLETED_WALLTIME_REACHED,3151,147,3298,2844,2991,20.346938775510203,7 8 9 12 13,-1
71,w0,100,313,6,152,0,COMPLETED_WALLTIME_REACHED,3156,152,3308,2843,2995,19.70394736842105,0 1 2 3 14 15,-1
651,w0,100,3076,1,152,0,COMPLETED_WALLTIME_REACHED,3290,152,3442,214,366,2.4078947368421053,10,-1
72,w0,100,333,4,151,0,COMPLETED_WALLTIME_REACHED,3294,151,3445,2961,3112,20.60927152317881,4 5 6 11,-1
74,w0,100,349,3,152,0,COMPLETED_WALLTIME_REACHED,3298,152,3450,2949,3101,20.401315789473685,7 8 9,-1
394,w0,100,1961,2,153,0,COMPLETED_WALLTIME_REACHED,3298,153,3451,1337,1490,9.738562091503267,12 13,-1
73,w0,100,342,6,148,0,COMPLETED_WALLTIME_REACHED,3308,148,3456,2966,3114,21.04054054054054,0 1 2 3 14 15,-1
75,w0,100,362,5,152,0,COMPLETED_WALLTIME_REACHED,3445,152,3597,3083,3235,21.282894736842106,4 5 6 10 11,-1
76,w0,100,370,4,148,0,COMPLETED_WALLTIME_REACHED,3451,148,3599,3081,3229,21.81756756756757,7 8 9 12,-1
77,w0,100,371,3,145,0,COMPLETED_WALLTIME_REACHED,3456,145,3601,3085,3230,22.275862068965516,0 1 2,-1
79,w0,100,389,4,148,0,COMPLETED_WALLTIME_REACHED,3456,148,3604,3067,3215,21.722972972972972,3 13 14 15,-1
78,w0,100,374,5,149,0,COMPLETED_WALLTIME_REACHED,3597,149,3746,3223,3372,22.630872483221477,4 5 6 10 11,-1
534,w0,100,2552,2,149,0,COMPLETED_WALLTIME_REACHED,3599,149,3748,1047,1196,8.026845637583893,7 8,-1
80,w0,100,397,5,149,0,COMPLETED_WALLTIME_REACHED,3601,149,3750,3204,3353,22.503355704697988,0 1 2 9 12,-1
81,w0,100,402,4,148,0,COMPLETED_WALLTIME_REACHED,3604,148,3752,3202,3350,22.635135135135137,3 13 14 15,-1
82,w0,100,404,7,149,0,COMPLETED_WALLTIME_REACHED,3748,149,3897,3344,3493,23.44295302013423,4 5 6 7 8 10 11,-1
83,w0,100,408,5,149,0,COMPLETED_WALLTIME_REACHED,3750,149,3899,3342,3491,23.42953020134228,0 1 2 9 12,-1
86,w0,100,413,4,154,0,COMPLETED_WALLTIME_REACHED,3752,154,3906,3339,3493,22.681818181818183,3 13 14 15,-1
84,w0,100,410,6,152,0,COMPLETED_WALLTIME_REACHED,3897,152,4049,3487,3639,23.94078947368421,4 5 6 7 8 10,-1
87,w0,100,414,3,150,0,COMPLETED_WALLTIME_REACHED,3899,150,4049,3485,3635,24.233333333333334,0 1 2,-1
85,w0,100,412,7,151,0,COMPLETED_WALLTIME_REACHED,3906,151,4057,3494,3645,24.13907284768212,3 9 11 12 13 14 15,-1
88,w0,100,425,6,150,0,COMPLETED_WALLTIME_REACHED,4049,150,4199,3624,3774,25.16,0 1 2 4 5 6,-1
102,w0,100,471,3,146,0,COMPLETED_WALLTIME_REACHED,4049,146,4195,3578,3724,25.506849315068493,7 8 10,-1
89,w0,100,430,6,151,0,COMPLETED_WALLTIME_REACHED,4057,151,4208,3627,3778,25.019867549668874,3 9 11 12 13 14,-1
93,w0,100,454,4,147,0,COMPLETED_WALLTIME_REACHED,4195,147,4342,3741,3888,26.448979591836736,7 8 10 15,-1
90,w0,100,432,5,150,0,COMPLETED_WALLTIME_REACHED,4199,150,4349,3767,3917,26.113333333333333,0 1 2 4 5,-1
91,w0,100,432,5,150,0,COMPLETED_WALLTIME_REACHED,4208,150,4358,3776,3926,26.173333333333332,3 6 9 11 12,-1
92,w0,100,445,5,147,0,COMPLETED_WALLTIME_REACHED,4342,147,4489,3897,4044,27.510204081632654,7 8 10 13 14,-1
94,w0,100,456,5,151,0,COMPLETED_WALLTIME_REACHED,4349,151,4500,3893,4044,26.781456953642383,0 1 2 4 5,-1
95,w0,100,460,4,151,0,COMPLETED_WALLTIME_REACHED,4358,151,4509,3898,4049,26.814569536423843,3 6 9 11,-1
96,w0,100,462,6,149,0,COMPLETED_WALLTIME_REACHED,4489,149,4638,4027,4176,28.026845637583893,7 8 10 12 13 14,-1
97,w0,100,463,5,150,0,COMPLETED_WALLTIME_REACHED,4500,150,4650,4037,4187,27.913333333333334,0 1 2 4 5,-1
98,w0,100,465,4,147,0,COMPLETED_WALLTIME_REACHED,4509,147,4656,4044,4191,28.510204081632654,3 6 9 11,-1
99,w0,100,466,5,151,0,COMPLETED_WALLTIME_REACHED,4638,151,4789,4172,4323,28.629139072847682,7 8 10 12 13,-1
641,w0,100,3027,2,149,0,COMPLETED_WALLTIME_REACHED,4638,149,4787,1611,1760,11.812080536912752,14 15,-1
100,w0,100,467,4,148,0,COMPLETED_WALLTIME_REACHED,4650,148,4798,4183,4331,29.263513513513512,0 1 2 4,-1
101,w0,100,467,5,152,0,COMPLETED_WALLTIME_REACHED,4656,152,4808,4189,4341,28.55921052631579,3 5 6 9 11,-1
654,w0,100,3085,2,154,0,COMPLETED_WALLTIME_REACHED,4787,154,4941,1702,1856,12.051948051948052,14 15,-1
103,w0,100,478,5,147,0,COMPLETED_WALLTIME_REACHED,4789,147,4936,4311,4458,30.3265306122449,7 8 10 12 13,-1
107,w0,100,499,3,146,0,COMPLETED_WALLTIME_REACHED,4798,146,4944,4299,4445,30.445205479452056,0 1 2,-1
104,w0,100,484,5,146,0,COMPLETED_WALLTIME_REACHED,4808,146,4954,4324,4470,30.616438356164384,3 4 5 6 9,-1
105,w0,100,491,6,150,0,COMPLETED_WALLTIME_REACHED,4936,150,5086,4445,4595,30.633333333333333,7 8 10 11 12 13,-1
106,w0,100,493,5,152,0,COMPLETED_WALLTIME_REACHED,4944,152,5096,4451,4603,30.282894736842106,0 1 2 14 15,-1
108,w0,100,512,5,153,0,COMPLETED_WALLTIME_REACHED,4954,153,5107,4442,4595,30.03267973856209,3 4 5 6 9,-1
109,w0,100,517,3,151,0,COMPLETED_WALLTIME_REACHED,5086,151,5237,4569,4720,31.258278145695364,7 8 10,-1
111,w0,100,519,3,147,0,COMPLETED_WALLTIME_REACHED,5086,147,5233,4567,4714,32.06802721088435,11 12 13,-1
110,w0,100,518,4,152,0,COMPLETED_WALLTIME_REACHED,5096,152,5248,4578,4730,31.11842105263158,0 1 2 14,-1
112,w0,100,526,4,152,0,COMPLETED_WALLTIME_REACHED,5107,152,5259,4581,4733,31.138157894736842,3 4 5 6,-1
113,w0,100,528,5,150,0,COMPLETED_WALLTIME_REACHED,5233,150,5383,4705,4855,32.36666666666667,9 11 12 13 15,-1
114,w0,100,532,6,150,0,COMPLETED_WALLTIME_REACHED,5248,150,5398,4716,4866,32.44,0 1 2 7 8 10,-1
115,w0,100,534,5,152,0,COMPLETED_WALLTIME_REACHED,5259,152,5411,4725,4877,32.08552631578947,3 4 5 6 14,-1
116,w0,100,543,5,150,0,COMPLETED_WALLTIME_REACHED,5383,150,5533,4840,4990,33.266666666666666,9 11 12 13 15,-1
117,w0,100,549,4,148,0,COMPLETED_WALLTIME_REACHED,5398,148,5546,4849,4997,33.763513513513516,0 1 2 7,-1
722,w0,100,3445,2,152,0,COMPLETED_WALLTIME_REACHED,5398,152,5550,1953,2105,13.848684210526315,8 10,-1
120,w0,100,571,3,150,0,COMPLETED_WALLTIME_REACHED,5411,150,5561,4840,4990,33.266666666666666,3 4 5,-1
777,w0,100,3729,2,148,0,COMPLETED_WALLTIME_REACHED,5411,148,5559,1682,1830,12.364864864864865,6 14,-1
121,w0,100,578,5,147,0,COMPLETED_WALLTIME_REACHED,5533,147,5680,4955,5102,34.70748299319728,9 11 12 13 15,-1
122,w0,100,590,3,146,0,COMPLETED_WALLTIME_REACHED,5546,146,5692,4956,5102,34.945205479452056,0 1 2,-1
123,w0,100,590,5,145,0,COMPLETED_WALLTIME_REACHED,5559,145,5704,4969,5114,35.26896551724138,6 7 8 10 14,-1
126,w0,100,597,3,148,0,COMPLETED_WALLTIME_REACHED,5561,148,5709,4964,5112,34.54054054054054,3 4 5,-1
124,w0,100,591,5,149,0,COMPLETED_WALLTIME_REACHED,5680,149,5829,5089,5238,35.15436241610738,9 11 12 13 15,-1
129,w0,100,606,3,146,0,COMPLETED_WALLTIME_REACHED,5692,146,5838,5086,5232,35.83561643835616,0 1 2,-1
125,w0,100,597,4,153,0,COMPLETED_WALLTIME_REACHED,5704,153,5857,5107,5260,34.37908496732026,6 7 8 10,-1
127,w0,100,600,4,151,0,COMPLETED_WALLTIME_REACHED,5709,151,5860,5109,5260,34.83443708609271,3 4 5 14,-1
128,w0,100,604,4,149,0,COMPLETED_WALLTIME_REACHED,5829,149,5978,5225,5374,36.06711409395973,9 11 12 13,-1
785,w0,100,3802,2,150,0,COMPLETED_WALLTIME_REACHED,5838,150,5988,2036,2186,14.573333333333334,0 1,-1
130,w0,100,608,6,148,0,COMPLETED_WALLTIME_REACHED,5857,148,6005,5249,5397,36.46621621621622,2 6 7 8 10 15,-1
811,w0,100,3929,2,152,0,COMPLETED_WALLTIME_REACHED,5860,152,6012,1931,2083,13.703947368421053,3 4,-1
131,w0,100,608,6,152,0,COMPLETED_WALLTIME_REACHED,5978,152,6130,5370,5522,36.328947368421055,5 9 11 12 13 14,-1
895,w0,100,4316,2,151,0,COMPLETED_WALLTIME_REACHED,5988,151,6139,1672,1823,12.072847682119205,0 1,-1
132,w0,100,614,5,148,0,COMPLETED_WALLTIME_REACHED,6005,148,6153,5391,5539,37.42567567567568,2 6 7 8 10,-1
139,w0,100,651,3,148,0,COMPLETED_WALLTIME_REACHED,6012,148,6160,5361,5509,37.222972972972975,3 4 15,-1
133,w0,100,617,5,150,0,COMPLETED_WALLTIME_REACHED,6130,150,6280,5513,5663,37.75333333333333,5 9 11 12 13,-1
145,w0,100,661,3,153,0,COMPLETED_WALLTIME_REACHED,6139,153,6292,5478,5631,36.80392156862745,0 1 14,-1
134,w0,100,634,4,154,0,COMPLETED_WALLTIME_REACHED,6153,154,6307,5519,5673,36.83766233766234,2 6 7 8,-1
135,w0,100,635,4,151,0,COMPLETED_WALLTIME_REACHED,6160,151,6311,5525,5676,37.58940397350993,3 4 10 15,-1
136,w0,100,636,4,148,0,COMPLETED_WALLTIME_REACHED,6280,148,6428,5644,5792,39.13513513513514,5 9 11 12,-1
934,w0,100,4483,2,150,0,COMPLETED_WALLTIME_REACHED,6292,150,6442,1809,1959,13.06,0 1,-1
137,w0,100,642,6,148,0,COMPLETED_WALLTIME_REACHED,6307,148,6455,5665,5813,39.277027027027025,2 6 7 8 13 14,-1
146,w0,100,666,3,149,0,COMPLETED_WALLTIME_REACHED,6311,149,6460,5645,5794,38.88590604026846,3 4 10,-1
138,w0,100,643,5,150,0,COMPLETED_WALLTIME_REACHED,6428,150,6578,5785,5935,39.56666666666667,5 9 11 12 15,-1
993,w0,100,4861,2,150,0,COMPLETED_WALLTIME_REACHED,6442,150,6592,1581,1731,11.54,0 1,-1
140,w0,100,652,5,150,0,COMPLETED_WALLTIME_REACHED,6455,150,6605,5803,5953,39.68666666666667,2 6 7 8 13,-1
142,w0,100,656,4,148,0,COMPLETED_WALLTIME_REACHED,6460,148,6608,5804,5952,40.21621621621622,3 4 10 14,-1
141,w0,100,652,5,148,0,COMPLETED_WALLTIME_REACHED,6578,148,6726,5926,6074,41.04054054054054,5 9 11 12 15,-1
143,w0,100,657,4,149,0,COMPLETED_WALLTIME_REACHED,6605,149,6754,5948,6097,40.919463087248324,0 1 2 6,-1
153,w0,100,698,3,149,0,COMPLETED_WALLTIME_REACHED,6605,149,6754,5907,6056,40.644295302013425,7 8 13,-1
144,w0,100,658,4,150,0,COMPLETED_WALLTIME_REACHED,6608,150,6758,5950,6100,40.666666666666664,3 4 10 14,-1
147,w0,100,667,4,146,0,COMPLETED_WALLTIME_REACHED,6726,146,6872,6059,6205,42.5,5 9 11 12,-1
148,w0,100,669,4,149,0,COMPLETED_WALLTIME_REACHED,6754,149,6903,6085,6234,41.83892617449664,0 1 2 6,-1
157,w0,100,732,3,149,0,COMPLETED_WALLTIME_REACHED,6754,149,6903,6022,6171,41.41610738255034,7 8 13,-1
149,w0,100,676,5,146,0,COMPLETED_WALLTIME_REACHED,6758,146,6904,6082,6228,42.657534246575345,3 4 10 14 15,-1
150,w0,100,684,4,149,0,COMPLETED_WALLTIME_REACHED,6872,149,7021,6188,6337,42.53020134228188,5 9 11 12,-1
151,w0,100,693,4,146,0,COMPLETED_WALLTIME_REACHED,6903,146,7049,6210,6356,43.534246575342465,0 1 2 6,-1
162,w0,100,767,3,150,0,COMPLETED_WALLTIME_REACHED,6903,150,7053,6136,6286,41.906666666666666,7 8 13,-1
152,w0,100,695,4,154,0,COMPLETED_WALLTIME_REACHED,6904,154,7058,6209,6363,41.31818181818182,3 4 10 14,-1
154,w0,100,701,5,151,0,COMPLETED_WALLTIME_REACHED,7021,151,7172,6320,6471,42.854304635761586,5 9 11 12 15,-1
155,w0,100,704,4,149,0,COMPLETED_WALLTIME_REACHED,7049,149,7198,6345,6494,43.58389261744966,0 1 2 6,-1
163,w0,100,785,3,156,0,COMPLETED_WALLTIME_REACHED,7053,156,7209,6268,6424,41.17948717948718,7 8 13,-1
156,w0,100,716,4,151,0,COMPLETED_WALLTIME_REACHED,7058,151,7209,6342,6493,43.0,3 4 10 14,-1
158,w0,100,746,5,151,0,COMPLETED_WALLTIME_REACHED,7172,151,7323,6426,6577,43.556291390728475,5 9 11 12 15,-1
164,w0,100,792,4,151,0,COMPLETED_WALLTIME_REACHED,7198,151,7349,6406,6557,43.42384105960265,0 1 2 6,-1
159,w0,100,752,5,147,0,COMPLETED_WALLTIME_REACHED,7209,147,7356,6457,6604,44.925170068027214,3 4 7 8 10,-1
160,w0,100,763,5,145,0,COMPLETED_WALLTIME_REACHED,7323,145,7468,6560,6705,46.241379310344826,5 9 11 12 13,-1
161,w0,100,766,5,152,0,COMPLETED_WALLTIME_REACHED,7349,152,7501,6583,6735,44.30921052631579,0 1 2 6 14,-1
165,w0,100,797,4,151,0,COMPLETED_WALLTIME_REACHED,7356,151,7507,6559,6710,44.437086092715234,3 4 7 8,-1
166,w0,100,799,4,152,0,COMPLETED_WALLTIME_REACHED,7468,152,7620,6669,6821,44.875,5 9 10 11,-1
179,w0,100,881,3,151,0,COMPLETED_WALLTIME_REACHED,7468,151,7619,6587,6738,44.62251655629139,12 13 15,-1
167,w0,100,806,4,149,0,COMPLETED_WALLTIME_REACHED,7501,149,7650,6695,6844,45.93288590604027,0 1 2 6,-1
169,w0,100,820,4,146,0,COMPLETED_WALLTIME_REACHED,7507,146,7653,6687,6833,46.8013698630137,3 4 7 8,-1
181,w0,100,892,3,150,0,COMPLETED_WALLTIME_REACHED,7619,150,7769,6727,6877,45.846666666666664,12 13 14,-1
171,w0,100,826,5,147,0,COMPLETED_WALLTIME_REACHED,7620,147,7767,6794,6941,47.21768707482993,5 9 10 11 15,-1
185,w0,100,905,3,154,0,COMPLETED_WALLTIME_REACHED,7650,154,7804,6745,6899,44.798701298701296,0 1 2,-1
173,w0,100,838,5,153,0,COMPLETED_WALLTIME_REACHED,7653,153,7806,6815,6968,45.54248366013072,3 4 6 7 8,-1
174,w0,100,849,5,149,0,COMPLETED_WALLTIME_REACHED,7767,149,7916,6918,7067,47.42953020134228,5 9 10 11 15,-1
175,w0,100,852,4,149,0,COMPLETED_WALLTIME_REACHED,7804,149,7953,6952,7101,47.65771812080537,0 1 2 12,-1
176,w0,100,852,5,150,0,COMPLETED_WALLTIME_REACHED,7806,150,7956,6954,7104,47.36,3 4 6 7 8,-1
177,w0,100,869,4,155,0,COMPLETED_WALLTIME_REACHED,7916,155,8071,7047,7202,46.464516129032255,5 9 10 11,-1
178,w0,100,880,5,152,0,COMPLETED_WALLTIME_REACHED,7953,152,8105,7073,7225,47.5328947368421,0 1 2 12 13,-1
180,w0,100,891,5,153,0,COMPLETED_WALLTIME_REACHED,7956,153,8109,7065,7218,47.1764705882353,3 4 6 7 8,-1
182,w0,100,895,4,152,0,COMPLETED_WALLTIME_REACHED,8071,152,8223,7176,7328,48.21052631578947,5 9 10 11,-1
183,w0,100,899,5,151,0,COMPLETED_WALLTIME_REACHED,8105,151,8256,7206,7357,48.72185430463576,0 1 2 12 13,-1
184,w0,100,901,5,150,0,COMPLETED_WALLTIME_REACHED,8109,150,8259,7208,7358,49.053333333333335,3 4 6 7 8,-1
186,w0,100,907,4,147,0,COMPLETED_WALLTIME_REACHED,8223,147,8370,7316,7463,50.7687074829932,5 9 10 11,-1
187,w0,100,907,5,147,0,COMPLETED_WALLTIME_REACHED,8256,147,8403,7349,7496,50.993197278911566,0 1 2 12 13,-1
188,w0,100,912,6,149,0,COMPLETED_WALLTIME_REACHED,8259,149,8408,7347,7496,50.308724832214764,3 4 6 7 8 14,-1
189,w0,100,917,5,149,0,COMPLETED_WALLTIME_REACHED,8370,149,8519,7453,7602,51.02013422818792,5 9 10 11 15,-1
190,w0,100,925,5,149,0,COMPLETED_WALLTIME_REACHED,8403,149,8552,7478,7627,51.18791946308725,0 1 2 12 13,-1
191,w0,100,928,4,152,0,COMPLETED_WALLTIME_REACHED,8408,152,8560,7480,7632,50.21052631578947,3 4 6 7,-1
192,w0,100,933,6,149,0,COMPLETED_WALLTIME_REACHED,8519,149,8668,7586,7735,51.91275167785235,5 8 9 10 11 14,-1
193,w0,100,941,6,148,0,COMPLETED_WALLTIME_REACHED,8552,148,8700,7611,7759,52.42567567567568,0 1 2 12 13 15,-1
195,w0,100,946,4,152,0,COMPLETED_WALLTIME_REACHED,8560,152,8712,7614,7766,51.0921052631579,3 4 6 7,-1
194,w0,100,943,5,149,0,COMPLETED_WALLTIME_REACHED,8668,149,8817,7725,7874,52.84563758389262,5 8 9 10 11,-1
196,w0,100,950,5,151,0,COMPLETED_WALLTIME_REACHED,8700,151,8851,7750,7901,52.324503311258276,0 1 2 12 13,-1
197,w0,100,953,3,150,0,COMPLETED_WALLTIME_REACHED,8712,150,8862,7759,7909,52.72666666666667,3 4 6,-1
211,w0,100,1033,3,151,0,COMPLETED_WALLTIME_REACHED,8712,151,8863,7679,7830,51.854304635761586,7 14 15,-1
198,w0,100,965,4,151,0,COMPLETED_WALLTIME_REACHED,8817,151,8968,7852,8003,53.0,5 8 9 10,-1
199,w0,100,972,6,149,0,COMPLETED_WALLTIME_REACHED,8851,149,9000,7879,8028,53.87919463087248,0 1 2 11 12 13,-1
200,w0,100,977,4,150,0,COMPLETED_WALLTIME_REACHED,8863,150,9013,7886,8036,53.57333333333333,3 4 6 7,-1
201,w0,100,977,5,149,0,COMPLETED_WALLTIME_REACHED,8968,149,9117,7991,8140,54.630872483221474,5 8 9 10 14,-1
202,w0,100,978,5,153,0,COMPLETED_WALLTIME_REACHED,9000,153,9153,8022,8175,53.431372549019606,0 1 2 11 12,-1
203,w0,100,984,4,148,0,COMPLETED_WALLTIME_REACHED,9013,148,9161,8029,8177,55.25,3 4 6 7,-1
204,w0,100,999,5,151,0,COMPLETED_WALLTIME_REACHED,9117,151,9268,8118,8269,54.76158940397351,5 8 9 10 13,-1
205,w0,100,1005,5,148,0,COMPLETED_WALLTIME_REACHED,9153,148,9301,8148,8296,56.054054054054056,0 1 2 11 12,-1
206,w0,100,1014,5,150,0,COMPLETED_WALLTIME_REACHED,9161,150,9311,8147,8297,55.31333333333333,3 4 6 7 14,-1
207,w0,100,1023,4,153,0,COMPLETED_WALLTIME_REACHED,9268,153,9421,8245,8398,54.888888888888886,5 8 9 10,-1
208,w0,100,1025,4,154,0,COMPLETED_WALLTIME_REACHED,9301,154,9455,8276,8430,54.74025974025974,0 1 2 11,-1
218,w0,100,1064,3,152,0,COMPLETED_WALLTIME_REACHED,9301,152,9453,8237,8389,55.19078947368421,12 13 15,-1
209,w0,100,1032,5,146,0,COMPLETED_WALLTIME_REACHED,9311,146,9457,8279,8425,57.705479452054796,3 4 6 7 14,-1
210,w0,100,1032,5,147,0,COMPLETED_WALLTIME_REACHED,9453,147,9600,8421,8568,58.285714285714285,5 8 9 10 12,-1
212,w0,100,1034,5,147,0,COMPLETED_WALLTIME_REACHED,9455,147,9602,8421,8568,58.285714285714285,0 1 2 11 13,-1
213,w0,100,1037,4,152,0,COMPLETED_WALLTIME_REACHED,9457,152,9609,8420,8572,56.39473684210526,3 4 6 7,-1
214,w0,100,1042,4,150,0,COMPLETED_WALLTIME_REACHED,9600,150,9750,8558,8708,58.053333333333335,5 8 9 10,-1
215,w0,100,1042,6,147,0,COMPLETED_WALLTIME_REACHED,9602,147,9749,8560,8707,59.2312925170068,0 1 2 11 12 13,-1
216,w0,100,1045,4,150,0,COMPLETED_WALLTIME_REACHED,9609,150,9759,8564,8714,58.093333333333334,3 4 6 7,-1
217,w0,100,1052,5,148,0,COMPLETED_WALLTIME_REACHED,9749,148,9897,8697,8845,59.763513513513516,0 1 2 11 12,-1
255,w0,100,1277,3,151,0,COMPLETED_WALLTIME_REACHED,9749,151,9900,8472,8623,57.10596026490066,13 14 15,-1
219,w0,100,1065,4,147,0,COMPLETED_WALLTIME_REACHED,9750,147,9897,8685,8832,60.08163265306123,5 8 9 10,-1
220,w0,100,1079,4,148,0,COMPLETED_WALLTIME_REACHED,9759,148,9907,8680,8828,59.648648648648646,3 4 6 7,-1
221,w0,100,1086,7,149,0,COMPLETED_WALLTIME_REACHED,9897,149,10046,8811,8960,60.13422818791946,0 1 2 5 8 9 10,-1
256,w0,100,1279,3,149,0,COMPLETED_WALLTIME_REACHED,9900,149,10049,8621,8770,58.85906040268456,11 12 13,-1
222,w0,100,1087,6,148,0,COMPLETED_WALLTIME_REACHED,9907,148,10055,8820,8968,60.5945945945946,3 4 6 7 14 15,-1
223,w0,100,1096,4,150,0,COMPLETED_WALLTIME_REACHED,10046,150,10196,8950,9100,60.666666666666664,0 1 2 5,-1
224,w0,100,1097,6,150,0,COMPLETED_WALLTIME_REACHED,10049,150,10199,8952,9102,60.68,8 9 10 11 12 13,-1
225,w0,100,1107,5,148,0,COMPLETED_WALLTIME_REACHED,10055,148,10203,8948,9096,61.45945945945946,3 4 6 7 14,-1
226,w0,100,1114,4,151,0,COMPLETED_WALLTIME_REACHED,10196,151,10347,9082,9233,61.145695364238414,0 1 2 5,-1
227,w0,100,1115,5,150,0,COMPLETED_WALLTIME_REACHED,10199,150,10349,9084,9234,61.56,8 9 10 11 12,-1
228,w0,100,1121,4,148,0,COMPLETED_WALLTIME_REACHED,10203,148,10351,9082,9230,62.36486486486486,3 4 6 7,-1
257,w0,100,1283,3,154,0,COMPLETED_WALLTIME_REACHED,10203,154,10357,8920,9074,58.922077922077925,13 14 15,-1
229,w0,100,1123,4,151,0,COMPLETED_WALLTIME_REACHED,10347,151,10498,9224,9375,62.086092715231786,0 1 2 5,-1
230,w0,100,1124,5,150,0,COMPLETED_WALLTIME_REACHED,10349,150,10499,9225,9375,62.5,8 9 10 11 12,-1
231,w0,100,1127,4,151,0,COMPLETED_WALLTIME_REACHED,10351,151,10502,9224,9375,62.086092715231786,3 4 6 7,-1
258,w0,100,1297,3,148,0,COMPLETED_WALLTIME_REACHED,10357,148,10505,9060,9208,62.21621621621622,13 14 15,-1
232,w0,100,1134,4,152,0,COMPLETED_WALLTIME_REACHED,10498,152,10650,9364,9516,62.60526315789474,0 1 2 5,-1
233,w0,100,1143,5,149,0,COMPLETED_WALLTIME_REACHED,10499,149,10648,9356,9505,63.79194630872483,8 9 10 11 12,-1
234,w0,100,1151,6,147,0,COMPLETED_WALLTIME_REACHED,10505,147,10652,9354,9501,64.63265306122449,3 4 6 7 13 14,-1
235,w0,100,1159,4,147,0,COMPLETED_WALLTIME_REACHED,10648,147,10795,9489,9636,65.55102040816327,8 9 10 11,-1
236,w0,100,1171,4,148,0,COMPLETED_WALLTIME_REACHED,10650,148,10798,9479,9627,65.04729729729729,0 1 2 5,-1
237,w0,100,1172,6,150,0,COMPLETED_WALLTIME_REACHED,10652,150,10802,9480,9630,64.2,3 4 6 7 12 13,-1
238,w0,100,1179,6,150,0,COMPLETED_WALLTIME_REACHED,10795,150,10945,9616,9766,65.10666666666667,8 9 10 11 14 15,-1
239,w0,100,1183,4,148,0,COMPLETED_WALLTIME_REACHED,10798,148,10946,9615,9763,65.96621621621621,0 1 2 5,-1
240,w0,100,1185,5,148,0,COMPLETED_WALLTIME_REACHED,10802,148,10950,9617,9765,65.97972972972973,3 4 6 7 12,-1
241,w0,100,1195,4,151,0,COMPLETED_WALLTIME_REACHED,10945,151,11096,9750,9901,65.56953642384106,8 9 10 11,-1
267,w0,100,1331,3,148,0,COMPLETED_WALLTIME_REACHED,10945,148,11093,9614,9762,65.95945945945945,13 14 15,-1
242,w0,100,1198,4,149,0,COMPLETED_WALLTIME_REACHED,10946,149,11095,9748,9897,66.42281879194631,0 1 2 5,-1
243,w0,100,1216,5,151,0,COMPLETED_WALLTIME_REACHED,10950,151,11101,9734,9885,65.4635761589404,3 4 6 7 12,-1
244,w0,100,1219,5,149,0,COMPLETED_WALLTIME_REACHED,11095,149,11244,9876,10025,67.28187919463087,0 1 2 5 13,-1
245,w0,100,1233,4,152,0,COMPLETED_WALLTIME_REACHED,11096,152,11248,9863,10015,65.88815789473684,8 9 10 11,-1
246,w0,100,1237,5,151,0,COMPLETED_WALLTIME_REACHED,11101,151,11252,9864,10015,66.32450331125828,3 4 6 7 12,-1
247,w0,100,1246,5,148,0,COMPLETED_WALLTIME_REACHED,11244,148,11392,9998,10146,68.55405405405405,0 1 2 5 13,-1
248,w0,100,1248,5,149,0,COMPLETED_WALLTIME_REACHED,11248,149,11397,10000,10149,68.11409395973155,8 9 10 11 14,-1
249,w0,100,1250,4,149,0,COMPLETED_WALLTIME_REACHED,11252,149,11401,10002,10151,68.12751677852349,3 4 6 7,-1
250,w0,100,1254,7,150,0,COMPLETED_WALLTIME_REACHED,11392,150,11542,10138,10288,68.58666666666667,0 1 2 5 12 13 15,-1
251,w0,100,1267,5,150,0,COMPLETED_WALLTIME_REACHED,11397,150,11547,10130,10280,68.53333333333333,8 9 10 11 14,-1
262,w0,100,1315,4,150,0,COMPLETED_WALLTIME_REACHED,11401,150,11551,10086,10236,68.24,3 4 6 7,-1
252,w0,100,1270,5,150,0,COMPLETED_WALLTIME_REACHED,11542,150,11692,10272,10422,69.48,0 1 2 5 12,-1
253,w0,100,1272,6,150,0,COMPLETED_WALLTIME_REACHED,11547,150,11697,10275,10425,69.5,8 9 10 11 13 14,-1
269,w0,100,1339,3,152,0,COMPLETED_WALLTIME_REACHED,11551,152,11703,10212,10364,68.1842105263158,3 4 6,-1
259,w0,100,1298,6,151,0,COMPLETED_WALLTIME_REACHED,11692,151,11843,10394,10545,69.83443708609272,0 1 2 5 7 12,-1
260,w0,100,1307,5,150,0,COMPLETED_WALLTIME_REACHED,11697,150,11847,10390,10540,70.26666666666667,8 9 10 11 13,-1
261,w0,100,1311,5,152,0,COMPLETED_WALLTIME_REACHED,11703,152,11855,10392,10544,69.36842105263158,3 4 6 14 15,-1
263,w0,100,1317,6,150,0,COMPLETED_WALLTIME_REACHED,11843,150,11993,10526,10676,71.17333333333333,0 1 2 5 7 12,-1
265,w0,100,1326,5,152,0,COMPLETED_WALLTIME_REACHED,11847,152,11999,10521,10673,70.21710526315789,8 9 10 11 13,-1
271,w0,100,1347,5,153,0,COMPLETED_WALLTIME_REACHED,11855,153,12008,10508,10661,69.6797385620915,3 4 6 14 15,-1
268,w0,100,1335,6,149,0,COMPLETED_WALLTIME_REACHED,11993,149,12142,10658,10807,72.53020134228188,0 1 2 5 7 12,-1
272,w0,100,1350,3,149,0,COMPLETED_WALLTIME_REACHED,11999,149,12148,10649,10798,72.46979865771812,8 9 10,-1
270,w0,100,1343,6,150,0,COMPLETED_WALLTIME_REACHED,12008,150,12158,10665,10815,72.1,3 4 6 11 13 14,-1
273,w0,100,1361,4,150,0,COMPLETED_WALLTIME_REACHED,12142,150,12292,10781,10931,72.87333333333333,0 1 2 5,-1
274,w0,100,1366,6,148,0,COMPLETED_WALLTIME_REACHED,12148,148,12296,10782,10930,73.85135135135135,7 8 9 10 12 15,-1
275,w0,100,1373,5,150,0,COMPLETED_WALLTIME_REACHED,12158,150,12308,10785,10935,72.9,3 4 6 11 13,-1
276,w0,100,1379,4,148,0,COMPLETED_WALLTIME_REACHED,12292,148,12440,10913,11061,74.73648648648648,0 1 2 5,-1
277,w0,100,1385,5,149,0,COMPLETED_WALLTIME_REACHED,12296,149,12445,10911,11060,74.22818791946308,7 8 9 10 12,-1
278,w0,100,1385,5,149,0,COMPLETED_WALLTIME_REACHED,12308,149,12457,10923,11072,74.30872483221476,3 4 6 11 13,-1
279,w0,100,1387,5,148,0,COMPLETED_WALLTIME_REACHED,12440,148,12588,11053,11201,75.68243243243244,0 1 2 5 14,-1
280,w0,100,1392,3,150,0,COMPLETED_WALLTIME_REACHED,12445,150,12595,11053,11203,74.68666666666667,7 8 9,-1
283,w0,100,1413,3,149,0,COMPLETED_WALLTIME_REACHED,12445,149,12594,11032,11181,75.04026845637584,10 12 15,-1
281,w0,100,1396,5,152,0,COMPLETED_WALLTIME_REACHED,12457,152,12609,11061,11213,73.76973684210526,3 4 6 11 13,-1
282,w0,100,1399,6,150,0,COMPLETED_WALLTIME_REACHED,12594,150,12744,11195,11345,75.63333333333334,0 1 2 5 10 12,-1
287,w0,100,1439,3,149,0,COMPLETED_WALLTIME_REACHED,12595,149,12744,11156,11305,75.87248322147651,7 8 9,-1
284,w0,100,1427,6,147,0,COMPLETED_WALLTIME_REACHED,12609,147,12756,11182,11329,77.06802721088435,3 4 6 11 13 14,-1
285,w0,100,1428,6,146,0,COMPLETED_WALLTIME_REACHED,12744,146,12890,11316,11462,78.5068493150685,0 1 2 5 7 8,-1
288,w0,100,1439,4,150,0,COMPLETED_WALLTIME_REACHED,12744,150,12894,11305,11455,76.36666666666666,9 10 12 15,-1
286,w0,100,1429,6,152,0,COMPLETED_WALLTIME_REACHED,12756,152,12908,11327,11479,75.51973684210526,3 4 6 11 13 14,-1
289,w0,100,1448,5,148,0,COMPLETED_WALLTIME_REACHED,12890,148,13038,11442,11590,78.3108108108108,0 1 2 5 7,-1
290,w0,100,1457,3,151,0,COMPLETED_WALLTIME_REACHED,12894,151,13045,11437,11588,76.74172185430463,8 9 10,-1
291,w0,100,1459,5,152,0,COMPLETED_WALLTIME_REACHED,12908,152,13060,11449,11601,76.32236842105263,3 4 6 11 12,-1
310,w0,100,1542,3,148,0,COMPLETED_WALLTIME_REACHED,12908,148,13056,11366,11514,77.79729729729729,13 14 15,-1
292,w0,100,1467,4,149,0,COMPLETED_WALLTIME_REACHED,13038,149,13187,11571,11720,78.65771812080537,0 1 2 5,-1
293,w0,100,1471,5,152,0,COMPLETED_WALLTIME_REACHED,13056,152,13208,11585,11737,77.21710526315789,7 8 9 10 13,-1
294,w0,100,1472,5,151,0,COMPLETED_WALLTIME_REACHED,13060,151,13211,11588,11739,77.74172185430463,3 4 6 11 12,-1
295,w0,100,1477,5,154,0,COMPLETED_WALLTIME_REACHED,13187,154,13341,11710,11864,77.03896103896103,0 1 2 5 14,-1
296,w0,100,1480,5,145,0,COMPLETED_WALLTIME_REACHED,13208,145,13353,11728,11873,81.88275862068966,7 8 9 10 13,-1
297,w0,100,1481,6,150,0,COMPLETED_WALLTIME_REACHED,13211,150,13361,11730,11880,79.2,3 4 6 11 12 15,-1
298,w0,100,1487,4,152,0,COMPLETED_WALLTIME_REACHED,13341,152,13493,11854,12006,78.98684210526316,0 1 2 5,-1
299,w0,100,1488,6,148,0,COMPLETED_WALLTIME_REACHED,13353,148,13501,11865,12013,81.16891891891892,7 8 9 10 13 14,-1
300,w0,100,1492,4,154,0,COMPLETED_WALLTIME_REACHED,13361,154,13515,11869,12023,78.07142857142857,3 4 6 11,-1
301,w0,100,1503,6,150,0,COMPLETED_WALLTIME_REACHED,13493,150,13643,11990,12140,80.93333333333334,0 1 2 5 12 15,-1
302,w0,100,1507,5,152,0,COMPLETED_WALLTIME_REACHED,13501,152,13653,11994,12146,79.90789473684211,7 8 9 10 13,-1
303,w0,100,1514,5,151,0,COMPLETED_WALLTIME_REACHED,13515,151,13666,12001,12152,80.47682119205298,3 4 6 11 14,-1
304,w0,100,1518,5,148,0,COMPLETED_WALLTIME_REACHED,13643,148,13791,12125,12273,82.92567567567568,0 1 2 5 12,-1
305,w0,100,1521,6,151,0,COMPLETED_WALLTIME_REACHED,13653,151,13804,12132,12283,81.34437086092716,7 8 9 10 13 15,-1
308,w0,100,1530,4,149,0,COMPLETED_WALLTIME_REACHED,13666,149,13815,12136,12285,82.4496644295302,3 4 6 11,-1
306,w0,100,1522,6,151,0,COMPLETED_WALLTIME_REACHED,13791,151,13942,12269,12420,82.25165562913908,0 1 2 5 12 14,-1
307,w0,100,1529,5,149,0,COMPLETED_WALLTIME_REACHED,13804,149,13953,12275,12424,83.38255033557047,7 8 9 10 13,-1
309,w0,100,1537,4,150,0,COMPLETED_WALLTIME_REACHED,13815,150,13965,12278,12428,82.85333333333334,3 4 6 11,-1
311,w0,100,1542,6,146,0,COMPLETED_WALLTIME_REACHED,13942,146,14088,12400,12546,85.93150684931507,0 1 2 5 12 14,-1
312,w0,100,1544,5,148,0,COMPLETED_WALLTIME_REACHED,13953,148,14101,12409,12557,84.8445945945946,7 8 9 10 13,-1
313,w0,100,1551,4,151,0,COMPLETED_WALLTIME_REACHED,13965,151,14116,12414,12565,83.21192052980132,3 4 6 11,-1
314,w0,100,1552,4,150,0,COMPLETED_WALLTIME_REACHED,14088,150,14238,12536,12686,84.57333333333334,0 1 2 5,-1
318,w0,100,1562,3,148,0,COMPLETED_WALLTIME_REACHED,14088,148,14236,12526,12674,85.63513513513513,12 14 15,-1
315,w0,100,1553,4,150,0,COMPLETED_WALLTIME_REACHED,14101,150,14251,12548,12698,84.65333333333334,7 8 9 10,-1
316,w0,100,1557,6,149,0,COMPLETED_WALLTIME_REACHED,14236,149,14385,12679,12828,86.09395973154362,3 4 6 11 12 13,-1
317,w0,100,1560,4,148,0,COMPLETED_WALLTIME_REACHED,14238,148,14386,12678,12826,86.66216216216216,0 1 2 5,-1
319,w0,100,1566,4,149,0,COMPLETED_WALLTIME_REACHED,14251,149,14400,12685,12834,86.13422818791946,7 8 9 10,-1
320,w0,100,1568,5,147,0,COMPLETED_WALLTIME_REACHED,14385,147,14532,12817,12964,88.19047619047619,3 4 6 11 12,-1
325,w0,100,1610,3,151,0,COMPLETED_WALLTIME_REACHED,14385,151,14536,12775,12926,85.60264900662251,13 14 15,-1
321,w0,100,1587,4,149,0,COMPLETED_WALLTIME_REACHED,14386,149,14535,12799,12948,86.8993288590604,0 1 2 5,-1
339,w0,100,1686,3,152,0,COMPLETED_WALLTIME_REACHED,14400,152,14552,12714,12866,84.64473684210526,7 8 9,-1
322,w0,100,1588,6,153,0,COMPLETED_WALLTIME_REACHED,14532,153,14685,12944,13097,85.60130718954248,3 4 6 10 11 12,-1
323,w0,100,1591,5,152,0,COMPLETED_WALLTIME_REACHED,14536,152,14688,12945,13097,86.16447368421052,0 1 2 5 13,-1
324,w0,100,1595,4,153,0,COMPLETED_WALLTIME_REACHED,14552,153,14705,12957,13110,85.68627450980392,7 8 9 14,-1
326,w0,100,1610,7,148,0,COMPLETED_WALLTIME_REACHED,14685,148,14833,13075,13223,89.3445945945946,3 4 6 10 11 12 15,-1
354,w0,100,1751,3,155,0,COMPLETED_WALLTIME_REACHED,14688,155,14843,12937,13092,84.46451612903226,0 1 2,-1
327,w0,100,1613,6,151,0,COMPLETED_WALLTIME_REACHED,14705,151,14856,13092,13243,87.70198675496688,5 7 8 9 13 14,-1
328,w0,100,1620,6,148,0,COMPLETED_WALLTIME_REACHED,14833,148,14981,13213,13361,90.27702702702703,3 4 6 10 11 12,-1
329,w0,100,1641,4,149,0,COMPLETED_WALLTIME_REACHED,14843,149,14992,13202,13351,89.60402684563758,0 1 2 15,-1
330,w0,100,1647,5,148,0,COMPLETED_WALLTIME_REACHED,14856,148,15004,13209,13357,90.25,5 7 8 9 13,-1
331,w0,100,1648,4,147,0,COMPLETED_WALLTIME_REACHED,14981,147,15128,13333,13480,91.70068027210884,3 4 6 10,-1
380,w0,100,1865,3,150,0,COMPLETED_WALLTIME_REACHED,14981,150,15131,13116,13266,88.44,11 12 14,-1
332,w0,100,1651,4,152,0,COMPLETED_WALLTIME_REACHED,14992,152,15144,13341,13493,88.76973684210526,0 1 2 15,-1
333,w0,100,1663,4,154,0,COMPLETED_WALLTIME_REACHED,15004,154,15158,13341,13495,87.62987012987013,5 7 8 9,-1
334,w0,100,1663,5,148,0,COMPLETED_WALLTIME_REACHED,15128,148,15276,13465,13613,91.97972972972973,3 4 6 10 13,-1
388,w0,100,1933,3,150,0,COMPLETED_WALLTIME_REACHED,15131,150,15281,13198,13348,88.98666666666666,11 12 14,-1
336,w0,100,1666,4,152,0,COMPLETED_WALLTIME_REACHED,15144,152,15296,13478,13630,89.67105263157895,0 1 2 15,-1
337,w0,100,1666,4,151,0,COMPLETED_WALLTIME_REACHED,15158,151,15309,13492,13643,90.35099337748345,5 7 8 9,-1
338,w0,100,1674,5,150,0,COMPLETED_WALLTIME_REACHED,15276,150,15426,13602,13752,91.68,3 4 6 10 13,-1
397,w0,100,1982,3,150,0,COMPLETED_WALLTIME_REACHED,15281,150,15431,13299,13449,89.66,11 12 14,-1
340,w0,100,1687,4,149,0,COMPLETED_WALLTIME_REACHED,15296,149,15445,13609,13758,92.33557046979865,0 1 2 15,-1
341,w0,100,1691,4,147,0,COMPLETED_WALLTIME_REACHED,15309,147,15456,13618,13765,93.63945578231292,5 7 8 9,-1
342,w0,100,1708,4,151,0,COMPLETED_WALLTIME_REACHED,15426,151,15577,13718,13869,91.8476821192053,3 4 6 10,-1
400,w0,100,1989,3,152,0,COMPLETED_WALLTIME_REACHED,15431,152,15583,13442,13594,89.4342105263158,11 12 13,-1
343,w0,100,1709,5,150,0,COMPLETED_WALLTIME_REACHED,15445,150,15595,13736,13886,92.57333333333334,0 1 2 14 15,-1
402,w0,100,1996,3,149,0,COMPLETED_WALLTIME_REACHED,15456,149,15605,13460,13609,91.33557046979865,5 7 8,-1
344,w0,100,1710,5,147,0,COMPLETED_WALLTIME_REACHED,15577,147,15724,13867,14014,95.33333333333333,3 4 6 9 10,-1
345,w0,100,1715,6,149,0,COMPLETED_WALLTIME_REACHED,15595,149,15744,13880,14029,94.15436241610739,0 1 2 11 12 13,-1
349,w0,100,1741,4,148,0,COMPLETED_WALLTIME_REACHED,15605,148,15753,13864,14012,94.67567567567568,5 7 8 14,-1
346,w0,100,1717,6,149,0,COMPLETED_WALLTIME_REACHED,15724,149,15873,14007,14156,95.00671140939598,3 4 6 9 10 15,-1
347,w0,100,1721,5,149,0,COMPLETED_WALLTIME_REACHED,15744,149,15893,14023,14172,95.11409395973155,0 1 2 11 12,-1
348,w0,100,1725,5,150,0,COMPLETED_WALLTIME_REACHED,15753,150,15903,14028,14178,94.52,5 7 8 13 14,-1
350,w0,100,1742,4,147,0,COMPLETED_WALLTIME_REACHED,15873,147,16020,14131,14278,97.12925170068027,3 4 6 9,-1
351,w0,100,1742,6,153,0,COMPLETED_WALLTIME_REACHED,15893,153,16046,14151,14304,93.49019607843137,0 1 2 10 11 12,-1
352,w0,100,1744,5,149,0,COMPLETED_WALLTIME_REACHED,15903,149,16052,14159,14308,96.02684563758389,5 7 8 13 14,-1
353,w0,100,1746,5,152,0,COMPLETED_WALLTIME_REACHED,16020,152,16172,14274,14426,94.90789473684211,3 4 6 9 15,-1
355,w0,100,1753,5,150,0,COMPLETED_WALLTIME_REACHED,16046,150,16196,14293,14443,96.28666666666666,0 1 2 10 11,-1
356,w0,100,1762,5,151,0,COMPLETED_WALLTIME_REACHED,16052,151,16203,14290,14441,95.63576158940397,5 7 8 12 13,-1
357,w0,100,1762,4,148,0,COMPLETED_WALLTIME_REACHED,16172,148,16320,14410,14558,98.36486486486487,3 4 6 9,-1
358,w0,100,1764,5,151,0,COMPLETED_WALLTIME_REACHED,16196,151,16347,14432,14583,96.57615894039735,0 1 2 10 11,-1
359,w0,100,1770,5,152,0,COMPLETED_WALLTIME_REACHED,16203,152,16355,14433,14585,95.95394736842105,5 7 8 12 13,-1
360,w0,100,1772,4,150,0,COMPLETED_WALLTIME_REACHED,16320,150,16470,14548,14698,97.98666666666666,3 4 6 9,-1
361,w0,100,1773,4,149,0,COMPLETED_WALLTIME_REACHED,16347,149,16496,14574,14723,98.81208053691275,0 1 2 10,-1
362,w0,100,1775,6,150,0,COMPLETED_WALLTIME_REACHED,16355,150,16505,14580,14730,98.2,5 7 8 11 12 13,-1
363,w0,100,1776,4,152,0,COMPLETED_WALLTIME_REACHED,16470,152,16622,14694,14846,97.67105263157895,3 4 6 9,-1
364,w0,100,1780,4,149,0,COMPLETED_WALLTIME_REACHED,16496,149,16645,14716,14865,99.76510067114094,0 1 2 10,-1
365,w0,100,1783,5,148,0,COMPLETED_WALLTIME_REACHED,16505,148,16653,14722,14870,100.47297297297297,5 7 8 11 12,-1
366,w0,100,1793,6,151,0,COMPLETED_WALLTIME_REACHED,16622,151,16773,14829,14980,99.20529801324503,3 4 6 9 13 14,-1
367,w0,100,1794,4,151,0,COMPLETED_WALLTIME_REACHED,16645,151,16796,14851,15002,99.35099337748345,0 1 2 10,-1
368,w0,100,1795,4,155,0,COMPLETED_WALLTIME_REACHED,16653,155,16808,14858,15013,96.85806451612903,5 7 8 11,-1
369,w0,100,1797,5,149,0,COMPLETED_WALLTIME_REACHED,16773,149,16922,14976,15125,101.51006711409396,3 4 6 9 12,-1
410,w0,100,2012,3,151,0,COMPLETED_WALLTIME_REACHED,16773,151,16924,14761,14912,98.75496688741723,13 14 15,-1
370,w0,100,1804,4,151,0,COMPLETED_WALLTIME_REACHED,16796,151,16947,14992,15143,100.28476821192054,0 1 2 10,-1
378,w0,100,1853,4,153,0,COMPLETED_WALLTIME_REACHED,16808,153,16961,14955,15108,98.74509803921569,5 7 8 11,-1
371,w0,100,1819,5,151,0,COMPLETED_WALLTIME_REACHED,16922,151,17073,15103,15254,101.01986754966887,3 4 6 9 12,-1
372,w0,100,1819,5,148,0,COMPLETED_WALLTIME_REACHED,16947,148,17095,15128,15276,103.21621621621621,0 1 2 10 13,-1
373,w0,100,1832,5,146,0,COMPLETED_WALLTIME_REACHED,16961,146,17107,15129,15275,104.62328767123287,5 7 8 11 14,-1
374,w0,100,1835,5,149,0,COMPLETED_WALLTIME_REACHED,17073,149,17222,15238,15387,103.26845637583892,3 4 6 9 12,-1
376,w0,100,1844,5,151,0,COMPLETED_WALLTIME_REACHED,17095,151,17246,15251,15402,102.0,0 1 2 10 13,-1
377,w0,100,1847,5,148,0,COMPLETED_WALLTIME_REACHED,17107,148,17255,15260,15408,104.10810810810811,5 7 8 11 14,-1
379,w0,100,1854,4,149,0,COMPLETED_WALLTIME_REACHED,17222,149,17371,15368,15517,104.14093959731544,3 4 6 9,-1
381,w0,100,1868,5,153,0,COMPLETED_WALLTIME_REACHED,17246,153,17399,15378,15531,101.50980392156863,0 1 2 10 12,-1
382,w0,100,1874,4,150,0,COMPLETED_WALLTIME_REACHED,17255,150,17405,15381,15531,103.54,5 7 8 11,-1
427,w0,100,2097,3,148,0,COMPLETED_WALLTIME_REACHED,17255,148,17403,15158,15306,103.41891891891892,13 14 15,-1
383,w0,100,1876,4,152,0,COMPLETED_WALLTIME_REACHED,17371,152,17523,15495,15647,102.9407894736842,3 4 6 9,-1
384,w0,100,1878,5,150,0,COMPLETED_WALLTIME_REACHED,17399,150,17549,15521,15671,104.47333333333333,0 1 2 10 12,-1
429,w0,100,2100,3,149,0,COMPLETED_WALLTIME_REACHED,17403,149,17552,15303,15452,103.70469798657719,13 14 15,-1
385,w0,100,1886,4,151,0,COMPLETED_WALLTIME_REACHED,17405,151,17556,15519,15670,103.7748344370861,5 7 8 11,-1
390,w0,100,1939,4,148,0,COMPLETED_WALLTIME_REACHED,17523,148,17671,15584,15732,106.29729729729729,3 4 6 9,-1
386,w0,100,1894,5,152,0,COMPLETED_WALLTIME_REACHED,17549,152,17701,15655,15807,103.99342105263158,0 1 2 10 12,-1
387,w0,100,1904,5,151,0,COMPLETED_WALLTIME_REACHED,17556,151,17707,15652,15803,104.65562913907284,5 7 8 11 13,-1
389,w0,100,1936,5,148,0,COMPLETED_WALLTIME_REACHED,17671,148,17819,15735,15883,107.31756756756756,3 4 6 9 14,-1
391,w0,100,1951,4,150,0,COMPLETED_WALLTIME_REACHED,17701,150,17851,15750,15900,106.0,0 1 2 10,-1
392,w0,100,1958,6,149,0,COMPLETED_WALLTIME_REACHED,17707,149,17856,15749,15898,106.69798657718121,5 7 8 11 12 13,-1
393,w0,100,1959,8,148,0,COMPLETED_WALLTIME_REACHED,17851,148,17999,15892,16040,108.37837837837837,0 1 2 3 4 6 9 10,-1
395,w0,100,1970,5,155,0,COMPLETED_WALLTIME_REACHED,17856,155,18011,15886,16041,103.49032258064516,5 7 8 11 12,-1
448,w0,100,2195,3,150,0,COMPLETED_WALLTIME_REACHED,17856,150,18006,15661,15811,105.40666666666667,13 14 15,-1
396,w0,100,1977,5,153,0,COMPLETED_WALLTIME_REACHED,17999,153,18152,16022,16175,105.71895424836602,0 1 2 3 4,-1
398,w0,100,1986,4,150,0,COMPLETED_WALLTIME_REACHED,18006,150,18156,16020,16170,107.8,6 9 10 13,-1
399,w0,100,1988,4,149,0,COMPLETED_WALLTIME_REACHED,18011,149,18160,16023,16172,108.53691275167785,5 7 8 11,-1
449,w0,100,2197,3,150,0,COMPLETED_WALLTIME_REACHED,18011,150,18161,15814,15964,106.42666666666666,12 14 15,-1
401,w0,100,1994,4,146,0,COMPLETED_WALLTIME_REACHED,18152,146,18298,16158,16304,111.67123287671232,0 1 2 3,-1
403,w0,100,1997,7,148,0,COMPLETED_WALLTIME_REACHED,18160,148,18308,16163,16311,110.20945945945945,4 5 6 7 8 9 10,-1
404,w0,100,1998,5,147,0,COMPLETED_WALLTIME_REACHED,18161,147,18308,16163,16310,110.95238095238095,11 12 13 14 15,-1
405,w0,100,2000,4,149,0,COMPLETED_WALLTIME_REACHED,18298,149,18447,16298,16447,110.38255033557047,0 1 2 3,-1
406,w0,100,2001,7,149,0,COMPLETED_WALLTIME_REACHED,18308,149,18457,16307,16456,110.44295302013423,4 5 6 7 8 9 10,-1
407,w0,100,2002,5,153,0,COMPLETED_WALLTIME_REACHED,18308,153,18461,16306,16459,107.57516339869281,11 12 13 14 15,-1
412,w0,100,2024,4,150,0,COMPLETED_WALLTIME_REACHED,18447,150,18597,16423,16573,110.48666666666666,0 1 2 3,-1
408,w0,100,2005,5,150,0,COMPLETED_WALLTIME_REACHED,18457,150,18607,16452,16602,110.68,4 5 6 7 8,-1
409,w0,100,2006,5,148,0,COMPLETED_WALLTIME_REACHED,18461,148,18609,16455,16603,112.18243243243244,9 10 11 12 13,-1
411,w0,100,2012,6,151,0,COMPLETED_WALLTIME_REACHED,18597,151,18748,16585,16736,110.83443708609272,0 1 2 3 14 15,-1
413,w0,100,2027,5,149,0,COMPLETED_WALLTIME_REACHED,18607,149,18756,16580,16729,112.2751677852349,4 5 6 7 8,-1
414,w0,100,2030,4,147,0,COMPLETED_WALLTIME_REACHED,18609,147,18756,16579,16726,113.78231292517007,9 10 11 12,-1
415,w0,100,2042,5,149,0,COMPLETED_WALLTIME_REACHED,18748,149,18897,16706,16855,113.12080536912751,0 1 2 3 13,-1
416,w0,100,2050,5,148,0,COMPLETED_WALLTIME_REACHED,18756,148,18904,16706,16854,113.87837837837837,4 5 6 7 8,-1
417,w0,100,2055,4,152,0,COMPLETED_WALLTIME_REACHED,18756,152,18908,16701,16853,110.875,9 10 11 12,-1
418,w0,100,2061,4,151,0,COMPLETED_WALLTIME_REACHED,18897,151,19048,16836,16987,112.49668874172185,0 1 2 3,-1
451,w0,100,2204,3,149,0,COMPLETED_WALLTIME_REACHED,18897,149,19046,16693,16842,113.03355704697987,13 14 15,-1
419,w0,100,2071,5,151,0,COMPLETED_WALLTIME_REACHED,18904,151,19055,16833,16984,112.47682119205298,4 5 6 7 8,-1
420,w0,100,2071,4,148,0,COMPLETED_WALLTIME_REACHED,18908,148,19056,16837,16985,114.76351351351352,9 10 11 12,-1
452,w0,100,2210,3,152,0,COMPLETED_WALLTIME_REACHED,19046,152,19198,16836,16988,111.76315789473684,13 14 15,-1
421,w0,100,2072,4,152,0,COMPLETED_WALLTIME_REACHED,19048,152,19200,16976,17128,112.6842105263158,0 1 2 3,-1
464,w0,100,2279,3,150,0,COMPLETED_WALLTIME_REACHED,19055,150,19205,16776,16926,112.84,4 5 6,-1
422,w0,100,2077,6,151,0,COMPLETED_WALLTIME_REACHED,19056,151,19207,16979,17130,113.44370860927152,7 8 9 10 11 12,-1
486,w0,100,2358,3,151,0,COMPLETED_WALLTIME_REACHED,19198,151,19349,16840,16991,112.52317880794702,13 14 15,-1
423,w0,100,2082,4,151,0,COMPLETED_WALLTIME_REACHED,19200,151,19351,17118,17269,114.36423841059603,0 1 2 3,-1
496,w0,100,2390,3,150,0,COMPLETED_WALLTIME_REACHED,19205,150,19355,16815,16965,113.1,4 5 6,-1
424,w0,100,2088,5,149,0,COMPLETED_WALLTIME_REACHED,19207,149,19356,17119,17268,115.89261744966443,7 8 9 10 11,-1
499,w0,100,2397,3,152,0,COMPLETED_WALLTIME_REACHED,19349,152,19501,16952,17104,112.52631578947368,12 13 14,-1
425,w0,100,2093,5,151,0,COMPLETED_WALLTIME_REACHED,19351,151,19502,17258,17409,115.29139072847683,0 1 2 3 15,-1
426,w0,100,2095,6,151,0,COMPLETED_WALLTIME_REACHED,19356,151,19507,17261,17412,115.3112582781457,4 5 6 7 8 9,-1
428,w0,100,2099,5,148,0,COMPLETED_WALLTIME_REACHED,19501,148,19649,17402,17550,118.58108108108108,10 11 12 13 14,-1
430,w0,100,2105,4,149,0,COMPLETED_WALLTIME_REACHED,19502,149,19651,17397,17546,117.75838926174497,0 1 2 3,-1
431,w0,100,2114,5,150,0,COMPLETED_WALLTIME_REACHED,19507,150,19657,17393,17543,116.95333333333333,4 5 6 7 8,-1
432,w0,100,2124,5,150,0,COMPLETED_WALLTIME_REACHED,19649,150,19799,17525,17675,117.83333333333333,9 10 11 12 13,-1
433,w0,100,2129,4,148,0,COMPLETED_WALLTIME_REACHED,19651,148,19799,17522,17670,119.39189189189189,0 1 2 3,-1
434,w0,100,2131,5,148,0,COMPLETED_WALLTIME_REACHED,19657,148,19805,17526,17674,119.41891891891892,4 5 6 7 8,-1
435,w0,100,2131,4,150,0,COMPLETED_WALLTIME_REACHED,19799,150,19949,17668,17818,118.78666666666666,0 1 2 3,-1
436,w0,100,2142,5,152,0,COMPLETED_WALLTIME_REACHED,19799,152,19951,17657,17809,117.16447368421052,9 10 11 12 13,-1
437,w0,100,2145,6,152,0,COMPLETED_WALLTIME_REACHED,19805,152,19957,17660,17812,117.1842105263158,4 5 6 7 8 14,-1
438,w0,100,2147,5,150,0,COMPLETED_WALLTIME_REACHED,19949,150,20099,17802,17952,119.68,0 1 2 3 15,-1
439,w0,100,2148,4,146,0,COMPLETED_WALLTIME_REACHED,19951,146,20097,17803,17949,122.93835616438356,9 10 11 12,-1
440,w0,100,2155,5,152,0,COMPLETED_WALLTIME_REACHED,19957,152,20109,17802,17954,118.11842105263158,4 5 6 7 8,-1
441,w0,100,2156,4,150,0,COMPLETED_WALLTIME_REACHED,20097,150,20247,17941,18091,120.60666666666667,9 10 11 12,-1
442,w0,100,2157,6,146,0,COMPLETED_WALLTIME_REACHED,20099,146,20245,17942,18088,123.89041095890411,0 1 2 3 13 14,-1
443,w0,100,2168,4,151,0,COMPLETED_WALLTIME_REACHED,20109,151,20260,17941,18092,119.81456953642385,4 5 6 7,-1
444,w0,100,2169,5,147,0,COMPLETED_WALLTIME_REACHED,20245,147,20392,18076,18223,123.96598639455782,0 1 2 3 8,-1
511,w0,100,2437,3,147,0,COMPLETED_WALLTIME_REACHED,20245,147,20392,17808,17955,122.14285714285714,13 14 15,-1
445,w0,100,2181,4,154,0,COMPLETED_WALLTIME_REACHED,20247,154,20401,18066,18220,118.31168831168831,9 10 11 12,-1
453,w0,100,2214,4,150,0,COMPLETED_WALLTIME_REACHED,20260,150,20410,18046,18196,121.30666666666667,4 5 6 7,-1
446,w0,100,2184,6,149,0,COMPLETED_WALLTIME_REACHED,20392,149,20541,18208,18357,123.20134228187919,0 1 2 3 8 13,-1
447,w0,100,2192,6,150,0,COMPLETED_WALLTIME_REACHED,20401,150,20551,18209,18359,122.39333333333333,9 10 11 12 14 15,-1
454,w0,100,2220,4,149,0,COMPLETED_WALLTIME_REACHED,20410,149,20559,18190,18339,123.08053691275168,4 5 6 7,-1
450,w0,100,2202,6,150,0,COMPLETED_WALLTIME_REACHED,20541,150,20691,18339,18489,123.26,0 1 2 3 8 13,-1
455,w0,100,2223,5,149,0,COMPLETED_WALLTIME_REACHED,20551,149,20700,18328,18477,124.00671140939598,9 10 11 12 14,-1
456,w0,100,2234,5,149,0,COMPLETED_WALLTIME_REACHED,20559,149,20708,18325,18474,123.98657718120805,4 5 6 7 15,-1
457,w0,100,2238,5,149,0,COMPLETED_WALLTIME_REACHED,20691,149,20840,18453,18602,124.84563758389261,0 1 2 3 8,-1
458,w0,100,2239,6,149,0,COMPLETED_WALLTIME_REACHED,20700,149,20849,18461,18610,124.8993288590604,9 10 11 12 13 14,-1
459,w0,100,2249,4,149,0,COMPLETED_WALLTIME_REACHED,20708,149,20857,18459,18608,124.88590604026845,4 5 6 7,-1
460,w0,100,2249,4,153,0,COMPLETED_WALLTIME_REACHED,20840,153,20993,18591,18744,122.50980392156863,0 1 2 3,-1
461,w0,100,2252,6,148,0,COMPLETED_WALLTIME_REACHED,20849,148,20997,18597,18745,126.6554054054054,8 9 10 11 12 13,-1
462,w0,100,2261,4,146,0,COMPLETED_WALLTIME_REACHED,20857,146,21003,18596,18742,128.36986301369862,4 5 6 7,-1
463,w0,100,2261,5,151,0,COMPLETED_WALLTIME_REACHED,20993,151,21144,18732,18883,125.05298013245033,0 1 2 3 14,-1
465,w0,100,2285,4,151,0,COMPLETED_WALLTIME_REACHED,20997,151,21148,18712,18863,124.9205298013245,8 9 10 11,-1
513,w0,100,2443,3,153,0,COMPLETED_WALLTIME_REACHED,20997,153,21150,18554,18707,122.26797385620915,12 13 15,-1
466,w0,100,2298,4,149,0,COMPLETED_WALLTIME_REACHED,21003,149,21152,18705,18854,126.53691275167785,4 5 6 7,-1
467,w0,100,2301,5,151,0,COMPLETED_WALLTIME_REACHED,21144,151,21295,18843,18994,125.78807947019868,0 1 2 3 14,-1
468,w0,100,2302,6,150,0,COMPLETED_WALLTIME_REACHED,21150,150,21300,18848,18998,126.65333333333334,8 9 10 11 12 13,-1
472,w0,100,2308,4,150,0,COMPLETED_WALLTIME_REACHED,21152,150,21302,18844,18994,126.62666666666667,4 5 6 7,-1
469,w0,100,2304,6,149,0,COMPLETED_WALLTIME_REACHED,21295,149,21444,18991,19140,128.45637583892616,0 1 2 3 14 15,-1
471,w0,100,2305,5,148,0,COMPLETED_WALLTIME_REACHED,21300,148,21448,18995,19143,129.34459459459458,8 9 10 11 12,-1
473,w0,100,2309,5,152,0,COMPLETED_WALLTIME_REACHED,21302,152,21454,18993,19145,125.95394736842105,4 5 6 7 13,-1
474,w0,100,2313,4,150,0,COMPLETED_WALLTIME_REACHED,21444,150,21594,19131,19281,128.54,0 1 2 3,-1
475,w0,100,2318,7,152,0,COMPLETED_WALLTIME_REACHED,21448,152,21600,19130,19282,126.85526315789474,8 9 10 11 12 14 15,-1
476,w0,100,2321,5,153,0,COMPLETED_WALLTIME_REACHED,21454,153,21607,19133,19286,126.05228758169935,4 5 6 7 13,-1
478,w0,100,2330,4,150,0,COMPLETED_WALLTIME_REACHED,21594,150,21744,19264,19414,129.42666666666668,0 1 2 3,-1
477,w0,100,2329,5,150,0,COMPLETED_WALLTIME_REACHED,21600,150,21750,19271,19421,129.47333333333333,8 9 10 11 12,-1
479,w0,100,2332,6,145,0,COMPLETED_WALLTIME_REACHED,21607,145,21752,19275,19420,133.93103448275863,4 5 6 7 13 14,-1
485,w0,100,2355,4,150,0,COMPLETED_WALLTIME_REACHED,21744,150,21894,19389,19539,130.26,0 1 2 3,-1
480,w0,100,2339,6,149,0,COMPLETED_WALLTIME_REACHED,21750,149,21899,19411,19560,131.2751677852349,8 9 10 11 12 15,-1
481,w0,100,2342,5,147,0,COMPLETED_WALLTIME_REACHED,21752,147,21899,19410,19557,133.0408163265306,4 5 6 7 13,-1
483,w0,100,2347,5,152,0,COMPLETED_WALLTIME_REACHED,21894,152,22046,19547,19699,129.59868421052633,0 1 2 3 14,-1
482,w0,100,2344,6,150,0,COMPLETED_WALLTIME_REACHED,21899,150,22049,19555,19705,131.36666666666667,4 5 6 7 8 9,-1
488,w0,100,2367,4,149,0,COMPLETED_WALLTIME_REACHED,21899,149,22048,19532,19681,132.08724832214764,10 11 12 13,-1
484,w0,100,2352,6,155,0,COMPLETED_WALLTIME_REACHED,22046,155,22201,19694,19849,128.05806451612904,0 1 2 3 14 15,-1
490,w0,100,2369,4,151,0,COMPLETED_WALLTIME_REACHED,22048,151,22199,19679,19830,131.32450331125827,10 11 12 13,-1
487,w0,100,2360,5,149,0,COMPLETED_WALLTIME_REACHED,22049,149,22198,19689,19838,133.14093959731542,4 5 6 7 8,-1
489,w0,100,2367,5,148,0,COMPLETED_WALLTIME_REACHED,22198,148,22346,19831,19979,134.99324324324326,4 5 6 7 8,-1
491,w0,100,2374,4,150,0,COMPLETED_WALLTIME_REACHED,22199,150,22349,19825,19975,133.16666666666666,9 10 11 12,-1
492,w0,100,2375,5,151,0,COMPLETED_WALLTIME_REACHED,22201,151,22352,19826,19977,132.2980132450331,0 1 2 3 13,-1
493,w0,100,2385,5,150,0,COMPLETED_WALLTIME_REACHED,22346,150,22496,19961,20111,134.07333333333332,4 5 6 7 8,-1
494,w0,100,2386,4,151,0,COMPLETED_WALLTIME_REACHED,22349,151,22500,19963,20114,133.20529801324503,9 10 11 12,-1
495,w0,100,2390,4,154,0,COMPLETED_WALLTIME_REACHED,22352,154,22506,19962,20116,130.62337662337663,0 1 2 3,-1
515,w0,100,2472,3,150,0,COMPLETED_WALLTIME_REACHED,22352,150,22502,19880,20030,133.53333333333333,13 14 15,-1
497,w0,100,2393,4,150,0,COMPLETED_WALLTIME_REACHED,22496,150,22646,20103,20253,135.02,4 5 6 7,-1
498,w0,100,2393,7,151,0,COMPLETED_WALLTIME_REACHED,22502,151,22653,20109,20260,134.17218543046357,8 9 10 11 12 13 14,-1
500,w0,100,2398,4,154,0,COMPLETED_WALLTIME_REACHED,22506,154,22660,20108,20262,131.57142857142858,0 1 2 3,-1
501,w0,100,2399,4,148,0,COMPLETED_WALLTIME_REACHED,22646,148,22794,20247,20395,137.80405405405406,4 5 6 7,-1
502,w0,100,2401,5,151,0,COMPLETED_WALLTIME_REACHED,22653,151,22804,20252,20403,135.11920529801324,8 9 10 11 12,-1
503,w0,100,2409,5,148,0,COMPLETED_WALLTIME_REACHED,22660,148,22808,20251,20399,137.8310810810811,0 1 2 3 13,-1
504,w0,100,2412,4,152,0,COMPLETED_WALLTIME_REACHED,22794,152,22946,20382,20534,135.0921052631579,4 5 6 7,-1
505,w0,100,2413,4,153,0,COMPLETED_WALLTIME_REACHED,22804,153,22957,20391,20544,134.27450980392157,8 9 10 11,-1
528,w0,100,2527,3,152,0,COMPLETED_WALLTIME_REACHED,22804,152,22956,20277,20429,134.40131578947367,12 14 15,-1
506,w0,100,2422,5,148,0,COMPLETED_WALLTIME_REACHED,22808,148,22956,20386,20534,138.74324324324326,0 1 2 3 13,-1
507,w0,100,2431,4,149,0,COMPLETED_WALLTIME_REACHED,22946,149,23095,20515,20664,138.68456375838926,4 5 6 7,-1
508,w0,100,2432,7,149,0,COMPLETED_WALLTIME_REACHED,22956,149,23105,20524,20673,138.74496644295303,0 1 2 3 12 13 14,-1
509,w0,100,2433,5,152,0,COMPLETED_WALLTIME_REACHED,22957,152,23109,20524,20676,136.02631578947367,8 9 10 11 15,-1
512,w0,100,2440,4,148,0,COMPLETED_WALLTIME_REACHED,23095,148,23243,20655,20803,140.5608108108108,4 5 6 7,-1
510,w0,100,2434,6,148,0,COMPLETED_WALLTIME_REACHED,23105,148,23253,20671,20819,140.6689189189189,0 1 2 3 12 13,-1
514,w0,100,2462,5,147,0,COMPLETED_WALLTIME_REACHED,23109,147,23256,20647,20794,141.45578231292518,8 9 10 11 14,-1
517,w0,100,2479,5,149,0,COMPLETED_WALLTIME_REACHED,23243,149,23392,20764,20913,140.35570469798657,4 5 6 7 15,-1
516,w0,100,2475,6,150,0,COMPLETED_WALLTIME_REACHED,23253,150,23403,20778,20928,139.52,0 1 2 3 12 13,-1
518,w0,100,2483,4,146,0,COMPLETED_WALLTIME_REACHED,23256,146,23402,20773,20919,143.28082191780823,8 9 10 11,-1
519,w0,100,2485,4,151,0,COMPLETED_WALLTIME_REACHED,23392,151,23543,20907,21058,139.4569536423841,4 5 6 7,-1
520,w0,100,2485,4,152,0,COMPLETED_WALLTIME_REACHED,23402,152,23554,20917,21069,138.61184210526315,8 9 10 11,-1
521,w0,100,2492,5,147,0,COMPLETED_WALLTIME_REACHED,23403,147,23550,20911,21058,143.2517006802721,0 1 2 3 12,-1
522,w0,100,2502,5,150,0,COMPLETED_WALLTIME_REACHED,23543,150,23693,21041,21191,141.27333333333334,4 5 6 7 13,-1
523,w0,100,2506,4,149,0,COMPLETED_WALLTIME_REACHED,23550,149,23699,21044,21193,142.23489932885906,0 1 2 3,-1
524,w0,100,2517,6,152,0,COMPLETED_WALLTIME_REACHED,23554,152,23706,21037,21189,139.40131578947367,8 9 10 11 12 14,-1
525,w0,100,2518,6,150,0,COMPLETED_WALLTIME_REACHED,23693,150,23843,21175,21325,142.16666666666666,4 5 6 7 13 15,-1
527,w0,100,2521,4,150,0,COMPLETED_WALLTIME_REACHED,23699,150,23849,21178,21328,142.18666666666667,0 1 2 3,-1
526,w0,100,2520,5,148,0,COMPLETED_WALLTIME_REACHED,23706,148,23854,21186,21334,144.14864864864865,8 9 10 11 12,-1
529,w0,100,2529,5,149,0,COMPLETED_WALLTIME_REACHED,23843,149,23992,21314,21463,144.04697986577182,4 5 6 7 13,-1
530,w0,100,2540,5,149,0,COMPLETED_WALLTIME_REACHED,23849,149,23998,21309,21458,144.01342281879195,0 1 2 3 14,-1
531,w0,100,2544,4,148,0,COMPLETED_WALLTIME_REACHED,23854,148,24002,21310,21458,144.98648648648648,8 9 10 11,-1
532,w0,100,2548,4,149,0,COMPLETED_WALLTIME_REACHED,23992,149,24141,21444,21593,144.91946308724832,4 5 6 7,-1
537,w0,100,2571,3,147,0,COMPLETED_WALLTIME_REACHED,23992,147,24139,21421,21568,146.72108843537416,12 13 15,-1
533,w0,100,2551,5,152,0,COMPLETED_WALLTIME_REACHED,23998,152,24150,21447,21599,142.09868421052633,0 1 2 3 14,-1
535,w0,100,2563,5,148,0,COMPLETED_WALLTIME_REACHED,24139,148,24287,21576,21724,146.78378378378378,8 9 10 11 12,-1
536,w0,100,2563,6,146,0,COMPLETED_WALLTIME_REACHED,24141,146,24287,21578,21724,148.7945205479452,4 5 6 7 13 15,-1
538,w0,100,2574,5,149,0,COMPLETED_WALLTIME_REACHED,24150,149,24299,21576,21725,145.80536912751677,0 1 2 3 14,-1
539,w0,100,2583,6,153,0,COMPLETED_WALLTIME_REACHED,24287,153,24440,21704,21857,142.8562091503268,4 5 6 7 8 9,-1
541,w0,100,2592,3,150,0,COMPLETED_WALLTIME_REACHED,24287,150,24437,21695,21845,145.63333333333333,10 11 12,-1
540,w0,100,2588,6,153,0,COMPLETED_WALLTIME_REACHED,24299,153,24452,21711,21864,142.90196078431373,0 1 2 3 13 14,-1
544,w0,100,2599,4,148,0,COMPLETED_WALLTIME_REACHED,24437,148,24585,21838,21986,148.55405405405406,10 11 12 15,-1
542,w0,100,2592,5,151,0,COMPLETED_WALLTIME_REACHED,24440,151,24591,21848,21999,145.6887417218543,4 5 6 7 8,-1
543,w0,100,2595,6,151,0,COMPLETED_WALLTIME_REACHED,24452,151,24603,21857,22008,145.74834437086093,0 1 2 3 9 13,-1
547,w0,100,2617,3,153,0,COMPLETED_WALLTIME_REACHED,24585,153,24738,21968,22121,144.58169934640523,10 11 12,-1
545,w0,100,2602,6,150,0,COMPLETED_WALLTIME_REACHED,24591,150,24741,21989,22139,147.59333333333333,4 5 6 7 8 14,-1
546,w0,100,2607,6,149,0,COMPLETED_WALLTIME_REACHED,24603,149,24752,21996,22145,148.6241610738255,0 1 2 3 9 13,-1
548,w0,100,2617,4,151,0,COMPLETED_WALLTIME_REACHED,24738,151,24889,22121,22272,147.49668874172184,10 11 12 15,-1
549,w0,100,2628,5,148,0,COMPLETED_WALLTIME_REACHED,24741,148,24889,22113,22261,150.41216216216216,4 5 6 7 8,-1
550,w0,100,2632,5,150,0,COMPLETED_WALLTIME_REACHED,24752,150,24902,22120,22270,148.46666666666667,0 1 2 3 9,-1
551,w0,100,2634,4,149,0,COMPLETED_WALLTIME_REACHED,24889,149,25038,22255,22404,150.36241610738256,4 5 6 7,-1
552,w0,100,2638,6,153,0,COMPLETED_WALLTIME_REACHED,24889,153,25042,22251,22404,146.4313725490196,8 10 11 12 13 14,-1
553,w0,100,2644,6,149,0,COMPLETED_WALLTIME_REACHED,24902,149,25051,22258,22407,150.38255033557047,0 1 2 3 9 15,-1
554,w0,100,2646,3,150,0,COMPLETED_WALLTIME_REACHED,25038,150,25188,22392,22542,150.28,4 5 6,-1
555,w0,100,2652,5,148,0,COMPLETED_WALLTIME_REACHED,25042,148,25190,22390,22538,152.28378378378378,7 8 10 11 12,-1
556,w0,100,2656,5,147,0,COMPLETED_WALLTIME_REACHED,25051,147,25198,22395,22542,153.3469387755102,0 1 2 3 9,-1
557,w0,100,2671,4,148,0,COMPLETED_WALLTIME_REACHED,25188,148,25336,22517,22665,153.1418918918919,4 5 6 13,-1
558,w0,100,2672,5,153,0,COMPLETED_WALLTIME_REACHED,25190,153,25343,22518,22671,148.1764705882353,7 8 10 11 12,-1
559,w0,100,2676,5,151,0,COMPLETED_WALLTIME_REACHED,25198,151,25349,22522,22673,150.1523178807947,0 1 2 3 9,-1
560,w0,100,2679,6,150,0,COMPLETED_WALLTIME_REACHED,25336,150,25486,22657,22807,152.04666666666665,4 5 6 13 14 15,-1
561,w0,100,2688,5,149,0,COMPLETED_WALLTIME_REACHED,25343,149,25492,22655,22804,153.04697986577182,7 8 10 11 12,-1
562,w0,100,2693,5,151,0,COMPLETED_WALLTIME_REACHED,25349,151,25500,22656,22807,151.03973509933775,0 1 2 3 9,-1
563,w0,100,2695,4,148,0,COMPLETED_WALLTIME_REACHED,25486,148,25634,22791,22939,154.99324324324326,4 5 6 13,-1
564,w0,100,2697,4,147,0,COMPLETED_WALLTIME_REACHED,25492,147,25639,22795,22942,156.06802721088437,7 8 10 11,-1
570,w0,100,2725,3,149,0,COMPLETED_WALLTIME_REACHED,25492,149,25641,22767,22916,153.7986577181208,12 14 15,-1
565,w0,100,2704,4,150,0,COMPLETED_WALLTIME_REACHED,25500,150,25650,22796,22946,152.97333333333333,0 1 2 3,-1
566,w0,100,2705,4,150,0,COMPLETED_WALLTIME_REACHED,25634,150,25784,22929,23079,153.86,4 5 6 9,-1
567,w0,100,2707,4,150,0,COMPLETED_WALLTIME_REACHED,25639,150,25789,22932,23082,153.88,7 8 10 11,-1
568,w0,100,2722,4,152,0,COMPLETED_WALLTIME_REACHED,25641,152,25793,22919,23071,151.7828947368421,12 13 14 15,-1
569,w0,100,2724,6,148,0,COMPLETED_WALLTIME_REACHED,25784,148,25932,23060,23208,156.8108108108108,0 1 2 3 4 5,-1
571,w0,100,2728,4,150,0,COMPLETED_WALLTIME_REACHED,25789,150,25939,23061,23211,154.74,6 7 8 9,-1
572,w0,100,2734,5,151,0,COMPLETED_WALLTIME_REACHED,25793,151,25944,23059,23210,153.7086092715232,10 11 12 13 14,-1
573,w0,100,2734,3,149,0,COMPLETED_WALLTIME_REACHED,25932,149,26081,23198,23347,156.69127516778522,0 1 2,-1
574,w0,100,2741,4,147,0,COMPLETED_WALLTIME_REACHED,25932,147,26079,23191,23338,158.76190476190476,3 4 5 15,-1
578,w0,100,2759,3,147,0,COMPLETED_WALLTIME_REACHED,25939,147,26086,23180,23327,158.68707482993196,6 7 8,-1
575,w0,100,2748,6,150,0,COMPLETED_WALLTIME_REACHED,25944,150,26094,23196,23346,155.64,9 10 11 12 13 14,-1
576,w0,100,2749,5,153,0,COMPLETED_WALLTIME_REACHED,26081,153,26234,23332,23485,153.4967320261438,0 1 2 3 4,-1
577,w0,100,2749,5,152,0,COMPLETED_WALLTIME_REACHED,26086,152,26238,23337,23489,154.5328947368421,5 6 7 8 15,-1
579,w0,100,2762,6,151,0,COMPLETED_WALLTIME_REACHED,26094,151,26245,23332,23483,155.51655629139074,9 10 11 12 13 14,-1
580,w0,100,2766,5,149,0,COMPLETED_WALLTIME_REACHED,26234,149,26383,23468,23617,158.50335570469798,0 1 2 3 4,-1
581,w0,100,2767,4,151,0,COMPLETED_WALLTIME_REACHED,26238,151,26389,23471,23622,156.43708609271522,5 6 7 8,-1
582,w0,100,2768,3,146,0,COMPLETED_WALLTIME_REACHED,26245,146,26391,23477,23623,161.8013698630137,9 10 11,-1
584,w0,100,2776,4,150,0,COMPLETED_WALLTIME_REACHED,26245,150,26395,23469,23619,157.46,12 13 14 15,-1
583,w0,100,2771,5,147,0,COMPLETED_WALLTIME_REACHED,26383,147,26530,23612,23759,161.62585034013605,0 1 2 3 4,-1
585,w0,100,2780,5,151,0,COMPLETED_WALLTIME_REACHED,26391,151,26542,23611,23762,157.36423841059602,5 6 7 8 9,-1
586,w0,100,2780,6,152,0,COMPLETED_WALLTIME_REACHED,26395,152,26547,23615,23767,156.36184210526315,10 11 12 13 14 15,-1
587,w0,100,2782,5,151,0,COMPLETED_WALLTIME_REACHED,26530,151,26681,23748,23899,158.27152317880794,0 1 2 3 4,-1
588,w0,100,2788,5,150,0,COMPLETED_WALLTIME_REACHED,26542,150,26692,23754,23904,159.36,5 6 7 8 9,-1
589,w0,100,2788,5,154,0,COMPLETED_WALLTIME_REACHED,26547,154,26701,23759,23913,155.2792207792208,10 11 12 13 14,-1
590,w0,100,2790,3,146,0,COMPLETED_WALLTIME_REACHED,26681,146,26827,23891,24037,164.63698630136986,0 1 2,-1
591,w0,100,2791,3,150,0,COMPLETED_WALLTIME_REACHED,26681,150,26831,23890,24040,160.26666666666668,3 4 15,-1
592,w0,100,2794,4,152,0,COMPLETED_WALLTIME_REACHED,26692,152,26844,23898,24050,158.22368421052633,5 6 7 8,-1
593,w0,100,2806,4,152,0,COMPLETED_WALLTIME_REACHED,26701,152,26853,23895,24047,158.20394736842104,9 10 11 12,-1
594,w0,100,2807,5,147,0,COMPLETED_WALLTIME_REACHED,26827,147,26974,24020,24167,164.40136054421768,0 1 2 13 14,-1
595,w0,100,2814,5,151,0,COMPLETED_WALLTIME_REACHED,26844,151,26995,24030,24181,160.13907284768212,3 4 5 6 7,-1
596,w0,100,2815,4,151,0,COMPLETED_WALLTIME_REACHED,26853,151,27004,24038,24189,160.19205298013244,8 9 10 11,-1
597,w0,100,2818,5,152,0,COMPLETED_WALLTIME_REACHED,26974,152,27126,24156,24308,159.92105263157896,0 1 2 12 13,-1
598,w0,100,2824,5,148,0,COMPLETED_WALLTIME_REACHED,26995,148,27143,24171,24319,164.31756756756758,3 4 5 6 7,-1
599,w0,100,2824,5,149,0,COMPLETED_WALLTIME_REACHED,27004,149,27153,24180,24329,163.28187919463087,8 9 10 11 14,-1
600,w0,100,2847,4,150,0,COMPLETED_WALLTIME_REACHED,27126,150,27276,24279,24429,162.86,0 1 2 12,-1
601,w0,100,2847,5,152,0,COMPLETED_WALLTIME_REACHED,27143,152,27295,24296,24448,160.8421052631579,3 4 5 6 7,-1
602,w0,100,2852,5,150,0,COMPLETED_WALLTIME_REACHED,27153,150,27303,24301,24451,163.00666666666666,8 9 10 11 13,-1
603,w0,100,2867,6,151,0,COMPLETED_WALLTIME_REACHED,27276,151,27427,24409,24560,162.64900662251657,0 1 2 12 14 15,-1
604,w0,100,2873,3,153,0,COMPLETED_WALLTIME_REACHED,27295,153,27448,24422,24575,160.62091503267973,3 4 5,-1
605,w0,100,2878,4,151,0,COMPLETED_WALLTIME_REACHED,27303,151,27454,24425,24576,162.75496688741723,6 7 8 9,-1
607,w0,100,2889,3,149,0,COMPLETED_WALLTIME_REACHED,27303,149,27452,24414,24563,164.8523489932886,10 11 13,-1
606,w0,100,2887,4,150,0,COMPLETED_WALLTIME_REACHED,27427,150,27577,24540,24690,164.6,0 1 2 12,-1
608,w0,100,2891,5,152,0,COMPLETED_WALLTIME_REACHED,27448,152,27600,24557,24709,162.55921052631578,3 4 5 14 15,-1
609,w0,100,2893,5,151,0,COMPLETED_WALLTIME_REACHED,27454,151,27605,24561,24712,163.65562913907286,6 7 8 9 10,-1
610,w0,100,2895,3,147,0,COMPLETED_WALLTIME_REACHED,27577,147,27724,24682,24829,168.9047619047619,0 1 2,-1
628,w0,100,2999,3,151,0,COMPLETED_WALLTIME_REACHED,27577,151,27728,24578,24729,163.7682119205298,11 12 13,-1
611,w0,100,2900,4,151,0,COMPLETED_WALLTIME_REACHED,27600,151,27751,24700,24851,164.57615894039736,3 4 5 14,-1
612,w0,100,2900,4,153,0,COMPLETED_WALLTIME_REACHED,27605,153,27758,24705,24858,162.47058823529412,6 7 8 9,-1
613,w0,100,2908,5,148,0,COMPLETED_WALLTIME_REACHED,27724,148,27872,24816,24964,168.67567567567568,0 1 2 10 15,-1
614,w0,100,2917,5,152,0,COMPLETED_WALLTIME_REACHED,27751,152,27903,24834,24986,164.3815789473684,3 4 5 11 12,-1
615,w0,100,2924,4,150,0,COMPLETED_WALLTIME_REACHED,27758,150,27908,24834,24984,166.56,6 7 8 9,-1
616,w0,100,2925,5,151,0,COMPLETED_WALLTIME_REACHED,27872,151,28023,24947,25098,166.21192052980132,0 1 2 10 13,-1
617,w0,100,2935,5,151,0,COMPLETED_WALLTIME_REACHED,27903,151,28054,24968,25119,166.35099337748343,3 4 5 11 12,-1
618,w0,100,2935,5,147,0,COMPLETED_WALLTIME_REACHED,27908,147,28055,24973,25120,170.8843537414966,6 7 8 9 14,-1
619,w0,100,2940,6,152,0,COMPLETED_WALLTIME_REACHED,28023,152,28175,25083,25235,166.01973684210526,0 1 2 10 13 15,-1
620,w0,100,2950,5,148,0,COMPLETED_WALLTIME_REACHED,28054,148,28202,25104,25252,170.6216216216216,3 4 5 11 12,-1
621,w0,100,2952,5,149,0,COMPLETED_WALLTIME_REACHED,28055,149,28204,25103,25252,169.4765100671141,6 7 8 9 14,-1
622,w0,100,2952,5,151,0,COMPLETED_WALLTIME_REACHED,28175,151,28326,25223,25374,168.03973509933775,0 1 2 10 13,-1
623,w0,100,2967,4,149,0,COMPLETED_WALLTIME_REACHED,28202,149,28351,25235,25384,170.36241610738256,3 4 5 11,-1
624,w0,100,2967,6,148,0,COMPLETED_WALLTIME_REACHED,28204,148,28352,25237,25385,171.52027027027026,6 7 8 9 12 14,-1
625,w0,100,2982,5,144,0,COMPLETED_WALLTIME_REACHED,28326,144,28470,25344,25488,177.0,0 1 2 10 13,-1
626,w0,100,2988,4,149,0,COMPLETED_WALLTIME_REACHED,28351,149,28500,25363,25512,171.2214765100671,3 4 5 11,-1
627,w0,100,2995,5,151,0,COMPLETED_WALLTIME_REACHED,28352,151,28503,25357,25508,168.9271523178808,6 7 8 9 12,-1
629,w0,100,3000,5,148,0,COMPLETED_WALLTIME_REACHED,28470,148,28618,25470,25618,173.09459459459458,0 1 2 10 13,-1
630,w0,100,3002,3,154,0,COMPLETED_WALLTIME_REACHED,28500,154,28654,25498,25652,166.57142857142858,3 4 5,-1
631,w0,100,3006,6,149,0,COMPLETED_WALLTIME_REACHED,28503,149,28652,25497,25646,172.1208053691275,6 7 8 9 11 12,-1
632,w0,100,3006,4,149,0,COMPLETED_WALLTIME_REACHED,28618,149,28767,25612,25761,172.89261744966444,0 1 2 10,-1
648,w0,100,3057,3,148,0,COMPLETED_WALLTIME_REACHED,28618,148,28766,25561,25709,173.70945945945945,13 14 15,-1
633,w0,100,3007,4,149,0,COMPLETED_WALLTIME_REACHED,28652,149,28801,25645,25794,173.11409395973155,6 7 8 9,-1
634,w0,100,3007,5,149,0,COMPLETED_WALLTIME_REACHED,28654,149,28803,25647,25796,173.1275167785235,3 4 5 11 12,-1
650,w0,100,3059,3,153,0,COMPLETED_WALLTIME_REACHED,28766,153,28919,25707,25860,169.01960784313727,13 14 15,-1
635,w0,100,3008,4,148,0,COMPLETED_WALLTIME_REACHED,28767,148,28915,25759,25907,175.0472972972973,0 1 2 10,-1
638,w0,100,3024,4,147,0,COMPLETED_WALLTIME_REACHED,28801,147,28948,25777,25924,176.35374149659864,6 7 8 9,-1
636,w0,100,3012,5,149,0,COMPLETED_WALLTIME_REACHED,28803,149,28952,25791,25940,174.09395973154363,3 4 5 11 12,-1
637,w0,100,3017,7,150,0,COMPLETED_WALLTIME_REACHED,28919,150,29069,25902,26052,173.68,0 1 2 10 13 14 15,-1
644,w0,100,3041,4,152,0,COMPLETED_WALLTIME_REACHED,28948,152,29100,25907,26059,171.44078947368422,6 7 8 9,-1
639,w0,100,3025,5,152,0,COMPLETED_WALLTIME_REACHED,28952,152,29104,25927,26079,171.57236842105263,3 4 5 11 12,-1
640,w0,100,3026,5,150,0,COMPLETED_WALLTIME_REACHED,29069,150,29219,26043,26193,174.62,0 1 2 10 13,-1
642,w0,100,3035,5,148,0,COMPLETED_WALLTIME_REACHED,29100,148,29248,26065,26213,177.11486486486487,6 7 8 9 14,-1
659,w0,100,3104,3,147,0,COMPLETED_WALLTIME_REACHED,29104,147,29251,26000,26147,177.87074829931973,3 4 5,-1
643,w0,100,3036,7,151,0,COMPLETED_WALLTIME_REACHED,29219,151,29370,26183,26334,174.39735099337747,0 1 2 10 11 12 13,-1
645,w0,100,3043,5,147,0,COMPLETED_WALLTIME_REACHED,29248,147,29395,26205,26352,179.26530612244898,6 7 8 9 14,-1
660,w0,100,3106,4,151,0,COMPLETED_WALLTIME_REACHED,29251,151,29402,26145,26296,174.1456953642384,3 4 5 15,-1
646,w0,100,3050,6,149,0,COMPLETED_WALLTIME_REACHED,29370,149,29519,26320,26469,177.64429530201343,0 1 2 10 11 12,-1
647,w0,100,3054,5,151,0,COMPLETED_WALLTIME_REACHED,29395,151,29546,26341,26492,175.4437086092715,6 7 8 9 13,-1
649,w0,100,3058,5,149,0,COMPLETED_WALLTIME_REACHED,29402,149,29551,26344,26493,177.80536912751677,3 4 5 14 15,-1
652,w0,100,3079,5,152,0,COMPLETED_WALLTIME_REACHED,29519,152,29671,26440,26592,174.94736842105263,0 1 2 10 11,-1
653,w0,100,3082,5,153,0,COMPLETED_WALLTIME_REACHED,29546,153,29699,26464,26617,173.96732026143792,6 7 8 9 12,-1
655,w0,100,3085,5,147,0,COMPLETED_WALLTIME_REACHED,29551,147,29698,26466,26613,181.0408163265306,3 4 5 13 14,-1
656,w0,100,3099,5,149,0,COMPLETED_WALLTIME_REACHED,29671,149,29820,26572,26721,179.33557046979865,0 1 2 10 11,-1
657,w0,100,3102,5,152,0,COMPLETED_WALLTIME_REACHED,29698,152,29850,26596,26748,175.97368421052633,3 4 5 13 14,-1
658,w0,100,3103,5,152,0,COMPLETED_WALLTIME_REACHED,29699,152,29851,26596,26748,175.97368421052633,6 7 8 9 12,-1
661,w0,100,3112,6,150,0,COMPLETED_WALLTIME_REACHED,29820,150,29970,26708,26858,179.05333333333334,0 1 2 10 11 15,-1
662,w0,100,3116,5,149,0,COMPLETED_WALLTIME_REACHED,29850,149,29999,26734,26883,180.4228187919463,3 4 5 13 14,-1
664,w0,100,3129,4,150,0,COMPLETED_WALLTIME_REACHED,29851,150,30001,26722,26872,179.14666666666668,6 7 8 9,-1
663,w0,100,3125,7,147,0,COMPLETED_WALLTIME_REACHED,29970,147,30117,26845,26992,183.61904761904762,0 1 2 10 11 12 15,-1
665,w0,100,3129,5,148,0,COMPLETED_WALLTIME_REACHED,29999,148,30147,26870,27018,182.55405405405406,3 4 5 13 14,-1
667,w0,100,3138,4,148,0,COMPLETED_WALLTIME_REACHED,30001,148,30149,26863,27011,182.50675675675674,6 7 8 9,-1
666,w0,100,3131,5,147,0,COMPLETED_WALLTIME_REACHED,30117,147,30264,26986,27133,184.57823129251702,0 1 2 10 11,-1
668,w0,100,3144,5,154,0,COMPLETED_WALLTIME_REACHED,30147,154,30301,27003,27157,176.34415584415584,3 4 5 12 13,-1
669,w0,100,3149,4,152,0,COMPLETED_WALLTIME_REACHED,30149,152,30301,27000,27152,178.6315789473684,6 7 8 9,-1
670,w0,100,3150,4,149,0,COMPLETED_WALLTIME_REACHED,30264,149,30413,27114,27263,182.9731543624161,0 1 2 10,-1
678,w0,100,3183,3,148,0,COMPLETED_WALLTIME_REACHED,30264,148,30412,27081,27229,183.97972972972974,11 14 15,-1
671,w0,100,3150,5,148,0,COMPLETED_WALLTIME_REACHED,30301,148,30449,27151,27299,184.4527027027027,3 4 5 6 7,-1
672,w0,100,3152,4,148,0,COMPLETED_WALLTIME_REACHED,30301,148,30449,27149,27297,184.4391891891892,8 9 12 13,-1
684,w0,100,3225,3,151,0,COMPLETED_WALLTIME_REACHED,30412,151,30563,27187,27338,181.04635761589404,11 14 15,-1
673,w0,100,3152,4,148,0,COMPLETED_WALLTIME_REACHED,30413,148,30561,27261,27409,185.19594594594594,0 1 2 10,-1
674,w0,100,3157,6,145,0,COMPLETED_WALLTIME_REACHED,30449,145,30594,27292,27437,189.2206896551724,3 4 5 6 7 8,-1
675,w0,100,3171,6,151,0,COMPLETED_WALLTIME_REACHED,30561,151,30712,27390,27541,182.39072847682118,0 1 2 9 10 12,-1
680,w0,100,3191,4,148,0,COMPLETED_WALLTIME_REACHED,30563,148,30711,27372,27520,185.94594594594594,11 13 14 15,-1
676,w0,100,3172,5,151,0,COMPLETED_WALLTIME_REACHED,30594,151,30745,27422,27573,182.60264900662253,3 4 5 6 7,-1
679,w0,100,3187,5,149,0,COMPLETED_WALLTIME_REACHED,30711,149,30860,27524,27673,185.7248322147651,8 11 13 14 15,-1
677,w0,100,3179,6,148,0,COMPLETED_WALLTIME_REACHED,30712,148,30860,27533,27681,187.03378378378378,0 1 2 9 10 12,-1
681,w0,100,3211,5,149,0,COMPLETED_WALLTIME_REACHED,30745,149,30894,27534,27683,185.79194630872485,3 4 5 6 7,-1
682,w0,100,3212,6,152,0,COMPLETED_WALLTIME_REACHED,30860,152,31012,27648,27800,182.89473684210526,0 1 2 8 9 10,-1
683,w0,100,3219,4,150,0,COMPLETED_WALLTIME_REACHED,30860,150,31010,27641,27791,185.27333333333334,11 12 13 14,-1
685,w0,100,3236,3,151,0,COMPLETED_WALLTIME_REACHED,30894,151,31045,27658,27809,184.16556291390728,3 4 5,-1
686,w0,100,3250,5,149,0,COMPLETED_WALLTIME_REACHED,31010,149,31159,27760,27909,187.30872483221478,6 7 11 12 13,-1
687,w0,100,3256,5,148,0,COMPLETED_WALLTIME_REACHED,31012,148,31160,27756,27904,188.54054054054055,0 1 2 8 9,-1
688,w0,100,3277,5,150,0,COMPLETED_WALLTIME_REACHED,31045,150,31195,27768,27918,186.12,3 4 5 10 14,-1
689,w0,100,3282,4,148,0,COMPLETED_WALLTIME_REACHED,31159,148,31307,27877,28025,189.3581081081081,6 7 11 12,-1
690,w0,100,3285,5,153,0,COMPLETED_WALLTIME_REACHED,31160,153,31313,27875,28028,183.18954248366012,0 1 2 8 9,-1
691,w0,100,3285,5,150,0,COMPLETED_WALLTIME_REACHED,31195,150,31345,27910,28060,187.06666666666666,3 4 5 10 13,-1
692,w0,100,3297,6,150,0,COMPLETED_WALLTIME_REACHED,31307,150,31457,28010,28160,187.73333333333332,6 7 11 12 14 15,-1
693,w0,100,3308,5,149,0,COMPLETED_WALLTIME_REACHED,31313,149,31462,28005,28154,188.95302013422818,0 1 2 8 9,-1
694,w0,100,3309,4,152,0,COMPLETED_WALLTIME_REACHED,31345,152,31497,28036,28188,185.44736842105263,3 4 5 10,-1
695,w0,100,3323,5,148,0,COMPLETED_WALLTIME_REACHED,31457,148,31605,28134,28282,191.09459459459458,6 7 11 12 13,-1
696,w0,100,3328,4,151,0,COMPLETED_WALLTIME_REACHED,31462,151,31613,28134,28285,187.31788079470198,0 1 2 8,-1
697,w0,100,3337,6,152,0,COMPLETED_WALLTIME_REACHED,31497,152,31649,28160,28312,186.26315789473685,3 4 5 9 10 14,-1
698,w0,100,3337,3,146,0,COMPLETED_WALLTIME_REACHED,31605,146,31751,28268,28414,194.6164383561644,6 7 11,-1
699,w0,100,3338,3,150,0,COMPLETED_WALLTIME_REACHED,31605,150,31755,28267,28417,189.44666666666666,12 13 15,-1
700,w0,100,3339,3,147,0,COMPLETED_WALLTIME_REACHED,31613,147,31760,28274,28421,193.34013605442178,0 1 2,-1
701,w0,100,3346,4,150,0,COMPLETED_WALLTIME_REACHED,31649,150,31799,28303,28453,189.68666666666667,3 4 5 8,-1
702,w0,100,3346,4,148,0,COMPLETED_WALLTIME_REACHED,31751,148,31899,28405,28553,192.92567567567568,6 7 9 10,-1
703,w0,100,3349,3,151,0,COMPLETED_WALLTIME_REACHED,31755,151,31906,28406,28557,189.11920529801324,11 12 13,-1
704,w0,100,3352,5,149,0,COMPLETED_WALLTIME_REACHED,31760,149,31909,28408,28557,191.65771812080536,0 1 2 14 15,-1
713,w0,100,3387,3,152,0,COMPLETED_WALLTIME_REACHED,31799,152,31951,28412,28564,187.92105263157896,3 4 5,-1
705,w0,100,3368,5,150,0,COMPLETED_WALLTIME_REACHED,31899,150,32049,28531,28681,191.20666666666668,6 7 8 9 10,-1
714,w0,100,3395,3,154,0,COMPLETED_WALLTIME_REACHED,31906,154,32060,28511,28665,186.13636363636363,11 12 13,-1
706,w0,100,3374,4,151,0,COMPLETED_WALLTIME_REACHED,31909,151,32060,28535,28686,189.97350993377484,0 1 2 14,-1
707,w0,100,3375,4,149,0,COMPLETED_WALLTIME_REACHED,31951,149,32100,28576,28725,192.78523489932886,3 4 5 15,-1
708,w0,100,3376,5,152,0,COMPLETED_WALLTIME_REACHED,32049,152,32201,28673,28825,189.63815789473685,6 7 8 9 10,-1
709,w0,100,3379,4,151,0,COMPLETED_WALLTIME_REACHED,32060,151,32211,28681,28832,190.94039735099338,0 1 2 11,-1
710,w0,100,3383,5,151,0,COMPLETED_WALLTIME_REACHED,32100,151,32251,28717,28868,191.17880794701986,3 4 5 12 13,-1
711,w0,100,3384,5,149,0,COMPLETED_WALLTIME_REACHED,32201,149,32350,28817,28966,194.40268456375838,6 7 8 9 10,-1
712,w0,100,3386,4,146,0,COMPLETED_WALLTIME_REACHED,32211,146,32357,28825,28971,198.43150684931507,0 1 2 11,-1
715,w0,100,3406,5,149,0,COMPLETED_WALLTIME_REACHED,32251,149,32400,28845,28994,194.59060402684563,3 4 5 12 13,-1
716,w0,100,3412,4,147,0,COMPLETED_WALLTIME_REACHED,32350,147,32497,28938,29085,197.85714285714286,6 7 8 9,-1
717,w0,100,3415,3,147,0,COMPLETED_WALLTIME_REACHED,32350,147,32497,28935,29082,197.83673469387756,10 14 15,-1
727,w0,100,3471,3,149,0,COMPLETED_WALLTIME_REACHED,32357,149,32506,28886,29035,194.86577181208054,0 1 2,-1
718,w0,100,3419,6,152,0,COMPLETED_WALLTIME_REACHED,32400,152,32552,28981,29133,191.66447368421052,3 4 5 11 12 13,-1
719,w0,100,3430,6,148,0,COMPLETED_WALLTIME_REACHED,32497,148,32645,29067,29215,197.39864864864865,6 7 8 9 10 14,-1
720,w0,100,3430,4,149,0,COMPLETED_WALLTIME_REACHED,32506,149,32655,29076,29225,196.14093959731542,0 1 2 15,-1
721,w0,100,3442,5,150,0,COMPLETED_WALLTIME_REACHED,32552,150,32702,29110,29260,195.06666666666666,3 4 5 11 12,-1
723,w0,100,3454,5,150,0,COMPLETED_WALLTIME_REACHED,32645,150,32795,29191,29341,195.60666666666665,6 7 8 9 10,-1
724,w0,100,3455,5,151,0,COMPLETED_WALLTIME_REACHED,32655,151,32806,29200,29351,194.3774834437086,0 1 2 13 14,-1
725,w0,100,3464,6,152,0,COMPLETED_WALLTIME_REACHED,32702,152,32854,29238,29390,193.35526315789474,3 4 5 11 12 15,-1
726,w0,100,3466,4,149,0,COMPLETED_WALLTIME_REACHED,32795,149,32944,29329,29478,197.83892617449663,6 7 8 9,-1
728,w0,100,3478,6,149,0,COMPLETED_WALLTIME_REACHED,32806,149,32955,29328,29477,197.83221476510067,0 1 2 10 13 14,-1
729,w0,100,3482,4,148,0,COMPLETED_WALLTIME_REACHED,32854,148,33002,29372,29520,199.45945945945945,3 4 5 11,-1
730,w0,100,3493,5,150,0,COMPLETED_WALLTIME_REACHED,32944,150,33094,29451,29601,197.34,6 7 8 9 12,-1
731,w0,100,3493,7,150,0,COMPLETED_WALLTIME_REACHED,32955,150,33105,29462,29612,197.41333333333333,0 1 2 10 13 14 15,-1
732,w0,100,3514,3,149,0,COMPLETED_WALLTIME_REACHED,33002,149,33151,29488,29637,198.90604026845637,3 4 5,-1
733,w0,100,3515,3,151,0,COMPLETED_WALLTIME_REACHED,33094,151,33245,29579,29730,196.88741721854305,6 7 8,-1
735,w0,100,3525,3,147,0,COMPLETED_WALLTIME_REACHED,33094,147,33241,29569,29716,202.14965986394557,9 11 12,-1
734,w0,100,3523,5,152,0,COMPLETED_WALLTIME_REACHED,33105,152,33257,29582,29734,195.6184210526316,0 1 2 10 13,-1
736,w0,100,3526,5,150,0,COMPLETED_WALLTIME_REACHED,33151,150,33301,29625,29775,198.5,3 4 5 14 15,-1
737,w0,100,3530,4,151,0,COMPLETED_WALLTIME_REACHED,33245,151,33396,29715,29866,197.78807947019868,6 7 8 9,-1
738,w0,100,3530,3,149,0,COMPLETED_WALLTIME_REACHED,33257,149,33406,29727,29876,200.51006711409397,0 1 2,-1
739,w0,100,3536,3,148,0,COMPLETED_WALLTIME_REACHED,33257,148,33405,29721,29869,201.81756756756758,10 11 12,-1
740,w0,100,3536,4,149,0,COMPLETED_WALLTIME_REACHED,33301,149,33450,29765,29914,200.76510067114094,3 4 5 13,-1
741,w0,100,3540,5,150,0,COMPLETED_WALLTIME_REACHED,33396,150,33546,29856,30006,200.04,6 7 8 9 14,-1
742,w0,100,3542,4,151,0,COMPLETED_WALLTIME_REACHED,33405,151,33556,29863,30014,198.7682119205298,10 11 12 15,-1
743,w0,100,3542,6,148,0,COMPLETED_WALLTIME_REACHED,33450,148,33598,29908,30056,203.0810810810811,0 1 2 3 4 5,-1
744,w0,100,3552,4,152,0,COMPLETED_WALLTIME_REACHED,33546,152,33698,29994,30146,198.32894736842104,6 7 8 9,-1
745,w0,100,3555,6,149,0,COMPLETED_WALLTIME_REACHED,33556,149,33705,30001,30150,202.3489932885906,10 11 12 13 14 15,-1
746,w0,100,3580,4,152,0,COMPLETED_WALLTIME_REACHED,33598,152,33750,30018,30170,198.48684210526315,0 1 2 3,-1
747,w0,100,3580,5,151,0,COMPLETED_WALLTIME_REACHED,33698,151,33849,30118,30269,200.4569536423841,4 5 6 7 8,-1
748,w0,100,3582,4,150,0,COMPLETED_WALLTIME_REACHED,33705,150,33855,30123,30273,201.82,9 10 11 12,-1
773,w0,100,3710,3,149,0,COMPLETED_WALLTIME_REACHED,33705,149,33854,29995,30144,202.30872483221478,13 14 15,-1
749,w0,100,3585,4,151,0,COMPLETED_WALLTIME_REACHED,33750,151,33901,30165,30316,200.7682119205298,0 1 2 3,-1
750,w0,100,3600,5,147,0,COMPLETED_WALLTIME_REACHED,33849,147,33996,30249,30396,206.77551020408163,4 5 6 7 8,-1
751,w0,100,3605,5,150,0,COMPLETED_WALLTIME_REACHED,33855,150,34005,30250,30400,202.66666666666666,9 10 11 12 13,-1
752,w0,100,3622,4,155,0,COMPLETED_WALLTIME_REACHED,33901,155,34056,30279,30434,196.3483870967742,0 1 2 3,-1
753,w0,100,3624,5,149,0,COMPLETED_WALLTIME_REACHED,33996,149,34145,30372,30521,204.83892617449663,4 5 6 7 8,-1
754,w0,100,3627,5,148,0,COMPLETED_WALLTIME_REACHED,34005,148,34153,30378,30526,206.25675675675674,9 10 11 12 13,-1
755,w0,100,3638,4,149,0,COMPLETED_WALLTIME_REACHED,34056,149,34205,30418,30567,205.1476510067114,0 1 2 3,-1
756,w0,100,3638,6,150,0,COMPLETED_WALLTIME_REACHED,34145,150,34295,30507,30657,204.38,4 5 6 7 8 14,-1
757,w0,100,3644,4,152,0,COMPLETED_WALLTIME_REACHED,34153,152,34305,30509,30661,201.7171052631579,9 10 11 12,-1
758,w0,100,3645,4,151,0,COMPLETED_WALLTIME_REACHED,34205,151,34356,30560,30711,203.3841059602649,0 1 2 3,-1
759,w0,100,3646,4,149,0,COMPLETED_WALLTIME_REACHED,34295,149,34444,30649,30798,206.6979865771812,4 5 6 7,-1
781,w0,100,3760,3,150,0,COMPLETED_WALLTIME_REACHED,34295,150,34445,30535,30685,204.56666666666666,8 13 14,-1
760,w0,100,3651,5,147,0,COMPLETED_WALLTIME_REACHED,34305,147,34452,30654,30801,209.53061224489795,9 10 11 12 15,-1
761,w0,100,3656,6,153,0,COMPLETED_WALLTIME_REACHED,34444,153,34597,30788,30941,202.22875816993465,0 1 2 3 4 5,-1
762,w0,100,3659,4,152,0,COMPLETED_WALLTIME_REACHED,34445,152,34597,30786,30938,203.53947368421052,6 7 8 13,-1
763,w0,100,3660,4,150,0,COMPLETED_WALLTIME_REACHED,34452,150,34602,30792,30942,206.28,9 10 11 12,-1
764,w0,100,3662,4,150,0,COMPLETED_WALLTIME_REACHED,34597,150,34747,30935,31085,207.23333333333332,0 1 2 3,-1
765,w0,100,3664,5,151,0,COMPLETED_WALLTIME_REACHED,34597,151,34748,30933,31084,205.8543046357616,4 5 6 7 8,-1
782,w0,100,3762,3,155,0,COMPLETED_WALLTIME_REACHED,34597,155,34752,30835,30990,199.93548387096774,13 14 15,-1
766,w0,100,3665,4,148,0,COMPLETED_WALLTIME_REACHED,34602,148,34750,30937,31085,210.03378378378378,9 10 11 12,-1
767,w0,100,3669,4,149,0,COMPLETED_WALLTIME_REACHED,34747,149,34896,31078,31227,209.5771812080537,0 1 2 3,-1
768,w0,100,3679,4,148,0,COMPLETED_WALLTIME_REACHED,34748,148,34896,31069,31217,210.92567567567568,4 5 6 7,-1
769,w0,100,3683,4,149,0,COMPLETED_WALLTIME_REACHED,34750,149,34899,31067,31216,209.50335570469798,8 9 10 11,-1
770,w0,100,3702,4,154,0,COMPLETED_WALLTIME_REACHED,34752,154,34906,31050,31204,202.62337662337663,12 13 14 15,-1
771,w0,100,3704,5,150,0,COMPLETED_WALLTIME_REACHED,34896,150,35046,31192,31342,208.94666666666666,0 1 2 3 4,-1
794,w0,100,3860,3,150,0,COMPLETED_WALLTIME_REACHED,34896,150,35046,31036,31186,207.90666666666667,5 6 7,-1
772,w0,100,3709,4,154,0,COMPLETED_WALLTIME_REACHED,34899,154,35053,31190,31344,203.53246753246754,8 9 10 11,-1
775,w0,100,3725,4,150,0,COMPLETED_WALLTIME_REACHED,34906,150,35056,31181,31331,208.87333333333333,12 13 14 15,-1
774,w0,100,3713,5,147,0,COMPLETED_WALLTIME_REACHED,35046,147,35193,31333,31480,214.14965986394557,0 1 2 3 4,-1
776,w0,100,3728,5,154,0,COMPLETED_WALLTIME_REACHED,35053,154,35207,31325,31479,204.4090909090909,5 6 7 8 9,-1
778,w0,100,3747,5,149,0,COMPLETED_WALLTIME_REACHED,35056,149,35205,31309,31458,211.1275167785235,10 11 12 13 14,-1
779,w0,100,3757,4,151,0,COMPLETED_WALLTIME_REACHED,35193,151,35344,31436,31587,209.18543046357615,0 1 2 3,-1
780,w0,100,3759,5,152,0,COMPLETED_WALLTIME_REACHED,35205,152,35357,31446,31598,207.8815789473684,4 10 11 12 13,-1
783,w0,100,3762,5,152,0,COMPLETED_WALLTIME_REACHED,35207,152,35359,31445,31597,207.875,5 6 7 8 9,-1
784,w0,100,3802,5,148,0,COMPLETED_WALLTIME_REACHED,35344,148,35492,31542,31690,214.1216216216216,0 1 2 3 14,-1
786,w0,100,3803,5,148,0,COMPLETED_WALLTIME_REACHED,35357,148,35505,31554,31702,214.2027027027027,4 10 11 12 13,-1
787,w0,100,3816,6,149,0,COMPLETED_WALLTIME_REACHED,35359,149,35508,31543,31692,212.6979865771812,5 6 7 8 9 15,-1
788,w0,100,3824,4,149,0,COMPLETED_WALLTIME_REACHED,35492,149,35641,31668,31817,213.53691275167785,0 1 2 3,-1
789,w0,100,3842,6,152,0,COMPLETED_WALLTIME_REACHED,35505,152,35657,31663,31815,209.30921052631578,4 10 11 12 13 14,-1
790,w0,100,3850,4,150,0,COMPLETED_WALLTIME_REACHED,35508,150,35658,31658,31808,212.05333333333334,5 6 7 8,-1
791,w0,100,3850,5,144,0,COMPLETED_WALLTIME_REACHED,35641,144,35785,31791,31935,221.77083333333334,0 1 2 3 9,-1
792,w0,100,3850,4,152,0,COMPLETED_WALLTIME_REACHED,35657,152,35809,31807,31959,210.2565789473684,4 10 11 12,-1
805,w0,100,3906,3,149,0,COMPLETED_WALLTIME_REACHED,35657,149,35806,31751,31900,214.09395973154363,13 14 15,-1
793,w0,100,3859,4,150,0,COMPLETED_WALLTIME_REACHED,35658,150,35808,31799,31949,212.99333333333334,5 6 7 8,-1
795,w0,100,3869,5,148,0,COMPLETED_WALLTIME_REACHED,35785,148,35933,31916,32064,216.64864864864865,0 1 2 3 9,-1
806,w0,100,3908,3,150,0,COMPLETED_WALLTIME_REACHED,35806,150,35956,31898,32048,213.65333333333334,13 14 15,-1
796,w0,100,3869,4,149,0,COMPLETED_WALLTIME_REACHED,35808,149,35957,31939,32088,215.35570469798657,5 6 7 8,-1
813,w0,100,3936,3,150,0,COMPLETED_WALLTIME_REACHED,35809,150,35959,31873,32023,213.48666666666668,4 10 11,-1
797,w0,100,3873,5,148,0,COMPLETED_WALLTIME_REACHED,35933,148,36081,32060,32208,217.6216216216216,0 1 2 3 9,-1
819,w0,100,3952,3,145,0,COMPLETED_WALLTIME_REACHED,35956,145,36101,32004,32149,221.71724137931034,12 13 14,-1
798,w0,100,3877,5,151,0,COMPLETED_WALLTIME_REACHED,35957,151,36108,32080,32231,213.4503311258278,5 6 7 8 15,-1
823,w0,100,3963,3,151,0,COMPLETED_WALLTIME_REACHED,35959,151,36110,31996,32147,212.89403973509934,4 10 11,-1
799,w0,100,3878,5,153,0,COMPLETED_WALLTIME_REACHED,36081,153,36234,32203,32356,211.47712418300654,0 1 2 3 9,-1
826,w0,100,3972,3,147,0,COMPLETED_WALLTIME_REACHED,36101,147,36248,32129,32276,219.56462585034015,12 13 14,-1
800,w0,100,3883,5,148,0,COMPLETED_WALLTIME_REACHED,36108,148,36256,32225,32373,218.73648648648648,5 6 7 8 15,-1
831,w0,100,4009,3,149,0,COMPLETED_WALLTIME_REACHED,36110,149,36259,32101,32250,216.44295302013424,4 10 11,-1
801,w0,100,3884,5,153,0,COMPLETED_WALLTIME_REACHED,36234,153,36387,32350,32503,212.43790849673204,0 1 2 3 9,-1
832,w0,100,4011,3,152,0,COMPLETED_WALLTIME_REACHED,36248,152,36400,32237,32389,213.08552631578948,12 13 14,-1
802,w0,100,3898,5,151,0,COMPLETED_WALLTIME_REACHED,36256,151,36407,32358,32509,215.2913907284768,5 6 7 8 15,-1
803,w0,100,3904,7,153,0,COMPLETED_WALLTIME_REACHED,36387,153,36540,32483,32636,213.30718954248366,0 1 2 3 4 9 10,-1
804,w0,100,3905,7,149,0,COMPLETED_WALLTIME_REACHED,36407,149,36556,32502,32651,219.13422818791946,5 6 7 8 11 12 13,-1
807,w0,100,3912,5,150,0,COMPLETED_WALLTIME_REACHED,36540,150,36690,32628,32778,218.52,0 1 2 3 4,-1
818,w0,100,3949,4,152,0,COMPLETED_WALLTIME_REACHED,36540,152,36692,32591,32743,215.41447368421052,9 10 14 15,-1
808,w0,100,3917,5,152,0,COMPLETED_WALLTIME_REACHED,36556,152,36708,32639,32791,215.73026315789474,5 6 7 8 11,-1
809,w0,100,3919,5,150,0,COMPLETED_WALLTIME_REACHED,36690,150,36840,32771,32921,219.47333333333333,0 1 2 3 4,-1
810,w0,100,3919,5,154,0,COMPLETED_WALLTIME_REACHED,36692,154,36846,32773,32927,213.8116883116883,9 10 12 13 14,-1
812,w0,100,3931,5,152,0,COMPLETED_WALLTIME_REACHED,36708,152,36860,32777,32929,216.63815789473685,5 6 7 8 11,-1
814,w0,100,3943,5,148,0,COMPLETED_WALLTIME_REACHED,36840,148,36988,32897,33045,223.27702702702703,0 1 2 3 4,-1
815,w0,100,3944,5,147,0,COMPLETED_WALLTIME_REACHED,36846,147,36993,32902,33049,224.8231292517007,9 10 12 13 14,-1
816,w0,100,3945,5,148,0,COMPLETED_WALLTIME_REACHED,36860,148,37008,32915,33063,223.39864864864865,5 6 7 8 11,-1
817,w0,100,3945,6,153,0,COMPLETED_WALLTIME_REACHED,36988,153,37141,33043,33196,216.96732026143792,0 1 2 3 4 15,-1
820,w0,100,3956,4,151,0,COMPLETED_WALLTIME_REACHED,36993,151,37144,33037,33188,219.78807947019868,9 10 12 13,-1
821,w0,100,3956,5,151,0,COMPLETED_WALLTIME_REACHED,37008,151,37159,33052,33203,219.88741721854305,5 6 7 8 11,-1
822,w0,100,3962,4,149,0,COMPLETED_WALLTIME_REACHED,37141,149,37290,33179,33328,223.6778523489933,0 1 2 3,-1
841,w0,100,4044,3,149,0,COMPLETED_WALLTIME_REACHED,37141,149,37290,33097,33246,223.1275167785235,4 14 15,-1
824,w0,100,3968,4,151,0,COMPLETED_WALLTIME_REACHED,37144,151,37295,33176,33327,220.7086092715232,9 10 12 13,-1
825,w0,100,3972,4,150,0,COMPLETED_WALLTIME_REACHED,37159,150,37309,33187,33337,222.24666666666667,5 6 7 8,-1
827,w0,100,3975,4,149,0,COMPLETED_WALLTIME_REACHED,37290,149,37439,33315,33464,224.59060402684563,0 1 2 3,-1
828,w0,100,3984,6,149,0,COMPLETED_WALLTIME_REACHED,37295,149,37444,33311,33460,224.56375838926175,4 9 10 11 12 13,-1
829,w0,100,3996,5,146,0,COMPLETED_WALLTIME_REACHED,37309,146,37455,33313,33459,229.17123287671234,5 6 7 8 14,-1
830,w0,100,4007,5,153,0,COMPLETED_WALLTIME_REACHED,37439,153,37592,33432,33585,219.50980392156862,0 1 2 3 15,-1
833,w0,100,4013,5,154,0,COMPLETED_WALLTIME_REACHED,37444,154,37598,33431,33585,218.08441558441558,4 9 10 11 12,-1
834,w0,100,4015,4,150,0,COMPLETED_WALLTIME_REACHED,37455,150,37605,33440,33590,223.93333333333334,5 6 7 8,-1
835,w0,100,4023,4,150,0,COMPLETED_WALLTIME_REACHED,37592,150,37742,33569,33719,224.79333333333332,0 1 2 3,-1
836,w0,100,4030,6,148,0,COMPLETED_WALLTIME_REACHED,37598,148,37746,33568,33716,227.8108108108108,4 9 10 11 12 13,-1
837,w0,100,4030,6,155,0,COMPLETED_WALLTIME_REACHED,37605,155,37760,33575,33730,217.61290322580646,5 6 7 8 14 15,-1
839,w0,100,4038,4,152,0,COMPLETED_WALLTIME_REACHED,37742,152,37894,33704,33856,222.73684210526315,0 1 2 3,-1
838,w0,100,4036,6,149,0,COMPLETED_WALLTIME_REACHED,37746,149,37895,33710,33859,227.24161073825502,4 9 10 11 12 13,-1
840,w0,100,4038,4,152,0,COMPLETED_WALLTIME_REACHED,37760,152,37912,33722,33874,222.85526315789474,5 6 7 8,-1
842,w0,100,4046,5,152,0,COMPLETED_WALLTIME_REACHED,37894,152,38046,33848,34000,223.68421052631578,0 1 2 3 14,-1
843,w0,100,4047,3,149,0,COMPLETED_WALLTIME_REACHED,37895,149,38044,33848,33997,228.16778523489933,4 9 10,-1
844,w0,100,4050,4,147,0,COMPLETED_WALLTIME_REACHED,37895,147,38042,33845,33992,231.23809523809524,11 12 13 15,-1
845,w0,100,4051,6,149,0,COMPLETED_WALLTIME_REACHED,38042,149,38191,33991,34140,229.1275167785235,5 6 7 8 11 12,-1
846,w0,100,4056,5,151,0,COMPLETED_WALLTIME_REACHED,38044,151,38195,33988,34139,226.08609271523179,4 9 10 13 15,-1
847,w0,100,4064,5,154,0,COMPLETED_WALLTIME_REACHED,38046,154,38200,33982,34136,221.66233766233765,0 1 2 3 14,-1
848,w0,100,4066,4,149,0,COMPLETED_WALLTIME_REACHED,38191,149,38340,34125,34274,230.0268456375839,5 6 7 8,-1
849,w0,100,4067,5,147,0,COMPLETED_WALLTIME_REACHED,38195,147,38342,34128,34275,233.16326530612244,4 9 10 11 12,-1
850,w0,100,4069,5,149,0,COMPLETED_WALLTIME_REACHED,38200,149,38349,34131,34280,230.06711409395973,0 1 2 3 13,-1
851,w0,100,4070,6,152,0,COMPLETED_WALLTIME_REACHED,38340,152,38492,34270,34422,226.46052631578948,5 6 7 8 14 15,-1
852,w0,100,4078,3,151,0,COMPLETED_WALLTIME_REACHED,38342,151,38493,34264,34415,227.91390728476821,4 9 10,-1
853,w0,100,4078,4,149,0,COMPLETED_WALLTIME_REACHED,38349,149,38498,34271,34420,231.00671140939596,0 1 2 3,-1
856,w0,100,4099,3,154,0,COMPLETED_WALLTIME_REACHED,38349,154,38503,34250,34404,223.4025974025974,11 12 13,-1
854,w0,100,4082,4,149,0,COMPLETED_WALLTIME_REACHED,38492,149,38641,34410,34559,231.93959731543623,5 6 7 8,-1
855,w0,100,4083,5,152,0,COMPLETED_WALLTIME_REACHED,38493,152,38645,34410,34562,227.3815789473684,4 9 10 14 15,-1
857,w0,100,4108,3,152,0,COMPLETED_WALLTIME_REACHED,38498,152,38650,34390,34542,227.25,0 1 2,-1
861,w0,100,4128,3,147,0,COMPLETED_WALLTIME_REACHED,38503,147,38650,34375,34522,234.843537414966,3 11 12,-1
858,w0,100,4112,5,150,0,COMPLETED_WALLTIME_REACHED,38641,150,38791,34529,34679,231.19333333333333,5 6 7 8 13,-1
859,w0,100,4113,5,152,0,COMPLETED_WALLTIME_REACHED,38645,152,38797,34532,34684,228.18421052631578,4 9 10 14 15,-1
860,w0,100,4127,4,153,0,COMPLETED_WALLTIME_REACHED,38650,153,38803,34523,34676,226.640522875817,0 1 2 3,-1
862,w0,100,4132,3,150,0,COMPLETED_WALLTIME_REACHED,38791,150,38941,34659,34809,232.06,5 6 7,-1
863,w0,100,4145,4,150,0,COMPLETED_WALLTIME_REACHED,38791,150,38941,34646,34796,231.97333333333333,8 11 12 13,-1
864,w0,100,4149,5,154,0,COMPLETED_WALLTIME_REACHED,38797,154,38951,34648,34802,225.98701298701297,4 9 10 14 15,-1
866,w0,100,4156,4,150,0,COMPLETED_WALLTIME_REACHED,38803,150,38953,34647,34797,231.98,0 1 2 3,-1
865,w0,100,4150,6,149,0,COMPLETED_WALLTIME_REACHED,38941,149,39090,34791,34940,234.49664429530202,5 6 7 8 11 12,-1
867,w0,100,4160,4,146,0,COMPLETED_WALLTIME_REACHED,38951,146,39097,34791,34937,239.2945205479452,4 9 10 13,-1
868,w0,100,4161,5,149,0,COMPLETED_WALLTIME_REACHED,38953,149,39102,34792,34941,234.50335570469798,0 1 2 3 14,-1
869,w0,100,4161,4,149,0,COMPLETED_WALLTIME_REACHED,39090,149,39239,34929,35078,235.4228187919463,5 6 7 8,-1
882,w0,100,4238,3,148,0,COMPLETED_WALLTIME_REACHED,39090,148,39238,34852,35000,236.48648648648648,11 12 15,-1
870,w0,100,4168,4,153,0,COMPLETED_WALLTIME_REACHED,39097,153,39250,34929,35082,229.2941176470588,4 9 10 13,-1
871,w0,100,4180,5,152,0,COMPLETED_WALLTIME_REACHED,39102,152,39254,34922,35074,230.75,0 1 2 3 14,-1
872,w0,100,4191,6,148,0,COMPLETED_WALLTIME_REACHED,39239,148,39387,35048,35196,237.8108108108108,5 6 7 8 11 12,-1
874,w0,100,4197,4,148,0,COMPLETED_WALLTIME_REACHED,39250,148,39398,35053,35201,237.84459459459458,4 9 10 13,-1
873,w0,100,4196,6,146,0,COMPLETED_WALLTIME_REACHED,39254,146,39400,35058,35204,241.12328767123287,0 1 2 3 14 15,-1
875,w0,100,4204,4,152,0,COMPLETED_WALLTIME_REACHED,39387,152,39539,35183,35335,232.4671052631579,5 6 7 8,-1
876,w0,100,4208,4,152,0,COMPLETED_WALLTIME_REACHED,39398,152,39550,35190,35342,232.51315789473685,4 9 10 11,-1
877,w0,100,4215,4,151,0,COMPLETED_WALLTIME_REACHED,39400,151,39551,35185,35336,234.01324503311258,0 1 2 3,-1
878,w0,100,4222,4,148,0,COMPLETED_WALLTIME_REACHED,39400,148,39548,35178,35326,238.6891891891892,12 13 14 15,-1
879,w0,100,4225,4,150,0,COMPLETED_WALLTIME_REACHED,39539,150,39689,35314,35464,236.42666666666668,5 6 7 8,-1
889,w0,100,4266,3,151,0,COMPLETED_WALLTIME_REACHED,39548,151,39699,35282,35433,234.65562913907286,12 13 14,-1
880,w0,100,4236,5,151,0,COMPLETED_WALLTIME_REACHED,39550,151,39701,35314,35465,234.86754966887418,4 9 10 11 15,-1
881,w0,100,4237,4,150,0,COMPLETED_WALLTIME_REACHED,39551,150,39701,35314,35464,236.42666666666668,0 1 2 3,-1
883,w0,100,4239,5,147,0,COMPLETED_WALLTIME_REACHED,39699,147,39846,35460,35607,242.22448979591837,5 6 7 8 12,-1
884,w0,100,4248,5,151,0,COMPLETED_WALLTIME_REACHED,39701,151,39852,35453,35604,235.78807947019868,0 1 2 3 4,-1
885,w0,100,4248,4,148,0,COMPLETED_WALLTIME_REACHED,39701,148,39849,35453,35601,240.5472972972973,9 10 11 13,-1
886,w0,100,4250,6,151,0,COMPLETED_WALLTIME_REACHED,39846,151,39997,35596,35747,236.73509933774835,5 6 7 8 12 14,-1
887,w0,100,4251,4,153,0,COMPLETED_WALLTIME_REACHED,39849,153,40002,35598,35751,233.66666666666666,9 10 11 13,-1
888,w0,100,4256,5,151,0,COMPLETED_WALLTIME_REACHED,39852,151,40003,35596,35747,236.73509933774835,0 1 2 3 4,-1
890,w0,100,4266,5,152,0,COMPLETED_WALLTIME_REACHED,39997,152,40149,35731,35883,236.07236842105263,5 6 7 8 12,-1
891,w0,100,4272,5,152,0,COMPLETED_WALLTIME_REACHED,40002,152,40154,35730,35882,236.06578947368422,9 10 11 13 14,-1
892,w0,100,4302,5,152,0,COMPLETED_WALLTIME_REACHED,40003,152,40155,35701,35853,235.875,0 1 2 3 4,-1
893,w0,100,4311,4,150,0,COMPLETED_WALLTIME_REACHED,40149,150,40299,35838,35988,239.92,5 6 7 8,-1
894,w0,100,4315,5,151,0,COMPLETED_WALLTIME_REACHED,40154,151,40305,35839,35990,238.34437086092714,9 10 11 12 13,-1
896,w0,100,4318,3,154,0,COMPLETED_WALLTIME_REACHED,40155,154,40309,35837,35991,233.7077922077922,0 1 2,-1
897,w0,100,4322,3,146,0,COMPLETED_WALLTIME_REACHED,40155,146,40301,35833,35979,246.43150684931507,3 4 14,-1
898,w0,100,4333,3,148,0,COMPLETED_WALLTIME_REACHED,40299,148,40447,35966,36114,244.01351351351352,5 6 7,-1
899,w0,100,4333,5,149,0,COMPLETED_WALLTIME_REACHED,40301,149,40450,35968,36117,242.39597315436242,3 4 8 14 15,-1
900,w0,100,4335,5,150,0,COMPLETED_WALLTIME_REACHED,40305,150,40455,35970,36120,240.8,9 10 11 12 13,-1
901,w0,100,4335,5,151,0,COMPLETED_WALLTIME_REACHED,40447,151,40598,36112,36263,240.1523178807947,0 1 2 5 6,-1
902,w0,100,4338,4,144,0,COMPLETED_WALLTIME_REACHED,40450,144,40594,36112,36256,251.77777777777777,3 4 7 8,-1
903,w0,100,4341,5,153,0,COMPLETED_WALLTIME_REACHED,40455,153,40608,36114,36267,237.0392156862745,9 10 11 12 13,-1
904,w0,100,4347,6,151,0,COMPLETED_WALLTIME_REACHED,40594,151,40745,36247,36398,241.04635761589404,3 4 7 8 14 15,-1
905,w0,100,4352,5,149,0,COMPLETED_WALLTIME_REACHED,40598,149,40747,36246,36395,244.26174496644296,0 1 2 5 6,-1
906,w0,100,4353,5,150,0,COMPLETED_WALLTIME_REACHED,40608,150,40758,36255,36405,242.7,9 10 11 12 13,-1
907,w0,100,4356,5,150,0,COMPLETED_WALLTIME_REACHED,40745,150,40895,36389,36539,243.59333333333333,3 4 7 8 14,-1
908,w0,100,4358,5,150,0,COMPLETED_WALLTIME_REACHED,40747,150,40897,36389,36539,243.59333333333333,0 1 2 5 6,-1
909,w0,100,4365,3,147,0,COMPLETED_WALLTIME_REACHED,40758,147,40905,36393,36540,248.57142857142858,9 10 11,-1
910,w0,100,4366,3,150,0,COMPLETED_WALLTIME_REACHED,40758,150,40908,36392,36542,243.61333333333334,12 13 15,-1
911,w0,100,4368,4,152,0,COMPLETED_WALLTIME_REACHED,40895,152,41047,36527,36679,241.30921052631578,3 4 7 8,-1
912,w0,100,4371,6,152,0,COMPLETED_WALLTIME_REACHED,40897,152,41049,36526,36678,241.30263157894737,0 1 2 5 6 14,-1
913,w0,100,4379,4,154,0,COMPLETED_WALLTIME_REACHED,40908,154,41062,36529,36683,238.2012987012987,9 10 11 12,-1
914,w0,100,4382,6,150,0,COMPLETED_WALLTIME_REACHED,41047,150,41197,36665,36815,245.43333333333334,3 4 7 8 13 15,-1
915,w0,100,4389,5,154,0,COMPLETED_WALLTIME_REACHED,41049,154,41203,36660,36814,239.05194805194805,0 1 2 5 6,-1
916,w0,100,4392,3,152,0,COMPLETED_WALLTIME_REACHED,41062,152,41214,36670,36822,242.25,9 10 11,-1
917,w0,100,4396,5,150,0,COMPLETED_WALLTIME_REACHED,41197,150,41347,36801,36951,246.34,3 4 7 8 12,-1
919,w0,100,4402,3,152,0,COMPLETED_WALLTIME_REACHED,41197,152,41349,36795,36947,243.07236842105263,13 14 15,-1
918,w0,100,4397,4,151,0,COMPLETED_WALLTIME_REACHED,41203,151,41354,36806,36957,244.74834437086093,0 1 2 5,-1
920,w0,100,4402,7,150,0,COMPLETED_WALLTIME_REACHED,41347,150,41497,36945,37095,247.3,3 4 6 7 8 9 10,-1
921,w0,100,4402,4,149,0,COMPLETED_WALLTIME_REACHED,41349,149,41498,36947,37096,248.96644295302013,11 12 13 14,-1
922,w0,100,4404,3,149,0,COMPLETED_WALLTIME_REACHED,41354,149,41503,36950,37099,248.98657718120805,0 1 2,-1
923,w0,100,4408,5,151,0,COMPLETED_WALLTIME_REACHED,41497,151,41648,37089,37240,246.6225165562914,3 4 5 6 7,-1
924,w0,100,4416,3,151,0,COMPLETED_WALLTIME_REACHED,41497,151,41648,37081,37232,246.56953642384107,8 9 10,-1
925,w0,100,4419,4,153,0,COMPLETED_WALLTIME_REACHED,41498,153,41651,37079,37232,243.34640522875816,11 12 13 14,-1
926,w0,100,4424,4,149,0,COMPLETED_WALLTIME_REACHED,41503,149,41652,37079,37228,249.8523489932886,0 1 2 15,-1
927,w0,100,4428,4,151,0,COMPLETED_WALLTIME_REACHED,41648,151,41799,37220,37371,247.49006622516555,3 4 5 6,-1
940,w0,100,4528,3,151,0,COMPLETED_WALLTIME_REACHED,41648,151,41799,37120,37271,246.82781456953643,7 8 9,-1
928,w0,100,4431,5,152,0,COMPLETED_WALLTIME_REACHED,41651,152,41803,37220,37372,245.8684210526316,10 11 12 13 14,-1
930,w0,100,4443,4,150,0,COMPLETED_WALLTIME_REACHED,41652,150,41802,37209,37359,249.06,0 1 2 15,-1
929,w0,100,4433,5,151,0,COMPLETED_WALLTIME_REACHED,41799,151,41950,37366,37517,248.4569536423841,3 4 5 6 7,-1
931,w0,100,4458,5,148,0,COMPLETED_WALLTIME_REACHED,41802,148,41950,37344,37492,253.32432432432432,0 1 2 8 9,-1
932,w0,100,4472,5,151,0,COMPLETED_WALLTIME_REACHED,41803,151,41954,37331,37482,248.2251655629139,10 11 12 13 14,-1
933,w0,100,4474,5,150,0,COMPLETED_WALLTIME_REACHED,41950,150,42100,37476,37626,250.84,0 1 2 3 4,-1
935,w0,100,4490,5,151,0,COMPLETED_WALLTIME_REACHED,41950,151,42101,37460,37611,249.0794701986755,5 6 7 8 9,-1
936,w0,100,4500,5,148,0,COMPLETED_WALLTIME_REACHED,41954,148,42102,37454,37602,254.06756756756758,10 11 12 13 14,-1
937,w0,100,4509,6,150,0,COMPLETED_WALLTIME_REACHED,42100,150,42250,37591,37741,251.60666666666665,0 1 2 3 4 15,-1
938,w0,100,4513,5,151,0,COMPLETED_WALLTIME_REACHED,42101,151,42252,37588,37739,249.9271523178808,5 6 7 8 9,-1
939,w0,100,4523,4,150,0,COMPLETED_WALLTIME_REACHED,42102,150,42252,37579,37729,251.52666666666667,10 11 12 13,-1
941,w0,100,4533,7,149,0,COMPLETED_WALLTIME_REACHED,42250,149,42399,37717,37866,254.13422818791946,0 1 2 3 4 14 15,-1
942,w0,100,4539,5,149,0,COMPLETED_WALLTIME_REACHED,42252,149,42401,37713,37862,254.10738255033556,5 6 7 8 9,-1
945,w0,100,4570,4,149,0,COMPLETED_WALLTIME_REACHED,42252,149,42401,37682,37831,253.8993288590604,10 11 12 13,-1
943,w0,100,4552,6,148,0,COMPLETED_WALLTIME_REACHED,42399,148,42547,37847,37995,256.72297297297297,0 1 2 3 4 14,-1
944,w0,100,4562,5,149,0,COMPLETED_WALLTIME_REACHED,42401,149,42550,37839,37988,254.95302013422818,5 6 7 8 9,-1
947,w0,100,4592,3,149,0,COMPLETED_WALLTIME_REACHED,42401,149,42550,37809,37958,254.751677852349,10 11 12,-1
946,w0,100,4573,6,151,0,COMPLETED_WALLTIME_REACHED,42547,151,42698,37974,38125,252.48344370860926,0 1 2 3 4 13,-1
948,w0,100,4599,5,153,0,COMPLETED_WALLTIME_REACHED,42550,153,42703,37951,38104,249.04575163398692,5 6 7 8 9,-1
949,w0,100,4610,5,149,0,COMPLETED_WALLTIME_REACHED,42550,149,42699,37940,38089,255.63087248322148,10 11 12 14 15,-1
950,w0,100,4618,3,155,0,COMPLETED_WALLTIME_REACHED,42698,155,42853,38080,38235,246.67741935483872,0 1 2,-1
951,w0,100,4623,6,147,0,COMPLETED_WALLTIME_REACHED,42699,147,42846,38076,38223,260.0204081632653,3 4 10 11 12 13,-1
952,w0,100,4633,5,154,0,COMPLETED_WALLTIME_REACHED,42703,154,42857,38070,38224,248.2077922077922,5 6 7 8 9,-1
953,w0,100,4634,4,150,0,COMPLETED_WALLTIME_REACHED,42846,150,42996,38212,38362,255.74666666666667,3 4 10 11,-1
954,w0,100,4636,5,150,0,COMPLETED_WALLTIME_REACHED,42853,150,43003,38217,38367,255.78,0 1 2 12 13,-1
955,w0,100,4645,4,149,0,COMPLETED_WALLTIME_REACHED,42857,149,43006,38212,38361,257.4563758389262,5 6 7 8,-1
965,w0,100,4741,3,152,0,COMPLETED_WALLTIME_REACHED,42857,152,43009,38116,38268,251.76315789473685,9 14 15,-1
956,w0,100,4651,4,150,0,COMPLETED_WALLTIME_REACHED,42996,150,43146,38345,38495,256.6333333333333,3 4 10 11,-1
967,w0,100,4756,3,149,0,COMPLETED_WALLTIME_REACHED,43003,149,43152,38247,38396,257.69127516778525,0 1 2,-1
957,w0,100,4670,6,152,0,COMPLETED_WALLTIME_REACHED,43006,152,43158,38336,38488,253.21052631578948,5 6 7 8 12 13,-1
958,w0,100,4696,5,150,0,COMPLETED_WALLTIME_REACHED,43146,150,43296,38450,38600,257.3333333333333,3 4 9 10 11,-1
959,w0,100,4697,4,152,0,COMPLETED_WALLTIME_REACHED,43152,152,43304,38455,38607,253.9934210526316,0 1 2 14,-1
960,w0,100,4715,4,147,0,COMPLETED_WALLTIME_REACHED,43158,147,43305,38443,38590,262.5170068027211,5 6 7 8,-1
969,w0,100,4779,3,148,0,COMPLETED_WALLTIME_REACHED,43158,148,43306,38379,38527,260.31756756756755,12 13 15,-1
961,w0,100,4725,5,149,0,COMPLETED_WALLTIME_REACHED,43296,149,43445,38571,38720,259.86577181208054,3 4 9 10 11,-1
971,w0,100,4784,3,148,0,COMPLETED_WALLTIME_REACHED,43304,148,43452,38520,38668,261.27027027027026,0 1 2,-1
962,w0,100,4730,5,154,0,COMPLETED_WALLTIME_REACHED,43305,154,43459,38575,38729,251.48701298701297,5 6 7 8 14,-1
977,w0,100,4796,3,151,0,COMPLETED_WALLTIME_REACHED,43306,151,43457,38510,38661,256.0331125827815,12 13 15,-1
963,w0,100,4737,4,148,0,COMPLETED_WALLTIME_REACHED,43445,148,43593,38708,38856,262.5405405405405,3 4 9 10,-1
964,w0,100,4738,4,153,0,COMPLETED_WALLTIME_REACHED,43452,153,43605,38714,38867,254.03267973856208,0 1 2 11,-1
983,w0,100,4820,3,144,0,COMPLETED_WALLTIME_REACHED,43457,144,43601,38637,38781,269.3125,12 13 15,-1
966,w0,100,4749,5,150,0,COMPLETED_WALLTIME_REACHED,43459,150,43609,38710,38860,259.06666666666666,5 6 7 8 14,-1
968,w0,100,4769,5,146,0,COMPLETED_WALLTIME_REACHED,43601,146,43747,38832,38978,266.972602739726,3 4 9 10 12,-1
970,w0,100,4782,4,153,0,COMPLETED_WALLTIME_REACHED,43605,153,43758,38823,38976,254.7450980392157,0 1 2 11,-1
972,w0,100,4786,4,149,0,COMPLETED_WALLTIME_REACHED,43609,149,43758,38823,38972,261.5570469798658,5 6 7 8,-1
984,w0,100,4821,3,149,0,COMPLETED_WALLTIME_REACHED,43609,149,43758,38788,38937,261.32214765100673,13 14 15,-1
973,w0,100,4793,4,148,0,COMPLETED_WALLTIME_REACHED,43747,148,43895,38954,39102,264.2027027027027,3 4 9 10,-1
974,w0,100,4793,5,149,0,COMPLETED_WALLTIME_REACHED,43758,149,43907,38965,39114,262.51006711409394,0 1 2 5 6,-1
975,w0,100,4793,4,147,0,COMPLETED_WALLTIME_REACHED,43758,147,43905,38965,39112,266.06802721088434,7 8 11 12,-1
976,w0,100,4795,5,153,0,COMPLETED_WALLTIME_REACHED,43895,153,44048,39100,39253,256.55555555555554,3 4 9 10 13,-1
978,w0,100,4797,6,151,0,COMPLETED_WALLTIME_REACHED,43905,151,44056,39108,39259,259.9933774834437,7 8 11 12 14 15,-1
981,w0,100,4808,4,151,0,COMPLETED_WALLTIME_REACHED,43907,151,44058,39099,39250,259.9337748344371,0 1 2 5,-1
979,w0,100,4800,6,151,0,COMPLETED_WALLTIME_REACHED,44048,151,44199,39248,39399,260.9205298013245,3 4 6 9 10 13,-1
980,w0,100,4800,5,148,0,COMPLETED_WALLTIME_REACHED,44056,148,44204,39256,39404,266.2432432432432,7 8 11 12 14,-1
982,w0,100,4815,5,149,0,COMPLETED_WALLTIME_REACHED,44058,149,44207,39243,39392,264.3758389261745,0 1 2 5 15,-1
985,w0,100,4823,3,150,0,COMPLETED_WALLTIME_REACHED,44199,150,44349,39376,39526,263.50666666666666,3 4 6,-1
987,w0,100,4824,3,152,0,COMPLETED_WALLTIME_REACHED,44199,152,44351,39375,39527,260.04605263157896,9 10 13,-1
986,w0,100,4823,5,155,0,COMPLETED_WALLTIME_REACHED,44204,155,44359,39381,39536,255.07096774193548,7 8 11 12 14,-1
988,w0,100,4840,5,149,0,COMPLETED_WALLTIME_REACHED,44207,149,44356,39367,39516,265.20805369127515,0 1 2 5 15,-1
989,w0,100,4844,5,150,0,COMPLETED_WALLTIME_REACHED,44351,150,44501,39507,39657,264.38,3 4 6 9 10,-1
990,w0,100,4858,4,151,0,COMPLETED_WALLTIME_REACHED,44356,151,44507,39498,39649,262.57615894039736,0 1 2 5,-1
991,w0,100,4860,4,151,0,COMPLETED_WALLTIME_REACHED,44359,151,44510,39499,39650,262.5827814569536,7 8 11 12,-1
992,w0,100,4861,5,150,0,COMPLETED_WALLTIME_REACHED,44501,150,44651,39640,39790,265.26666666666665,3 4 6 9 10,-1
994,w0,100,4866,5,153,0,COMPLETED_WALLTIME_REACHED,44507,153,44660,39641,39794,260.09150326797385,0 1 2 5 13,-1
995,w0,100,4866,5,150,0,COMPLETED_WALLTIME_REACHED,44510,150,44660,39644,39794,265.29333333333335,7 8 11 12 14,-1
996,w0,100,4890,4,155,0,COMPLETED_WALLTIME_REACHED,44651,155,44806,39761,39916,257.52258064516127,3 4 6 9,-1
997,w0,100,4893,4,152,0,COMPLETED_WALLTIME_REACHED,44660,152,44812,39767,39919,262.625,0 1 2 5,-1
998,w0,100,4920,4,152,0,COMPLETED_WALLTIME_REACHED,44660,152,44812,39740,39892,262.44736842105266,7 8 10 11,-1
999,w0,100,4931,6,148,0,COMPLETED_WALLTIME_REACHED,44806,148,44954,39875,40023,270.4256756756757,3 4 6 9 12 13,-1
1000,w0,100,4932,5,150,0,COMPLETED_WALLTIME_REACHED,44812,150,44962,39880,40030,266.8666666666667,0 1 2 5 7,-1
