job_id,workload_name,profile,submission_time,requested_number_of_resources,requested_time,success,final_state,starting_time,execution_time,finish_time,waiting_time,turnaround_time,stretch,allocated_resources,consumed_energy
1,w0,100,13,6,150,0,COMPLETED_WALLTIME_REACHED,13,150,163,0,150,1.0,0 1 2 3 4 5,-1
2,w0,100,36,4,151,0,COMPLETED_WALLTIME_REACHED,36,151,187,0,151,1.0,6 7 8 9,-1
3,w0,100,42,6,152,0,COMPLETED_WALLTIME_REACHED,42,152,194,0,152,1.0,10 11 12 13 14 15,-1
4,w0,100,47,6,154,0,COMPLETED_WALLTIME_REACHED,163,154,317,116,270,1.7532467532467533,0 1 2 3 4 5,-1
6,w0,100,67,4,153,0,COMPLETED_WALLTIME_REACHED,187,153,340,120,273,1.7843137254901962,6 7 8 9,-1
5,w0,100,66,5,155,0,COMPLETED_WALLTIME_REACHED,194,155,349,128,283,1.8258064516129033,10 11 12 13 14,-1
7,w0,100,77,3,147,0,COMPLETED_WALLTIME_REACHED,317,147,464,240,387,2.63265306122449,0 1 2,-1
15,w0,100,107,3,154,0,COMPLETED_WALLTIME_REACHED,317,154,471,210,364,2.3636363636363638,3 4 5,-1
8,w0,100,81,5,152,0,COMPLETED_WALLTIME_REACHED,340,152,492,259,411,2.7039473684210527,6 7 8 9 15,-1
9,w0,100,85,5,152,0,COMPLETED_WALLTIME_REACHED,349,152,501,264,416,2.736842105263158,10 11 12 13 14,-1
10,w0,100,97,6,150,0,COMPLETED_WALLTIME_REACHED,471,150,621,374,524,3.493333333333333,0 1 2 3 4 5,-1
11,w0,100,98,5,151,0,COMPLETED_WALLTIME_REACHED,492,151,643,394,545,3.609271523178808,6 7 8 9 15,-1
12,w0,100,99,4,150,0,COMPLETED_WALLTIME_REACHED,501,150,651,402,552,3.68,10 11 12 13,-1
13,w0,100,100,4,149,0,COMPLETED_WALLTIME_REACHED,621,149,770,521,670,4.496644295302014,0 1 2 3,-1
28,w0,100,156,3,150,0,COMPLETED_WALLTIME_REACHED,621,150,771,465,615,4.1,4 5 14,-1
14,w0,100,101,4,147,0,COMPLETED_WALLTIME_REACHED,643,147,790,542,689,4.687074829931973,6 7 8 9,-1
16,w0,100,108,4,147,0,COMPLETED_WALLTIME_REACHED,651,147,798,543,690,4.6938775510204085,10 11 12 13,-1
43,w0,100,254,2,149,0,COMPLETED_WALLTIME_REACHED,770,149,919,516,665,4.4630872483221475,0 1,-1
17,w0,100,113,6,151,0,COMPLETED_WALLTIME_REACHED,771,151,922,658,809,5.357615894039735,2 3 4 5 14 15,-1
35,w0,100,208,3,153,0,COMPLETED_WALLTIME_REACHED,790,153,943,582,735,4.803921568627451,6 7 8,-1
18,w0,100,114,5,151,0,COMPLETED_WALLTIME_REACHED,798,151,949,684,835,5.529801324503311,9 10 11 12 13,-1
19,w0,100,115,4,148,0,COMPLETED_WALLTIME_REACHED,922,148,1070,807,955,6.452702702702703,0 1 2 3,-1
20,w0,100,121,5,151,0,COMPLETED_WALLTIME_REACHED,943,151,1094,822,973,6.443708609271523,4 5 6 7 8,-1
21,w0,100,134,5,149,0,COMPLETED_WALLTIME_REACHED,949,149,1098,815,964,6.469798657718121,9 10 11 12 13,-1
196,w0,100,1057,1,152,0,COMPLETED_WALLTIME_REACHED,1057,152,1209,0,152,1.0,14,-1
22,w0,100,138,5,152,0,COMPLETED_WALLTIME_REACHED,1070,152,1222,932,1084,7.131578947368421,0 1 2 3 15,-1
30,w0,100,171,4,149,0,COMPLETED_WALLTIME_REACHED,1094,149,1243,923,1072,7.194630872483222,4 5 6 7,-1
23,w0,100,138,6,151,0,COMPLETED_WALLTIME_REACHED,1098,151,1249,960,1111,7.357615894039735,8 9 10 11 12 13,-1
24,w0,100,142,5,145,0,COMPLETED_WALLTIME_REACHED,1222,145,1367,1080,1225,8.448275862068966,0 1 2 3 14,-1
26,w0,100,153,5,147,0,COMPLETED_WALLTIME_REACHED,1243,147,1390,1090,1237,8.414965986394558,4 5 6 7 15,-1
25,w0,100,152,6,147,0,COMPLETED_WALLTIME_REACHED,1249,147,1396,1097,1244,8.462585034013605,8 9 10 11 12 13,-1
27,w0,100,153,5,146,0,COMPLETED_WALLTIME_REACHED,1367,146,1513,1214,1360,9.315068493150685,0 1 2 3 14,-1
31,w0,100,175,5,151,0,COMPLETED_WALLTIME_REACHED,1390,151,1541,1215,1366,9.04635761589404,4 5 6 7 15,-1
29,w0,100,171,6,151,0,COMPLETED_WALLTIME_REACHED,1396,151,1547,1225,1376,9.112582781456954,8 9 10 11 12 13,-1
32,w0,100,190,4,151,0,COMPLETED_WALLTIME_REACHED,1513,151,1664,1323,1474,9.76158940397351,0 1 2 3,-1
33,w0,100,199,4,148,0,COMPLETED_WALLTIME_REACHED,1541,148,1689,1342,1490,10.067567567567568,4 5 6 7,-1
258,w0,100,1315,2,151,0,COMPLETED_WALLTIME_REACHED,1541,151,1692,226,377,2.4966887417218544,14 15,-1
34,w0,100,202,4,149,0,COMPLETED_WALLTIME_REACHED,1547,149,1696,1345,1494,10.026845637583893,8 9 10 11,-1
263,w0,100,1352,2,151,0,COMPLETED_WALLTIME_REACHED,1547,151,1698,195,346,2.2913907284768213,12 13,-1
36,w0,100,208,3,150,0,COMPLETED_WALLTIME_REACHED,1664,150,1814,1456,1606,10.706666666666667,0 1 2,-1
37,w0,100,211,5,153,0,COMPLETED_WALLTIME_REACHED,1689,153,1842,1478,1631,10.660130718954248,3 4 5 6 7,-1
325,w0,100,1601,1,150,0,COMPLETED_WALLTIME_REACHED,1692,150,1842,91,241,1.6066666666666667,14,-1
38,w0,100,229,5,151,0,COMPLETED_WALLTIME_REACHED,1696,151,1847,1467,1618,10.71523178807947,8 9 10 11 15,-1
39,w0,100,237,5,149,0,COMPLETED_WALLTIME_REACHED,1814,149,1963,1577,1726,11.583892617449665,0 1 2 12 13,-1
40,w0,100,239,6,150,0,COMPLETED_WALLTIME_REACHED,1842,150,1992,1603,1753,11.686666666666667,3 4 5 6 7 14,-1
41,w0,100,246,3,151,0,COMPLETED_WALLTIME_REACHED,1847,151,1998,1601,1752,11.602649006622517,8 9 10,-1
290,w0,100,1450,2,152,0,COMPLETED_WALLTIME_REACHED,1847,152,1999,397,549,3.611842105263158,11 15,-1
42,w0,100,250,5,149,0,COMPLETED_WALLTIME_REACHED,1963,149,2112,1713,1862,12.496644295302014,0 1 2 12 13,-1
44,w0,100,261,6,149,0,COMPLETED_WALLTIME_REACHED,1992,149,2141,1731,1880,12.61744966442953,3 4 5 6 7 14,-1
45,w0,100,273,4,150,0,COMPLETED_WALLTIME_REACHED,1999,150,2149,1726,1876,12.506666666666666,8 9 10 11,-1
46,w0,100,285,5,148,0,COMPLETED_WALLTIME_REACHED,2112,148,2260,1827,1975,13.344594594594595,0 1 2 12 13,-1
47,w0,100,286,5,151,0,COMPLETED_WALLTIME_REACHED,2141,151,2292,1855,2006,13.28476821192053,3 4 5 6 7,-1
382,w0,100,1902,2,153,0,COMPLETED_WALLTIME_REACHED,2141,153,2294,239,392,2.5620915032679736,14 15,-1
48,w0,100,294,4,149,0,COMPLETED_WALLTIME_REACHED,2149,149,2298,1855,2004,13.449664429530202,8 9 10 11,-1
49,w0,100,305,5,151,0,COMPLETED_WALLTIME_REACHED,2260,151,2411,1955,2106,13.947019867549669,0 1 2 12 13,-1
50,w0,100,306,6,152,0,COMPLETED_WALLTIME_REACHED,2294,152,2446,1988,2140,14.078947368421053,3 4 5 6 7 14,-1
51,w0,100,308,4,150,0,COMPLETED_WALLTIME_REACHED,2298,150,2448,1990,2140,14.266666666666667,8 9 10 11,-1
52,w0,100,330,4,148,0,COMPLETED_WALLTIME_REACHED,2411,148,2559,2081,2229,15.06081081081081,0 1 2 12,-1
405,w0,100,2033,2,151,0,COMPLETED_WALLTIME_REACHED,2411,151,2562,378,529,3.5033112582781456,13 15,-1
53,w0,100,335,5,147,0,COMPLETED_WALLTIME_REACHED,2446,147,2593,2111,2258,15.360544217687075,3 4 5 6 7,-1
54,w0,100,335,5,148,0,COMPLETED_WALLTIME_REACHED,2448,148,2596,2113,2261,15.277027027027026,8 9 10 11 14,-1
55,w0,100,338,4,152,0,COMPLETED_WALLTIME_REACHED,2559,152,2711,2221,2373,15.611842105263158,0 1 2 12,-1
416,w0,100,2083,2,147,0,COMPLETED_WALLTIME_REACHED,2562,147,2709,479,626,4.258503401360544,13 15,-1
56,w0,100,350,5,147,0,COMPLETED_WALLTIME_REACHED,2593,147,2740,2243,2390,16.258503401360546,3 4 5 6 7,-1
57,w0,100,360,3,149,0,COMPLETED_WALLTIME_REACHED,2596,149,2745,2236,2385,16.006711409395972,8 9 10,-1
443,w0,100,2226,2,149,0,COMPLETED_WALLTIME_REACHED,2596,149,2745,370,519,3.4832214765100673,11 14,-1
58,w0,100,363,6,150,0,COMPLETED_WALLTIME_REACHED,2711,150,2861,2348,2498,16.653333333333332,0 1 2 12 13 15,-1
64,w0,100,419,4,148,0,COMPLETED_WALLTIME_REACHED,2740,148,2888,2321,2469,16.68243243243243,3 4 5 6,-1
59,w0,100,367,6,150,0,COMPLETED_WALLTIME_REACHED,2745,150,2895,2378,2528,16.85333333333333,7 8 9 10 11 14,-1
60,w0,100,376,5,146,0,COMPLETED_WALLTIME_REACHED,2861,146,3007,2485,2631,18.02054794520548,0 1 2 12 13,-1
62,w0,100,407,5,149,0,COMPLETED_WALLTIME_REACHED,2888,149,3037,2481,2630,17.651006711409394,3 4 5 6 15,-1
61,w0,100,398,6,152,0,COMPLETED_WALLTIME_REACHED,2895,152,3047,2497,2649,17.42763157894737,7 8 9 10 11 14,-1
63,w0,100,409,5,148,0,COMPLETED_WALLTIME_REACHED,3007,148,3155,2598,2746,18.554054054054053,0 1 2 12 13,-1
65,w0,100,420,5,149,0,COMPLETED_WALLTIME_REACHED,3037,149,3186,2617,2766,18.563758389261746,3 4 5 6 15,-1
66,w0,100,433,5,152,0,COMPLETED_WALLTIME_REACHED,3047,152,3199,2614,2766,18.19736842105263,7 8 9 10 11,-1
67,w0,100,446,6,147,0,COMPLETED_WALLTIME_REACHED,3155,147,3302,2709,2856,19.428571428571427,0 1 2 12 13 14,-1
68,w0,100,450,5,149,0,COMPLETED_WALLTIME_REACHED,3186,149,3335,2736,2885,19.36241610738255,3 4 5 6 15,-1
69,w0,100,452,4,149,0,COMPLETED_WALLTIME_REACHED,3199,149,3348,2747,2896,19.436241610738254,7 8 9 10,-1
70,w0,100,455,4,148,0,COMPLETED_WALLTIME_REACHED,3302,148,3450,2847,2995,20.236486486486488,0 1 2 11,-1
77,w0,100,485,3,155,0,COMPLETED_WALLTIME_REACHED,3302,155,3457,2817,2972,19.174193548387098,12 13 14,-1
71,w0,100,460,4,153,0,COMPLETED_WALLTIME_REACHED,3335,153,3488,2875,3028,19.790849673202615,3 4 5 6,-1
86,w0,100,527,3,148,0,COMPLETED_WALLTIME_REACHED,3348,148,3496,2821,2969,20.06081081081081,7 8 9,-1
72,w0,100,460,6,148,0,COMPLETED_WALLTIME_REACHED,3450,148,3598,2990,3138,21.2027027027027,0 1 2 10 11 15,-1
88,w0,100,545,3,152,0,COMPLETED_WALLTIME_REACHED,3457,152,3609,2912,3064,20.157894736842106,12 13 14,-1
73,w0,100,461,4,150,0,COMPLETED_WALLTIME_REACHED,3488,150,3638,3027,3177,21.18,3 4 5 6,-1
90,w0,100,551,3,150,0,COMPLETED_WALLTIME_REACHED,3496,150,3646,2945,3095,20.633333333333333,7 8 9,-1
74,w0,100,467,5,153,0,COMPLETED_WALLTIME_REACHED,3598,153,3751,3131,3284,21.464052287581698,0 1 2 10 11,-1
119,w0,100,742,3,152,0,COMPLETED_WALLTIME_REACHED,3609,152,3761,2867,3019,19.861842105263158,12 13 14,-1
75,w0,100,475,5,150,0,COMPLETED_WALLTIME_REACHED,3638,150,3788,3163,3313,22.086666666666666,3 4 5 6 15,-1
120,w0,100,744,3,150,0,COMPLETED_WALLTIME_REACHED,3646,150,3796,2902,3052,20.346666666666668,7 8 9,-1
76,w0,100,476,5,153,0,COMPLETED_WALLTIME_REACHED,3751,153,3904,3275,3428,22.405228758169933,0 1 2 10 11,-1
494,w0,100,2498,2,149,0,COMPLETED_WALLTIME_REACHED,3761,149,3910,1263,1412,9.476510067114093,12 13,-1
78,w0,100,487,6,149,0,COMPLETED_WALLTIME_REACHED,3788,149,3937,3301,3450,23.154362416107382,3 4 5 6 14 15,-1
125,w0,100,775,3,151,0,COMPLETED_WALLTIME_REACHED,3796,151,3947,3021,3172,21.00662251655629,7 8 9,-1
79,w0,100,492,5,146,0,COMPLETED_WALLTIME_REACHED,3904,146,4050,3412,3558,24.36986301369863,0 1 2 10 11,-1
500,w0,100,2521,2,147,0,COMPLETED_WALLTIME_REACHED,3910,147,4057,1389,1536,10.448979591836734,12 13,-1
80,w0,100,498,5,150,0,COMPLETED_WALLTIME_REACHED,3937,150,4087,3439,3589,23.926666666666666,3 4 5 6 14,-1
83,w0,100,518,4,152,0,COMPLETED_WALLTIME_REACHED,3947,152,4099,3429,3581,23.55921052631579,7 8 9 15,-1
81,w0,100,506,5,153,0,COMPLETED_WALLTIME_REACHED,4050,153,4203,3544,3697,24.163398692810457,0 1 2 10 11,-1
540,w0,100,2701,2,149,0,COMPLETED_WALLTIME_REACHED,4057,149,4206,1356,1505,10.100671140939598,12 13,-1
82,w0,100,507,5,148,0,COMPLETED_WALLTIME_REACHED,4087,148,4235,3580,3728,25.18918918918919,3 4 5 6 14,-1
84,w0,100,519,4,153,0,COMPLETED_WALLTIME_REACHED,4099,153,4252,3580,3733,24.398692810457515,7 8 9 15,-1
85,w0,100,520,4,151,0,COMPLETED_WALLTIME_REACHED,4203,151,4354,3683,3834,25.39072847682119,0 1 2 10,-1
126,w0,100,775,3,149,0,COMPLETED_WALLTIME_REACHED,4206,149,4355,3431,3580,24.026845637583893,11 12 13,-1
87,w0,100,544,4,151,0,COMPLETED_WALLTIME_REACHED,4235,151,4386,3691,3842,25.443708609271525,3 4 5 6,-1
130,w0,100,784,3,148,0,COMPLETED_WALLTIME_REACHED,4252,148,4400,3468,3616,24.43243243243243,7 8 9,-1
89,w0,100,548,6,150,0,COMPLETED_WALLTIME_REACHED,4354,150,4504,3806,3956,26.373333333333335,0 1 2 10 14 15,-1
131,w0,100,791,3,150,0,COMPLETED_WALLTIME_REACHED,4355,150,4505,3564,3714,24.76,11 12 13,-1
91,w0,100,552,4,147,0,COMPLETED_WALLTIME_REACHED,4386,147,4533,3834,3981,27.081632653061224,3 4 5 6,-1
146,w0,100,864,3,153,0,COMPLETED_WALLTIME_REACHED,4400,153,4553,3536,3689,24.11111111111111,7 8 9,-1
92,w0,100,553,5,148,0,COMPLETED_WALLTIME_REACHED,4504,148,4652,3951,4099,27.695945945945947,0 1 2 10 14,-1
542,w0,100,2713,2,147,0,COMPLETED_WALLTIME_REACHED,4505,147,4652,1792,1939,13.19047619047619,11 12,-1
93,w0,100,560,6,149,0,COMPLETED_WALLTIME_REACHED,4533,149,4682,3973,4122,27.664429530201343,3 4 5 6 13 15,-1
147,w0,100,867,3,151,0,COMPLETED_WALLTIME_REACHED,4553,151,4704,3686,3837,25.410596026490065,7 8 9,-1
94,w0,100,566,5,153,0,COMPLETED_WALLTIME_REACHED,4652,153,4805,4086,4239,27.705882352941178,0 1 2 10 11,-1
95,w0,100,569,7,151,0,COMPLETED_WALLTIME_REACHED,4682,151,4833,4113,4264,28.23841059602649,3 4 5 6 12 13 14,-1
100,w0,100,603,4,146,0,COMPLETED_WALLTIME_REACHED,4704,146,4850,4101,4247,29.089041095890412,7 8 9 15,-1
96,w0,100,575,5,151,0,COMPLETED_WALLTIME_REACHED,4805,151,4956,4230,4381,29.013245033112582,0 1 2 10 11,-1
97,w0,100,579,5,149,0,COMPLETED_WALLTIME_REACHED,4833,149,4982,4254,4403,29.550335570469798,3 4 5 6 12,-1
98,w0,100,583,6,149,0,COMPLETED_WALLTIME_REACHED,4850,149,4999,4267,4416,29.63758389261745,7 8 9 13 14 15,-1
99,w0,100,588,5,149,0,COMPLETED_WALLTIME_REACHED,4956,149,5105,4368,4517,30.315436241610737,0 1 2 10 11,-1
101,w0,100,610,4,150,0,COMPLETED_WALLTIME_REACHED,4982,150,5132,4372,4522,30.14666666666667,3 4 5 6,-1
102,w0,100,618,4,149,0,COMPLETED_WALLTIME_REACHED,4999,149,5148,4381,4530,30.40268456375839,7 8 9 12,-1
553,w0,100,2761,2,150,0,COMPLETED_WALLTIME_REACHED,4999,150,5149,2238,2388,15.92,13 14,-1
103,w0,100,632,6,150,0,COMPLETED_WALLTIME_REACHED,5105,150,5255,4473,4623,30.82,0 1 2 10 11 15,-1
104,w0,100,635,4,148,0,COMPLETED_WALLTIME_REACHED,5132,148,5280,4497,4645,31.385135135135137,3 4 5 6,-1
105,w0,100,636,6,153,0,COMPLETED_WALLTIME_REACHED,5149,153,5302,4513,4666,30.49673202614379,7 8 9 12 13 14,-1
106,w0,100,652,6,152,0,COMPLETED_WALLTIME_REACHED,5255,152,5407,4603,4755,31.282894736842106,0 1 2 10 11 15,-1
108,w0,100,655,4,150,0,COMPLETED_WALLTIME_REACHED,5280,150,5430,4625,4775,31.833333333333332,3 4 5 6,-1
107,w0,100,653,5,153,0,COMPLETED_WALLTIME_REACHED,5302,153,5455,4649,4802,31.38562091503268,7 8 9 12 13,-1
109,w0,100,657,6,149,0,COMPLETED_WALLTIME_REACHED,5407,149,5556,4750,4899,32.87919463087248,0 1 2 10 11 14,-1
110,w0,100,664,5,148,0,COMPLETED_WALLTIME_REACHED,5430,148,5578,4766,4914,33.2027027027027,3 4 5 6 15,-1
111,w0,100,666,5,149,0,COMPLETED_WALLTIME_REACHED,5455,149,5604,4789,4938,33.14093959731544,7 8 9 12 13,-1
113,w0,100,688,4,152,0,COMPLETED_WALLTIME_REACHED,5556,152,5708,4868,5020,33.026315789473685,0 1 2 10,-1
112,w0,100,681,7,149,0,COMPLETED_WALLTIME_REACHED,5578,149,5727,4897,5046,33.86577181208054,3 4 5 6 11 14 15,-1
114,w0,100,688,5,147,0,COMPLETED_WALLTIME_REACHED,5604,147,5751,4916,5063,34.4421768707483,7 8 9 12 13,-1
121,w0,100,756,4,148,0,COMPLETED_WALLTIME_REACHED,5708,148,5856,4952,5100,34.45945945945946,0 1 2 10,-1
115,w0,100,693,6,150,0,COMPLETED_WALLTIME_REACHED,5727,150,5877,5034,5184,34.56,3 4 5 6 11 14,-1
116,w0,100,718,5,149,0,COMPLETED_WALLTIME_REACHED,5751,149,5900,5033,5182,34.77852348993289,7 8 9 12 13,-1
117,w0,100,739,5,150,0,COMPLETED_WALLTIME_REACHED,5856,150,6006,5117,5267,35.11333333333334,0 1 2 10 15,-1
118,w0,100,741,5,154,0,COMPLETED_WALLTIME_REACHED,5877,154,6031,5136,5290,34.35064935064935,3 4 5 6 11,-1
122,w0,100,757,4,146,0,COMPLETED_WALLTIME_REACHED,5900,146,6046,5143,5289,36.226027397260275,7 8 9 12,-1
123,w0,100,763,6,149,0,COMPLETED_WALLTIME_REACHED,6006,149,6155,5243,5392,36.18791946308725,0 1 2 10 13 14,-1
124,w0,100,770,5,151,0,COMPLETED_WALLTIME_REACHED,6031,151,6182,5261,5412,35.841059602649004,3 4 5 6 11,-1
127,w0,100,776,4,149,0,COMPLETED_WALLTIME_REACHED,6046,149,6195,5270,5419,36.369127516778526,7 8 9 12,-1
128,w0,100,782,7,150,0,COMPLETED_WALLTIME_REACHED,6155,150,6305,5373,5523,36.82,0 1 2 10 13 14 15,-1
575,w0,100,2847,2,151,0,COMPLETED_WALLTIME_REACHED,6182,151,6333,3335,3486,23.08609271523179,3 4,-1
129,w0,100,782,7,149,0,COMPLETED_WALLTIME_REACHED,6195,149,6344,5413,5562,37.328859060402685,5 6 7 8 9 11 12,-1
132,w0,100,797,6,146,0,COMPLETED_WALLTIME_REACHED,6305,146,6451,5508,5654,38.726027397260275,0 1 2 10 13 14,-1
152,w0,100,894,3,152,0,COMPLETED_WALLTIME_REACHED,6333,152,6485,5439,5591,36.7828947368421,3 4 15,-1
133,w0,100,800,4,154,0,COMPLETED_WALLTIME_REACHED,6344,154,6498,5544,5698,37.0,5 6 7 8,-1
154,w0,100,901,3,153,0,COMPLETED_WALLTIME_REACHED,6344,153,6497,5443,5596,36.57516339869281,9 11 12,-1
134,w0,100,802,4,152,0,COMPLETED_WALLTIME_REACHED,6451,152,6603,5649,5801,38.16447368421053,0 1 2 10,-1
665,w0,100,3341,2,149,0,COMPLETED_WALLTIME_REACHED,6451,149,6600,3110,3259,21.87248322147651,13 14,-1
135,w0,100,807,6,150,0,COMPLETED_WALLTIME_REACHED,6497,150,6647,5690,5840,38.93333333333333,3 4 9 11 12 15,-1
136,w0,100,818,5,153,0,COMPLETED_WALLTIME_REACHED,6600,153,6753,5782,5935,38.790849673202615,5 6 7 8 13,-1
137,w0,100,819,5,149,0,COMPLETED_WALLTIME_REACHED,6603,149,6752,5784,5933,39.81879194630873,0 1 2 10 14,-1
138,w0,100,821,4,152,0,COMPLETED_WALLTIME_REACHED,6647,152,6799,5826,5978,39.328947368421055,3 4 9 11,-1
668,w0,100,3367,2,153,0,COMPLETED_WALLTIME_REACHED,6647,153,6800,3280,3433,22.437908496732025,12 15,-1
139,w0,100,822,4,151,0,COMPLETED_WALLTIME_REACHED,6752,151,6903,5930,6081,40.271523178807946,0 1 2 10,-1
140,w0,100,823,5,152,0,COMPLETED_WALLTIME_REACHED,6753,152,6905,5930,6082,40.01315789473684,5 6 7 8 13,-1
141,w0,100,828,4,150,0,COMPLETED_WALLTIME_REACHED,6799,150,6949,5971,6121,40.806666666666665,3 4 9 11,-1
142,w0,100,833,6,149,0,COMPLETED_WALLTIME_REACHED,6903,149,7052,6070,6219,41.738255033557046,0 1 2 10 12 14,-1
143,w0,100,838,5,150,0,COMPLETED_WALLTIME_REACHED,6905,150,7055,6067,6217,41.446666666666665,5 6 7 8 13,-1
144,w0,100,840,5,152,0,COMPLETED_WALLTIME_REACHED,6949,152,7101,6109,6261,41.19078947368421,3 4 9 11 15,-1
145,w0,100,847,4,152,0,COMPLETED_WALLTIME_REACHED,7052,152,7204,6205,6357,41.82236842105263,0 1 2 10,-1
718,w0,100,3597,2,148,0,COMPLETED_WALLTIME_REACHED,7052,148,7200,3455,3603,24.344594594594593,12 14,-1
148,w0,100,868,4,148,0,COMPLETED_WALLTIME_REACHED,7055,148,7203,6187,6335,42.804054054054056,5 6 7 8,-1
149,w0,100,872,5,147,0,COMPLETED_WALLTIME_REACHED,7101,147,7248,6229,6376,43.374149659863946,3 4 9 11 13,-1
170,w0,100,959,3,154,0,COMPLETED_WALLTIME_REACHED,7200,154,7354,6241,6395,41.52597402597402,12 14 15,-1
150,w0,100,880,4,151,0,COMPLETED_WALLTIME_REACHED,7203,151,7354,6323,6474,42.87417218543046,5 6 7 8,-1
151,w0,100,884,4,149,0,COMPLETED_WALLTIME_REACHED,7204,149,7353,6320,6469,43.41610738255034,0 1 2 10,-1
173,w0,100,961,3,148,0,COMPLETED_WALLTIME_REACHED,7248,148,7396,6287,6435,43.479729729729726,3 4 9,-1
153,w0,100,897,6,150,0,COMPLETED_WALLTIME_REACHED,7353,150,7503,6456,6606,44.04,0 1 2 10 11 13,-1
155,w0,100,904,5,147,0,COMPLETED_WALLTIME_REACHED,7354,147,7501,6450,6597,44.87755102040816,5 6 7 8 12,-1
156,w0,100,907,4,148,0,COMPLETED_WALLTIME_REACHED,7396,148,7544,6489,6637,44.8445945945946,3 4 9 14,-1
157,w0,100,911,4,150,0,COMPLETED_WALLTIME_REACHED,7501,150,7651,6590,6740,44.93333333333333,5 6 7 8,-1
760,w0,100,3785,2,151,0,COMPLETED_WALLTIME_REACHED,7501,151,7652,3716,3867,25.60927152317881,12 15,-1
158,w0,100,911,6,151,0,COMPLETED_WALLTIME_REACHED,7503,151,7654,6592,6743,44.65562913907285,0 1 2 10 11 13,-1
174,w0,100,968,3,153,0,COMPLETED_WALLTIME_REACHED,7544,153,7697,6576,6729,43.98039215686274,3 4 9,-1
159,w0,100,911,5,152,0,COMPLETED_WALLTIME_REACHED,7651,152,7803,6740,6892,45.3421052631579,5 6 7 8 14,-1
768,w0,100,3818,2,151,0,COMPLETED_WALLTIME_REACHED,7652,151,7803,3834,3985,26.39072847682119,12 15,-1
160,w0,100,914,6,150,0,COMPLETED_WALLTIME_REACHED,7654,150,7804,6740,6890,45.93333333333333,0 1 2 10 11 13,-1
178,w0,100,974,3,151,0,COMPLETED_WALLTIME_REACHED,7697,151,7848,6723,6874,45.52317880794702,3 4 9,-1
161,w0,100,918,4,153,0,COMPLETED_WALLTIME_REACHED,7803,153,7956,6885,7038,46.0,5 6 7 8,-1
179,w0,100,979,3,151,0,COMPLETED_WALLTIME_REACHED,7803,151,7954,6824,6975,46.19205298013245,12 14 15,-1
162,w0,100,925,4,149,0,COMPLETED_WALLTIME_REACHED,7804,149,7953,6879,7028,47.16778523489933,0 1 2 10,-1
163,w0,100,938,4,150,0,COMPLETED_WALLTIME_REACHED,7848,150,7998,6910,7060,47.06666666666667,3 4 9 11,-1
164,w0,100,938,4,152,0,COMPLETED_WALLTIME_REACHED,7953,152,8105,7015,7167,47.151315789473685,0 1 2 10,-1
810,w0,100,4017,2,149,0,COMPLETED_WALLTIME_REACHED,7954,149,8103,3937,4086,27.42281879194631,12 13,-1
165,w0,100,940,6,150,0,COMPLETED_WALLTIME_REACHED,7956,150,8106,7016,7166,47.77333333333333,5 6 7 8 14 15,-1
166,w0,100,942,6,149,0,COMPLETED_WALLTIME_REACHED,8103,149,8252,7161,7310,49.060402684563755,3 4 9 11 12 13,-1
168,w0,100,952,4,150,0,COMPLETED_WALLTIME_REACHED,8105,150,8255,7153,7303,48.68666666666667,0 1 2 10,-1
167,w0,100,945,6,148,0,COMPLETED_WALLTIME_REACHED,8106,148,8254,7161,7309,49.38513513513514,5 6 7 8 14 15,-1
169,w0,100,954,6,149,0,COMPLETED_WALLTIME_REACHED,8252,149,8401,7298,7447,49.97986577181208,3 4 9 11 12 13,-1
171,w0,100,959,5,150,0,COMPLETED_WALLTIME_REACHED,8254,150,8404,7295,7445,49.63333333333333,5 6 7 8 14,-1
172,w0,100,959,5,152,0,COMPLETED_WALLTIME_REACHED,8255,152,8407,7296,7448,49.0,0 1 2 10 15,-1
175,w0,100,968,4,152,0,COMPLETED_WALLTIME_REACHED,8401,152,8553,7433,7585,49.901315789473685,3 4 9 11,-1
825,w0,100,4079,2,149,0,COMPLETED_WALLTIME_REACHED,8401,149,8550,4322,4471,30.006711409395972,12 13,-1
176,w0,100,970,4,151,0,COMPLETED_WALLTIME_REACHED,8404,151,8555,7434,7585,50.2317880794702,5 6 7 8,-1
177,w0,100,973,5,149,0,COMPLETED_WALLTIME_REACHED,8407,149,8556,7434,7583,50.89261744966443,0 1 2 10 14,-1
182,w0,100,997,3,155,0,COMPLETED_WALLTIME_REACHED,8550,155,8705,7553,7708,49.729032258064514,12 13 15,-1
180,w0,100,986,4,148,0,COMPLETED_WALLTIME_REACHED,8553,148,8701,7567,7715,52.12837837837838,3 4 9 11,-1
189,w0,100,1031,3,152,0,COMPLETED_WALLTIME_REACHED,8555,152,8707,7524,7676,50.5,5 6 7,-1
181,w0,100,997,6,147,0,COMPLETED_WALLTIME_REACHED,8556,147,8703,7559,7706,52.42176870748299,0 1 2 8 10 14,-1
183,w0,100,1006,4,153,0,COMPLETED_WALLTIME_REACHED,8701,153,8854,7695,7848,51.294117647058826,3 4 9 11,-1
184,w0,100,1007,4,153,0,COMPLETED_WALLTIME_REACHED,8703,153,8856,7696,7849,51.30065359477124,0 1 2 8,-1
185,w0,100,1009,5,151,0,COMPLETED_WALLTIME_REACHED,8705,151,8856,7696,7847,51.966887417218544,10 12 13 14 15,-1
293,w0,100,1460,3,147,0,COMPLETED_WALLTIME_REACHED,8707,147,8854,7247,7394,50.29931972789116,5 6 7,-1
186,w0,100,1013,6,150,0,COMPLETED_WALLTIME_REACHED,8854,150,9004,7841,7991,53.27333333333333,3 4 5 6 7 9,-1
187,w0,100,1017,6,152,0,COMPLETED_WALLTIME_REACHED,8856,152,9008,7839,7991,52.57236842105263,0 1 2 8 10 11,-1
193,w0,100,1044,4,147,0,COMPLETED_WALLTIME_REACHED,8856,147,9003,7812,7959,54.142857142857146,12 13 14 15,-1
194,w0,100,1045,4,149,0,COMPLETED_WALLTIME_REACHED,9003,149,9152,7958,8107,54.40939597315436,12 13 14 15,-1
188,w0,100,1022,5,146,0,COMPLETED_WALLTIME_REACHED,9004,146,9150,7982,8128,55.67123287671233,3 4 5 6 7,-1
190,w0,100,1032,5,147,0,COMPLETED_WALLTIME_REACHED,9008,147,9155,7976,8123,55.25850340136054,0 1 2 8 9,-1
873,w0,100,4397,2,148,0,COMPLETED_WALLTIME_REACHED,9008,148,9156,4611,4759,32.1554054054054,10 11,-1
191,w0,100,1035,5,152,0,COMPLETED_WALLTIME_REACHED,9150,152,9302,8115,8267,54.38815789473684,3 4 5 6 7,-1
197,w0,100,1059,3,148,0,COMPLETED_WALLTIME_REACHED,9152,148,9300,8093,8241,55.682432432432435,12 13 14,-1
192,w0,100,1042,5,151,0,COMPLETED_WALLTIME_REACHED,9155,151,9306,8113,8264,54.728476821192054,0 1 2 8 9,-1
499,w0,100,2520,3,144,0,COMPLETED_WALLTIME_REACHED,9156,144,9300,6636,6780,47.083333333333336,10 11 15,-1
195,w0,100,1048,6,150,0,COMPLETED_WALLTIME_REACHED,9300,150,9450,8252,8402,56.013333333333335,10 11 12 13 14 15,-1
198,w0,100,1060,4,149,0,COMPLETED_WALLTIME_REACHED,9302,149,9451,8242,8391,56.31543624161074,3 4 5 6,-1
199,w0,100,1061,5,148,0,COMPLETED_WALLTIME_REACHED,9306,148,9454,8245,8393,56.70945945945946,0 1 2 7 8,-1
200,w0,100,1062,4,150,0,COMPLETED_WALLTIME_REACHED,9450,150,9600,8388,8538,56.92,9 10 11 12,-1
201,w0,100,1066,3,150,0,COMPLETED_WALLTIME_REACHED,9450,150,9600,8384,8534,56.89333333333333,13 14 15,-1
203,w0,100,1072,3,148,0,COMPLETED_WALLTIME_REACHED,9451,148,9599,8379,8527,57.61486486486486,3 4 5,-1
202,w0,100,1069,6,148,0,COMPLETED_WALLTIME_REACHED,9454,148,9602,8385,8533,57.6554054054054,0 1 2 6 7 8,-1
234,w0,100,1208,3,148,0,COMPLETED_WALLTIME_REACHED,9599,148,9747,8391,8539,57.695945945945944,3 4 5,-1
204,w0,100,1073,4,150,0,COMPLETED_WALLTIME_REACHED,9600,150,9750,8527,8677,57.846666666666664,9 10 11 12,-1
257,w0,100,1314,3,148,0,COMPLETED_WALLTIME_REACHED,9600,148,9748,8286,8434,56.986486486486484,13 14 15,-1
205,w0,100,1073,6,151,0,COMPLETED_WALLTIME_REACHED,9602,151,9753,8529,8680,57.48344370860927,0 1 2 6 7 8,-1
206,w0,100,1074,5,150,0,COMPLETED_WALLTIME_REACHED,9748,150,9898,8674,8824,58.82666666666667,3 4 5 13 14,-1
207,w0,100,1083,5,148,0,COMPLETED_WALLTIME_REACHED,9750,148,9898,8667,8815,59.560810810810814,9 10 11 12 15,-1
208,w0,100,1085,4,150,0,COMPLETED_WALLTIME_REACHED,9753,150,9903,8668,8818,58.78666666666667,0 1 2 6,-1
884,w0,100,4447,2,147,0,COMPLETED_WALLTIME_REACHED,9753,147,9900,5306,5453,37.095238095238095,7 8,-1
209,w0,100,1085,5,148,0,COMPLETED_WALLTIME_REACHED,9898,148,10046,8813,8961,60.5472972972973,3 4 5 9 10,-1
210,w0,100,1089,4,149,0,COMPLETED_WALLTIME_REACHED,9898,149,10047,8809,8958,60.12080536912752,11 12 13 14,-1
989,w0,100,4931,2,151,0,COMPLETED_WALLTIME_REACHED,9900,151,10051,4969,5120,33.90728476821192,7 8,-1
211,w0,100,1093,5,152,0,COMPLETED_WALLTIME_REACHED,9903,152,10055,8810,8962,58.96052631578947,0 1 2 6 15,-1
212,w0,100,1109,4,150,0,COMPLETED_WALLTIME_REACHED,10046,150,10196,8937,9087,60.58,3 4 5 9,-1
213,w0,100,1111,4,147,0,COMPLETED_WALLTIME_REACHED,10047,147,10194,8936,9083,61.7891156462585,10 11 12 13,-1
260,w0,100,1334,3,150,0,COMPLETED_WALLTIME_REACHED,10051,150,10201,8717,8867,59.11333333333334,7 8 14,-1
214,w0,100,1118,5,149,0,COMPLETED_WALLTIME_REACHED,10055,149,10204,8937,9086,60.97986577181208,0 1 2 6 15,-1
215,w0,100,1135,4,147,0,COMPLETED_WALLTIME_REACHED,10194,147,10341,9059,9206,62.625850340136054,10 11 12 13,-1
992,w0,100,4955,2,150,0,COMPLETED_WALLTIME_REACHED,10196,150,10346,5241,5391,35.94,3 4,-1
216,w0,100,1136,5,153,0,COMPLETED_WALLTIME_REACHED,10201,153,10354,9065,9218,60.248366013071895,5 7 8 9 14,-1
217,w0,100,1144,5,150,0,COMPLETED_WALLTIME_REACHED,10204,150,10354,9060,9210,61.4,0 1 2 6 15,-1
218,w0,100,1145,4,147,0,COMPLETED_WALLTIME_REACHED,10341,147,10488,9196,9343,63.5578231292517,10 11 12 13,-1
996,w0,100,5003,2,150,0,COMPLETED_WALLTIME_REACHED,10346,150,10496,5343,5493,36.62,3 4,-1
219,w0,100,1150,4,150,0,COMPLETED_WALLTIME_REACHED,10354,150,10504,9204,9354,62.36,0 1 2 5,-1
220,w0,100,1152,4,150,0,COMPLETED_WALLTIME_REACHED,10354,150,10504,9202,9352,62.346666666666664,6 7 8 9,-1
221,w0,100,1164,4,148,0,COMPLETED_WALLTIME_REACHED,10488,148,10636,9324,9472,64.0,10 11 12 13,-1
223,w0,100,1172,4,149,0,COMPLETED_WALLTIME_REACHED,10496,149,10645,9324,9473,63.577181208053695,3 4 14 15,-1
222,w0,100,1170,5,150,0,COMPLETED_WALLTIME_REACHED,10504,150,10654,9334,9484,63.22666666666667,0 1 2 5 6,-1
267,w0,100,1361,3,148,0,COMPLETED_WALLTIME_REACHED,10504,148,10652,9143,9291,62.777027027027025,7 8 9,-1
224,w0,100,1172,4,148,0,COMPLETED_WALLTIME_REACHED,10636,148,10784,9464,9612,64.94594594594595,10 11 12 13,-1
225,w0,100,1181,5,152,0,COMPLETED_WALLTIME_REACHED,10652,152,10804,9471,9623,63.30921052631579,3 4 7 8 9,-1
226,w0,100,1185,4,147,0,COMPLETED_WALLTIME_REACHED,10654,147,10801,9469,9616,65.41496598639456,0 1 2 5,-1
227,w0,100,1187,5,151,0,COMPLETED_WALLTIME_REACHED,10784,151,10935,9597,9748,64.55629139072848,6 10 11 12 13,-1
228,w0,100,1192,5,150,0,COMPLETED_WALLTIME_REACHED,10801,150,10951,9609,9759,65.06,0 1 2 5 14,-1
229,w0,100,1196,4,151,0,COMPLETED_WALLTIME_REACHED,10804,151,10955,9608,9759,64.62913907284768,3 4 7 8,-1
230,w0,100,1200,4,153,0,COMPLETED_WALLTIME_REACHED,10935,153,11088,9735,9888,64.62745098039215,6 9 10 11,-1
271,w0,100,1385,3,151,0,COMPLETED_WALLTIME_REACHED,10935,151,11086,9550,9701,64.24503311258277,12 13 15,-1
231,w0,100,1201,4,152,0,COMPLETED_WALLTIME_REACHED,10951,152,11103,9750,9902,65.14473684210526,0 1 2 5,-1
232,w0,100,1202,5,148,0,COMPLETED_WALLTIME_REACHED,10955,148,11103,9753,9901,66.89864864864865,3 4 7 8 14,-1
281,w0,100,1423,3,149,0,COMPLETED_WALLTIME_REACHED,11086,149,11235,9663,9812,65.85234899328859,12 13 15,-1
233,w0,100,1204,4,148,0,COMPLETED_WALLTIME_REACHED,11088,148,11236,9884,10032,67.78378378378379,6 9 10 11,-1
235,w0,100,1221,5,149,0,COMPLETED_WALLTIME_REACHED,11103,149,11252,9882,10031,67.32214765100672,0 1 2 3 4,-1
236,w0,100,1226,4,148,0,COMPLETED_WALLTIME_REACHED,11103,148,11251,9877,10025,67.73648648648648,5 7 8 14,-1
237,w0,100,1229,6,149,0,COMPLETED_WALLTIME_REACHED,11236,149,11385,10007,10156,68.16107382550335,6 9 10 11 12 13,-1
238,w0,100,1230,4,153,0,COMPLETED_WALLTIME_REACHED,11251,153,11404,10021,10174,66.49673202614379,5 7 8 14,-1
239,w0,100,1230,5,148,0,COMPLETED_WALLTIME_REACHED,11252,148,11400,10022,10170,68.71621621621621,0 1 2 3 4,-1
240,w0,100,1233,4,151,0,COMPLETED_WALLTIME_REACHED,11385,151,11536,10152,10303,68.23178807947019,6 9 10 11,-1
284,w0,100,1426,3,152,0,COMPLETED_WALLTIME_REACHED,11385,152,11537,9959,10111,66.51973684210526,12 13 15,-1
241,w0,100,1241,4,148,0,COMPLETED_WALLTIME_REACHED,11400,148,11548,10159,10307,69.64189189189189,0 1 2 3,-1
242,w0,100,1241,5,152,0,COMPLETED_WALLTIME_REACHED,11404,152,11556,10163,10315,67.86184210526316,4 5 7 8 14,-1
243,w0,100,1243,4,152,0,COMPLETED_WALLTIME_REACHED,11536,152,11688,10293,10445,68.71710526315789,6 9 10 11,-1
244,w0,100,1244,5,148,0,COMPLETED_WALLTIME_REACHED,11548,148,11696,10304,10452,70.62162162162163,0 1 2 3 12,-1
245,w0,100,1252,4,156,0,COMPLETED_WALLTIME_REACHED,11556,156,11712,10304,10460,67.05128205128206,4 5 7 8,-1
246,w0,100,1257,5,148,0,COMPLETED_WALLTIME_REACHED,11688,148,11836,10431,10579,71.47972972972973,6 9 10 11 13,-1
247,w0,100,1260,5,148,0,COMPLETED_WALLTIME_REACHED,11696,148,11844,10436,10584,71.51351351351352,0 1 2 3 12,-1
248,w0,100,1261,5,152,0,COMPLETED_WALLTIME_REACHED,11712,152,11864,10451,10603,69.75657894736842,4 5 7 8 14,-1
249,w0,100,1269,4,149,0,COMPLETED_WALLTIME_REACHED,11836,149,11985,10567,10716,71.91946308724832,6 9 10 11,-1
250,w0,100,1272,6,147,0,COMPLETED_WALLTIME_REACHED,11844,147,11991,10572,10719,72.91836734693878,0 1 2 3 12 13,-1
251,w0,100,1285,6,152,0,COMPLETED_WALLTIME_REACHED,11864,152,12016,10579,10731,70.59868421052632,4 5 7 8 14 15,-1
253,w0,100,1295,4,151,0,COMPLETED_WALLTIME_REACHED,11985,151,12136,10690,10841,71.79470198675497,6 9 10 11,-1
252,w0,100,1288,6,152,0,COMPLETED_WALLTIME_REACHED,11991,152,12143,10703,10855,71.41447368421052,0 1 2 3 12 13,-1
254,w0,100,1302,4,148,0,COMPLETED_WALLTIME_REACHED,12016,148,12164,10714,10862,73.39189189189189,4 5 7 8,-1
255,w0,100,1306,4,147,0,COMPLETED_WALLTIME_REACHED,12136,147,12283,10830,10977,74.6734693877551,6 9 10 11,-1
256,w0,100,1310,5,150,0,COMPLETED_WALLTIME_REACHED,12143,150,12293,10833,10983,73.22,0 1 2 3 12,-1
286,w0,100,1431,3,152,0,COMPLETED_WALLTIME_REACHED,12143,152,12295,10712,10864,71.47368421052632,13 14 15,-1
259,w0,100,1325,4,151,0,COMPLETED_WALLTIME_REACHED,12164,151,12315,10839,10990,72.78145695364239,4 5 7 8,-1
261,w0,100,1338,4,151,0,COMPLETED_WALLTIME_REACHED,12283,151,12434,10945,11096,73.48344370860927,6 9 10 11,-1
262,w0,100,1350,5,151,0,COMPLETED_WALLTIME_REACHED,12293,151,12444,10943,11094,73.47019867549669,0 1 2 3 12,-1
264,w0,100,1353,6,154,0,COMPLETED_WALLTIME_REACHED,12315,154,12469,10962,11116,72.18181818181819,4 5 7 8 13 14,-1
265,w0,100,1358,4,150,0,COMPLETED_WALLTIME_REACHED,12434,150,12584,11076,11226,74.84,6 9 10 11,-1
266,w0,100,1358,5,149,0,COMPLETED_WALLTIME_REACHED,12444,149,12593,11086,11235,75.40268456375838,0 1 2 3 12,-1
268,w0,100,1374,5,152,0,COMPLETED_WALLTIME_REACHED,12469,152,12621,11095,11247,73.99342105263158,4 5 7 8 13,-1
269,w0,100,1376,4,148,0,COMPLETED_WALLTIME_REACHED,12584,148,12732,11208,11356,76.72972972972973,6 9 10 11,-1
270,w0,100,1381,5,152,0,COMPLETED_WALLTIME_REACHED,12593,152,12745,11212,11364,74.76315789473684,0 1 2 3 12,-1
272,w0,100,1389,4,153,0,COMPLETED_WALLTIME_REACHED,12621,153,12774,11232,11385,74.41176470588235,4 5 7 8,-1
273,w0,100,1391,6,150,0,COMPLETED_WALLTIME_REACHED,12732,150,12882,11341,11491,76.60666666666667,6 9 10 11 13 14,-1
274,w0,100,1404,5,148,0,COMPLETED_WALLTIME_REACHED,12745,148,12893,11341,11489,77.62837837837837,0 1 2 3 12,-1
275,w0,100,1404,5,154,0,COMPLETED_WALLTIME_REACHED,12774,154,12928,11370,11524,74.83116883116882,4 5 7 8 15,-1
276,w0,100,1408,5,149,0,COMPLETED_WALLTIME_REACHED,12882,149,13031,11474,11623,78.00671140939598,6 9 10 11 13,-1
277,w0,100,1413,5,148,0,COMPLETED_WALLTIME_REACHED,12893,148,13041,11480,11628,78.56756756756756,0 1 2 3 12,-1
278,w0,100,1416,6,152,0,COMPLETED_WALLTIME_REACHED,12928,152,13080,11512,11664,76.73684210526316,4 5 7 8 14 15,-1
279,w0,100,1419,5,150,0,COMPLETED_WALLTIME_REACHED,13031,150,13181,11612,11762,78.41333333333333,6 9 10 11 13,-1
280,w0,100,1421,5,152,0,COMPLETED_WALLTIME_REACHED,13041,152,13193,11620,11772,77.44736842105263,0 1 2 3 12,-1
282,w0,100,1425,5,152,0,COMPLETED_WALLTIME_REACHED,13080,152,13232,11655,11807,77.67763157894737,4 5 7 8 14,-1
283,w0,100,1426,4,149,0,COMPLETED_WALLTIME_REACHED,13181,149,13330,11755,11904,79.89261744966443,6 9 10 11,-1
285,w0,100,1430,4,149,0,COMPLETED_WALLTIME_REACHED,13193,149,13342,11763,11912,79.94630872483222,0 1 2 3,-1
306,w0,100,1503,3,147,0,COMPLETED_WALLTIME_REACHED,13193,147,13340,11690,11837,80.52380952380952,12 13 15,-1
287,w0,100,1434,4,149,0,COMPLETED_WALLTIME_REACHED,13232,149,13381,11798,11947,80.18120805369128,4 5 7 8,-1
288,w0,100,1440,6,151,0,COMPLETED_WALLTIME_REACHED,13340,151,13491,11900,12051,79.80794701986756,6 9 10 11 12 13,-1
289,w0,100,1444,4,150,0,COMPLETED_WALLTIME_REACHED,13342,150,13492,11898,12048,80.32,0 1 2 3,-1
291,w0,100,1454,4,153,0,COMPLETED_WALLTIME_REACHED,13381,153,13534,11927,12080,78.95424836601308,4 5 7 8,-1
292,w0,100,1457,4,151,0,COMPLETED_WALLTIME_REACHED,13491,151,13642,12034,12185,80.69536423841059,6 9 10 11,-1
294,w0,100,1464,4,152,0,COMPLETED_WALLTIME_REACHED,13491,152,13643,12027,12179,80.125,12 13 14 15,-1
295,w0,100,1468,4,150,0,COMPLETED_WALLTIME_REACHED,13492,150,13642,12024,12174,81.16,0 1 2 3,-1
298,w0,100,1477,4,149,0,COMPLETED_WALLTIME_REACHED,13534,149,13683,12057,12206,81.91946308724832,4 5 7 8,-1
296,w0,100,1474,6,144,0,COMPLETED_WALLTIME_REACHED,13642,144,13786,12168,12312,85.5,0 1 2 3 6 9,-1
297,w0,100,1476,5,151,0,COMPLETED_WALLTIME_REACHED,13643,151,13794,12167,12318,81.57615894039735,10 11 12 13 14,-1
299,w0,100,1480,4,154,0,COMPLETED_WALLTIME_REACHED,13683,154,13837,12203,12357,80.24025974025975,4 5 7 8,-1
300,w0,100,1486,4,151,0,COMPLETED_WALLTIME_REACHED,13786,151,13937,12300,12451,82.45695364238411,0 1 2 3,-1
308,w0,100,1507,3,151,0,COMPLETED_WALLTIME_REACHED,13786,151,13937,12279,12430,82.31788079470199,6 9 15,-1
301,w0,100,1487,5,148,0,COMPLETED_WALLTIME_REACHED,13794,148,13942,12307,12455,84.1554054054054,10 11 12 13 14,-1
302,w0,100,1491,4,152,0,COMPLETED_WALLTIME_REACHED,13837,152,13989,12346,12498,82.22368421052632,4 5 7 8,-1
303,w0,100,1491,4,151,0,COMPLETED_WALLTIME_REACHED,13937,151,14088,12446,12597,83.42384105960265,0 1 2 3,-1
304,w0,100,1496,7,151,0,COMPLETED_WALLTIME_REACHED,13942,151,14093,12446,12597,83.42384105960265,6 9 10 11 12 13 14,-1
305,w0,100,1502,4,153,0,COMPLETED_WALLTIME_REACHED,13989,153,14142,12487,12640,82.61437908496733,4 5 7 8,-1
307,w0,100,1504,4,151,0,COMPLETED_WALLTIME_REACHED,14088,151,14239,12584,12735,84.33774834437087,0 1 2 3,-1
309,w0,100,1512,4,150,0,COMPLETED_WALLTIME_REACHED,14093,150,14243,12581,12731,84.87333333333333,6 9 10 11,-1
310,w0,100,1539,7,149,0,COMPLETED_WALLTIME_REACHED,14142,149,14291,12603,12752,85.58389261744966,4 5 7 8 12 13 14,-1
312,w0,100,1550,3,147,0,COMPLETED_WALLTIME_REACHED,14239,147,14386,12689,12836,87.31972789115646,0 1 2,-1
311,w0,100,1544,6,151,0,COMPLETED_WALLTIME_REACHED,14243,151,14394,12699,12850,85.09933774834437,3 6 9 10 11 15,-1
313,w0,100,1553,3,148,0,COMPLETED_WALLTIME_REACHED,14291,148,14439,12738,12886,87.06756756756756,4 5 7,-1
314,w0,100,1554,5,150,0,COMPLETED_WALLTIME_REACHED,14386,150,14536,12832,12982,86.54666666666667,0 1 2 8 12,-1
315,w0,100,1559,6,151,0,COMPLETED_WALLTIME_REACHED,14394,151,14545,12835,12986,86.0,3 6 9 10 11 13,-1
316,w0,100,1570,3,151,0,COMPLETED_WALLTIME_REACHED,14439,151,14590,12869,13020,86.2251655629139,4 5 7,-1
317,w0,100,1572,4,149,0,COMPLETED_WALLTIME_REACHED,14536,149,14685,12964,13113,88.00671140939598,0 1 2 8,-1
319,w0,100,1581,3,152,0,COMPLETED_WALLTIME_REACHED,14536,152,14688,12955,13107,86.23026315789474,12 14 15,-1
318,w0,100,1578,5,152,0,COMPLETED_WALLTIME_REACHED,14545,152,14697,12967,13119,86.3092105263158,3 6 9 10 11,-1
320,w0,100,1585,4,145,0,COMPLETED_WALLTIME_REACHED,14590,145,14735,13005,13150,90.6896551724138,4 5 7 13,-1
321,w0,100,1587,4,148,0,COMPLETED_WALLTIME_REACHED,14685,148,14833,13098,13246,89.5,0 1 2 8,-1
324,w0,100,1595,3,148,0,COMPLETED_WALLTIME_REACHED,14688,148,14836,13093,13241,89.46621621621621,12 14 15,-1
322,w0,100,1590,4,149,0,COMPLETED_WALLTIME_REACHED,14697,149,14846,13107,13256,88.96644295302013,3 6 9 10,-1
323,w0,100,1591,4,153,0,COMPLETED_WALLTIME_REACHED,14735,153,14888,13144,13297,86.90849673202614,4 5 7 11,-1
326,w0,100,1606,5,150,0,COMPLETED_WALLTIME_REACHED,14833,150,14983,13227,13377,89.18,0 1 2 8 13,-1
331,w0,100,1626,3,153,0,COMPLETED_WALLTIME_REACHED,14836,153,14989,13210,13363,87.33986928104575,12 14 15,-1
327,w0,100,1613,4,149,0,COMPLETED_WALLTIME_REACHED,14846,149,14995,13233,13382,89.81208053691275,3 6 9 10,-1
328,w0,100,1614,4,147,0,COMPLETED_WALLTIME_REACHED,14888,147,15035,13274,13421,91.29931972789116,4 5 7 11,-1
329,w0,100,1619,4,152,0,COMPLETED_WALLTIME_REACHED,14983,152,15135,13364,13516,88.92105263157895,0 1 2 8,-1
330,w0,100,1625,4,151,0,COMPLETED_WALLTIME_REACHED,14989,151,15140,13364,13515,89.50331125827815,12 13 14 15,-1
332,w0,100,1627,6,151,0,COMPLETED_WALLTIME_REACHED,15035,151,15186,13408,13559,89.79470198675497,3 4 5 6 7 9,-1
333,w0,100,1632,3,149,0,COMPLETED_WALLTIME_REACHED,15135,149,15284,13503,13652,91.6241610738255,0 1 2,-1
334,w0,100,1639,5,148,0,COMPLETED_WALLTIME_REACHED,15140,148,15288,13501,13649,92.22297297297297,8 10 11 12 13,-1
335,w0,100,1649,5,148,0,COMPLETED_WALLTIME_REACHED,15186,148,15334,13537,13685,92.46621621621621,3 4 5 6 7,-1
336,w0,100,1654,4,148,0,COMPLETED_WALLTIME_REACHED,15284,148,15432,13630,13778,93.0945945945946,0 1 2 9,-1
337,w0,100,1655,4,146,0,COMPLETED_WALLTIME_REACHED,15288,146,15434,13633,13779,94.37671232876713,8 10 11 12,-1
341,w0,100,1698,3,149,0,COMPLETED_WALLTIME_REACHED,15288,149,15437,13590,13739,92.20805369127517,13 14 15,-1
338,w0,100,1680,5,149,0,COMPLETED_WALLTIME_REACHED,15334,149,15483,13654,13803,92.63758389261746,3 4 5 6 7,-1
339,w0,100,1692,4,150,0,COMPLETED_WALLTIME_REACHED,15432,150,15582,13740,13890,92.6,0 1 2 9,-1
340,w0,100,1695,6,149,0,COMPLETED_WALLTIME_REACHED,15437,149,15586,13742,13891,93.22818791946308,8 10 11 12 13 14,-1
342,w0,100,1700,3,149,0,COMPLETED_WALLTIME_REACHED,15483,149,15632,13783,13932,93.50335570469798,3 4 5,-1
343,w0,100,1701,6,149,0,COMPLETED_WALLTIME_REACHED,15582,149,15731,13881,14030,94.16107382550335,0 1 2 6 7 9,-1
344,w0,100,1701,5,151,0,COMPLETED_WALLTIME_REACHED,15586,151,15737,13885,14036,92.95364238410596,8 10 11 12 13,-1
347,w0,100,1719,5,153,0,COMPLETED_WALLTIME_REACHED,15632,153,15785,13913,14066,91.93464052287581,3 4 5 14 15,-1
345,w0,100,1703,6,151,0,COMPLETED_WALLTIME_REACHED,15731,151,15882,14028,14179,93.90066225165563,0 1 2 6 7 9,-1
348,w0,100,1724,4,151,0,COMPLETED_WALLTIME_REACHED,15737,151,15888,14013,14164,93.80132450331126,8 10 11 12,-1
346,w0,100,1717,6,152,0,COMPLETED_WALLTIME_REACHED,15785,152,15937,14068,14220,93.55263157894737,3 4 5 13 14 15,-1
349,w0,100,1728,5,146,0,COMPLETED_WALLTIME_REACHED,15882,146,16028,14154,14300,97.94520547945206,0 1 2 6 7,-1
350,w0,100,1733,5,150,0,COMPLETED_WALLTIME_REACHED,15888,150,16038,14155,14305,95.36666666666666,8 9 10 11 12,-1
351,w0,100,1734,5,152,0,COMPLETED_WALLTIME_REACHED,15937,152,16089,14203,14355,94.4407894736842,3 4 5 13 14,-1
352,w0,100,1740,5,148,0,COMPLETED_WALLTIME_REACHED,16028,148,16176,14288,14436,97.54054054054055,0 1 2 6 7,-1
353,w0,100,1743,4,151,0,COMPLETED_WALLTIME_REACHED,16038,151,16189,14295,14446,95.66887417218543,8 9 10 11,-1
354,w0,100,1745,5,150,0,COMPLETED_WALLTIME_REACHED,16089,150,16239,14344,14494,96.62666666666667,3 4 5 12 13,-1
355,w0,100,1747,3,150,0,COMPLETED_WALLTIME_REACHED,16176,150,16326,14429,14579,97.19333333333333,0 1 2,-1
356,w0,100,1758,4,153,0,COMPLETED_WALLTIME_REACHED,16176,153,16329,14418,14571,95.23529411764706,6 7 14 15,-1
357,w0,100,1765,4,153,0,COMPLETED_WALLTIME_REACHED,16189,153,16342,14424,14577,95.27450980392157,8 9 10 11,-1
358,w0,100,1765,4,145,0,COMPLETED_WALLTIME_REACHED,16239,145,16384,14474,14619,100.82068965517242,3 4 5 12,-1
359,w0,100,1774,7,151,0,COMPLETED_WALLTIME_REACHED,16329,151,16480,14555,14706,97.3907284768212,0 1 2 6 7 13 14,-1
360,w0,100,1775,5,151,0,COMPLETED_WALLTIME_REACHED,16342,151,16493,14567,14718,97.47019867549669,8 9 10 11 15,-1
362,w0,100,1787,3,150,0,COMPLETED_WALLTIME_REACHED,16384,150,16534,14597,14747,98.31333333333333,3 4 5,-1
361,w0,100,1779,6,152,0,COMPLETED_WALLTIME_REACHED,16480,152,16632,14701,14853,97.71710526315789,0 1 2 6 7 12,-1
363,w0,100,1793,3,150,0,COMPLETED_WALLTIME_REACHED,16493,150,16643,14700,14850,99.0,8 9 10,-1
364,w0,100,1794,5,150,0,COMPLETED_WALLTIME_REACHED,16534,150,16684,14740,14890,99.26666666666667,3 4 5 11 13,-1
365,w0,100,1794,6,152,0,COMPLETED_WALLTIME_REACHED,16632,152,16784,14838,14990,98.61842105263158,0 1 2 6 7 12,-1
366,w0,100,1827,3,153,0,COMPLETED_WALLTIME_REACHED,16643,153,16796,14816,14969,97.83660130718954,8 9 10,-1
367,w0,100,1828,3,147,0,COMPLETED_WALLTIME_REACHED,16684,147,16831,14856,15003,102.06122448979592,3 4 5,-1
370,w0,100,1834,4,152,0,COMPLETED_WALLTIME_REACHED,16684,152,16836,14850,15002,98.69736842105263,11 13 14 15,-1
368,w0,100,1829,6,151,0,COMPLETED_WALLTIME_REACHED,16784,151,16935,14955,15106,100.03973509933775,0 1 2 6 7 12,-1
369,w0,100,1829,5,151,0,COMPLETED_WALLTIME_REACHED,16831,151,16982,15002,15153,100.35099337748345,3 4 5 8 9,-1
371,w0,100,1839,4,146,0,COMPLETED_WALLTIME_REACHED,16836,146,16982,14997,15143,103.71917808219177,10 11 13 14,-1
372,w0,100,1846,4,149,0,COMPLETED_WALLTIME_REACHED,16935,149,17084,15089,15238,102.26845637583892,0 1 2 6,-1
373,w0,100,1851,3,153,0,COMPLETED_WALLTIME_REACHED,16935,153,17088,15084,15237,99.58823529411765,7 12 15,-1
374,w0,100,1851,5,148,0,COMPLETED_WALLTIME_REACHED,16982,148,17130,15131,15279,103.23648648648648,3 4 5 8 9,-1
375,w0,100,1853,6,152,0,COMPLETED_WALLTIME_REACHED,17084,152,17236,15231,15383,101.20394736842105,0 1 2 6 10 11,-1
376,w0,100,1853,4,147,0,COMPLETED_WALLTIME_REACHED,17088,147,17235,15235,15382,104.63945578231292,7 12 13 14,-1
377,w0,100,1856,4,149,0,COMPLETED_WALLTIME_REACHED,17130,149,17279,15274,15423,103.51006711409396,3 4 5 8,-1
378,w0,100,1890,6,149,0,COMPLETED_WALLTIME_REACHED,17235,149,17384,15345,15494,103.98657718120805,7 9 12 13 14 15,-1
387,w0,100,1935,3,147,0,COMPLETED_WALLTIME_REACHED,17236,147,17383,15301,15448,105.08843537414965,0 1 2,-1
379,w0,100,1890,7,152,0,COMPLETED_WALLTIME_REACHED,17279,152,17431,15389,15541,102.24342105263158,3 4 5 6 8 10 11,-1
389,w0,100,1939,3,148,0,COMPLETED_WALLTIME_REACHED,17383,148,17531,15444,15592,105.35135135135135,0 1 2,-1
380,w0,100,1891,4,152,0,COMPLETED_WALLTIME_REACHED,17384,152,17536,15493,15645,102.92763157894737,7 9 12 13,-1
381,w0,100,1900,5,154,0,COMPLETED_WALLTIME_REACHED,17431,154,17585,15531,15685,101.85064935064935,3 4 5 6 8,-1
383,w0,100,1902,5,151,0,COMPLETED_WALLTIME_REACHED,17531,151,17682,15629,15780,104.50331125827815,0 1 2 10 11,-1
384,w0,100,1914,4,154,0,COMPLETED_WALLTIME_REACHED,17536,154,17690,15622,15776,102.44155844155844,7 9 12 13,-1
385,w0,100,1917,4,152,0,COMPLETED_WALLTIME_REACHED,17585,152,17737,15668,15820,104.07894736842105,3 4 5 6,-1
394,w0,100,1983,3,150,0,COMPLETED_WALLTIME_REACHED,17585,150,17735,15602,15752,105.01333333333334,8 14 15,-1
386,w0,100,1920,5,150,0,COMPLETED_WALLTIME_REACHED,17682,150,17832,15762,15912,106.08,0 1 2 10 11,-1
388,w0,100,1935,5,152,0,COMPLETED_WALLTIME_REACHED,17735,152,17887,15800,15952,104.94736842105263,7 8 9 12 13,-1
390,w0,100,1947,5,150,0,COMPLETED_WALLTIME_REACHED,17737,150,17887,15790,15940,106.26666666666667,3 4 5 6 14,-1
391,w0,100,1948,4,148,0,COMPLETED_WALLTIME_REACHED,17832,148,17980,15884,16032,108.32432432432432,0 1 2 10,-1
392,w0,100,1957,5,151,0,COMPLETED_WALLTIME_REACHED,17887,151,18038,15930,16081,106.49668874172185,3 4 5 6 7,-1
393,w0,100,1962,5,149,0,COMPLETED_WALLTIME_REACHED,17887,149,18036,15925,16074,107.87919463087249,8 9 11 12 13,-1
395,w0,100,1988,5,152,0,COMPLETED_WALLTIME_REACHED,17980,152,18132,15992,16144,106.21052631578948,0 1 2 10 14,-1
396,w0,100,1990,4,153,0,COMPLETED_WALLTIME_REACHED,18036,153,18189,16046,16199,105.87581699346406,8 9 11 12,-1
397,w0,100,1991,5,150,0,COMPLETED_WALLTIME_REACHED,18038,150,18188,16047,16197,107.98,3 4 5 6 7,-1
398,w0,100,2012,3,150,0,COMPLETED_WALLTIME_REACHED,18132,150,18282,16120,16270,108.46666666666667,0 1 2,-1
399,w0,100,2021,3,151,0,COMPLETED_WALLTIME_REACHED,18132,151,18283,16111,16262,107.69536423841059,10 13 14,-1
400,w0,100,2023,4,147,0,COMPLETED_WALLTIME_REACHED,18188,147,18335,16165,16312,110.96598639455782,3 4 5 6,-1
401,w0,100,2023,6,152,0,COMPLETED_WALLTIME_REACHED,18189,152,18341,16166,16318,107.35526315789474,7 8 9 11 12 15,-1
402,w0,100,2028,4,150,0,COMPLETED_WALLTIME_REACHED,18283,150,18433,16255,16405,109.36666666666666,0 1 2 10,-1
403,w0,100,2030,3,149,0,COMPLETED_WALLTIME_REACHED,18335,149,18484,16305,16454,110.42953020134229,3 4 5,-1
413,w0,100,2066,3,146,0,COMPLETED_WALLTIME_REACHED,18335,146,18481,16269,16415,112.43150684931507,6 13 14,-1
404,w0,100,2030,5,151,0,COMPLETED_WALLTIME_REACHED,18341,151,18492,16311,16462,109.01986754966887,7 8 9 11 12,-1
406,w0,100,2034,4,150,0,COMPLETED_WALLTIME_REACHED,18433,150,18583,16399,16549,110.32666666666667,0 1 2 10,-1
407,w0,100,2038,4,152,0,COMPLETED_WALLTIME_REACHED,18481,152,18633,16443,16595,109.17763157894737,6 13 14 15,-1
408,w0,100,2044,6,146,0,COMPLETED_WALLTIME_REACHED,18492,146,18638,16448,16594,113.65753424657534,3 4 5 7 8 9,-1
409,w0,100,2050,5,148,0,COMPLETED_WALLTIME_REACHED,18583,148,18731,16533,16681,112.70945945945945,0 1 2 10 11,-1
410,w0,100,2050,4,153,0,COMPLETED_WALLTIME_REACHED,18633,153,18786,16583,16736,109.38562091503267,6 12 13 14,-1
411,w0,100,2054,4,149,0,COMPLETED_WALLTIME_REACHED,18638,149,18787,16584,16733,112.30201342281879,3 4 5 7,-1
441,w0,100,2216,3,151,0,COMPLETED_WALLTIME_REACHED,18638,151,18789,16422,16573,109.75496688741723,8 9 15,-1
412,w0,100,2063,5,153,0,COMPLETED_WALLTIME_REACHED,18731,153,18884,16668,16821,109.94117647058823,0 1 2 10 11,-1
414,w0,100,2070,4,152,0,COMPLETED_WALLTIME_REACHED,18786,152,18938,16716,16868,110.97368421052632,6 12 13 14,-1
415,w0,100,2077,7,149,0,COMPLETED_WALLTIME_REACHED,18789,149,18938,16712,16861,113.16107382550335,3 4 5 7 8 9 15,-1
417,w0,100,2086,4,151,0,COMPLETED_WALLTIME_REACHED,18884,151,19035,16798,16949,112.24503311258277,0 1 2 10,-1
418,w0,100,2094,4,151,0,COMPLETED_WALLTIME_REACHED,18938,151,19089,16844,16995,112.54966887417218,3 4 5 6,-1
419,w0,100,2098,5,148,0,COMPLETED_WALLTIME_REACHED,18938,148,19086,16840,16988,114.78378378378379,7 8 9 11 12,-1
420,w0,100,2109,5,149,0,COMPLETED_WALLTIME_REACHED,19035,149,19184,16926,17075,114.59731543624162,0 1 2 10 13,-1
421,w0,100,2109,5,149,0,COMPLETED_WALLTIME_REACHED,19086,149,19235,16977,17126,114.93959731543625,7 8 9 11 12,-1
422,w0,100,2113,4,148,0,COMPLETED_WALLTIME_REACHED,19089,148,19237,16976,17124,115.70270270270271,3 4 5 6,-1
423,w0,100,2116,5,151,0,COMPLETED_WALLTIME_REACHED,19184,151,19335,17068,17219,114.03311258278146,0 1 2 10 13,-1
424,w0,100,2117,4,151,0,COMPLETED_WALLTIME_REACHED,19235,151,19386,17118,17269,114.36423841059603,7 8 9 11,-1
449,w0,100,2253,3,154,0,COMPLETED_WALLTIME_REACHED,19235,154,19389,16982,17136,111.27272727272727,12 14 15,-1
425,w0,100,2117,4,152,0,COMPLETED_WALLTIME_REACHED,19237,152,19389,17120,17272,113.63157894736842,3 4 5 6,-1
426,w0,100,2127,4,152,0,COMPLETED_WALLTIME_REACHED,19335,152,19487,17208,17360,114.21052631578948,0 1 2 10,-1
427,w0,100,2141,5,152,0,COMPLETED_WALLTIME_REACHED,19386,152,19538,17245,17397,114.45394736842105,7 8 9 11 13,-1
428,w0,100,2152,6,145,0,COMPLETED_WALLTIME_REACHED,19389,145,19534,17237,17382,119.87586206896552,3 4 5 6 12 14,-1
429,w0,100,2154,5,150,0,COMPLETED_WALLTIME_REACHED,19487,150,19637,17333,17483,116.55333333333333,0 1 2 10 15,-1
430,w0,100,2163,5,149,0,COMPLETED_WALLTIME_REACHED,19534,149,19683,17371,17520,117.58389261744966,3 4 5 6 12,-1
431,w0,100,2170,4,149,0,COMPLETED_WALLTIME_REACHED,19538,149,19687,17368,17517,117.56375838926175,7 8 9 11,-1
432,w0,100,2173,6,148,0,COMPLETED_WALLTIME_REACHED,19637,148,19785,17464,17612,119.0,0 1 2 10 13 14,-1
433,w0,100,2180,4,149,0,COMPLETED_WALLTIME_REACHED,19683,149,19832,17503,17652,118.46979865771812,3 4 5 6,-1
434,w0,100,2188,5,154,0,COMPLETED_WALLTIME_REACHED,19687,154,19841,17499,17653,114.62987012987013,7 8 9 11 12,-1
435,w0,100,2196,7,146,0,COMPLETED_WALLTIME_REACHED,19785,146,19931,17589,17735,121.47260273972603,0 1 2 10 13 14 15,-1
450,w0,100,2256,3,149,0,COMPLETED_WALLTIME_REACHED,19832,149,19981,17576,17725,118.95973154362416,3 4 5,-1
436,w0,100,2198,6,151,0,COMPLETED_WALLTIME_REACHED,19841,151,19992,17643,17794,117.84105960264901,6 7 8 9 11 12,-1
437,w0,100,2201,4,150,0,COMPLETED_WALLTIME_REACHED,19931,150,20081,17730,17880,119.2,0 1 2 10,-1
438,w0,100,2201,4,150,0,COMPLETED_WALLTIME_REACHED,19981,150,20131,17780,17930,119.53333333333333,3 4 5 13,-1
439,w0,100,2210,5,147,0,COMPLETED_WALLTIME_REACHED,19992,147,20139,17782,17929,121.96598639455782,6 7 8 9 11,-1
440,w0,100,2213,5,153,0,COMPLETED_WALLTIME_REACHED,20081,153,20234,17868,18021,117.7843137254902,0 1 2 10 12,-1
442,w0,100,2222,4,148,0,COMPLETED_WALLTIME_REACHED,20131,148,20279,17909,18057,122.00675675675676,3 4 5 13,-1
444,w0,100,2228,6,151,0,COMPLETED_WALLTIME_REACHED,20139,151,20290,17911,18062,119.6158940397351,6 7 8 9 11 14,-1
445,w0,100,2236,4,149,0,COMPLETED_WALLTIME_REACHED,20234,149,20383,17998,18147,121.79194630872483,0 1 2 10,-1
446,w0,100,2240,5,149,0,COMPLETED_WALLTIME_REACHED,20279,149,20428,18039,18188,122.06711409395973,3 4 5 12 13,-1
447,w0,100,2242,4,151,0,COMPLETED_WALLTIME_REACHED,20290,151,20441,18048,18199,120.52317880794702,6 7 8 9,-1
448,w0,100,2243,6,149,0,COMPLETED_WALLTIME_REACHED,20383,149,20532,18140,18289,122.74496644295301,0 1 2 10 11 14,-1
451,w0,100,2257,4,149,0,COMPLETED_WALLTIME_REACHED,20428,149,20577,18171,18320,122.95302013422818,3 4 5 12,-1
452,w0,100,2259,4,152,0,COMPLETED_WALLTIME_REACHED,20441,152,20593,18182,18334,120.61842105263158,6 7 8 9,-1
453,w0,100,2262,6,150,0,COMPLETED_WALLTIME_REACHED,20532,150,20682,18270,18420,122.8,0 1 2 10 11 13,-1
454,w0,100,2268,6,149,0,COMPLETED_WALLTIME_REACHED,20577,149,20726,18309,18458,123.87919463087249,3 4 5 12 14 15,-1
458,w0,100,2283,4,149,0,COMPLETED_WALLTIME_REACHED,20593,149,20742,18310,18459,123.88590604026845,6 7 8 9,-1
455,w0,100,2269,6,149,0,COMPLETED_WALLTIME_REACHED,20682,149,20831,18413,18562,124.57718120805369,0 1 2 10 11 13,-1
456,w0,100,2270,6,152,0,COMPLETED_WALLTIME_REACHED,20726,152,20878,18456,18608,122.42105263157895,3 4 5 12 14 15,-1
462,w0,100,2299,4,151,0,COMPLETED_WALLTIME_REACHED,20742,151,20893,18443,18594,123.13907284768212,6 7 8 9,-1
457,w0,100,2272,5,151,0,COMPLETED_WALLTIME_REACHED,20831,151,20982,18559,18710,123.90728476821192,0 1 2 10 11,-1
459,w0,100,2288,5,148,0,COMPLETED_WALLTIME_REACHED,20878,148,21026,18590,18738,126.60810810810811,3 4 5 12 13,-1
460,w0,100,2290,6,149,0,COMPLETED_WALLTIME_REACHED,20893,149,21042,18603,18752,125.85234899328859,6 7 8 9 14 15,-1
461,w0,100,2292,5,154,0,COMPLETED_WALLTIME_REACHED,20982,154,21136,18690,18844,122.36363636363636,0 1 2 10 11,-1
464,w0,100,2302,4,150,0,COMPLETED_WALLTIME_REACHED,21026,150,21176,18724,18874,125.82666666666667,3 4 5 12,-1
463,w0,100,2299,6,147,0,COMPLETED_WALLTIME_REACHED,21042,147,21189,18743,18890,128.50340136054422,6 7 8 9 13 14,-1
465,w0,100,2310,3,150,0,COMPLETED_WALLTIME_REACHED,21136,150,21286,18826,18976,126.50666666666666,0 1 2,-1
466,w0,100,2316,5,148,0,COMPLETED_WALLTIME_REACHED,21176,148,21324,18860,19008,128.43243243243242,3 4 5 10 11,-1
467,w0,100,2318,4,147,0,COMPLETED_WALLTIME_REACHED,21189,147,21336,18871,19018,129.37414965986395,6 7 8 9,-1
468,w0,100,2325,3,147,0,COMPLETED_WALLTIME_REACHED,21189,147,21336,18864,19011,129.3265306122449,12 13 14,-1
469,w0,100,2345,4,149,0,COMPLETED_WALLTIME_REACHED,21286,149,21435,18941,19090,128.1208053691275,0 1 2 15,-1
471,w0,100,2357,5,150,0,COMPLETED_WALLTIME_REACHED,21324,150,21474,18967,19117,127.44666666666667,3 4 5 10 11,-1
470,w0,100,2349,7,147,0,COMPLETED_WALLTIME_REACHED,21336,147,21483,18987,19134,130.16326530612244,6 7 8 9 12 13 14,-1
479,w0,100,2407,3,150,0,COMPLETED_WALLTIME_REACHED,21435,150,21585,19028,19178,127.85333333333334,0 1 2,-1
472,w0,100,2381,5,152,0,COMPLETED_WALLTIME_REACHED,21474,152,21626,19093,19245,126.61184210526316,3 4 5 10 11,-1
473,w0,100,2381,7,152,0,COMPLETED_WALLTIME_REACHED,21483,152,21635,19102,19254,126.67105263157895,6 7 8 9 12 13 14,-1
480,w0,100,2415,4,151,0,COMPLETED_WALLTIME_REACHED,21585,151,21736,19170,19321,127.95364238410596,0 1 2 15,-1
474,w0,100,2382,5,151,0,COMPLETED_WALLTIME_REACHED,21626,151,21777,19244,19395,128.4437086092715,3 4 5 10 11,-1
475,w0,100,2392,5,148,0,COMPLETED_WALLTIME_REACHED,21635,148,21783,19243,19391,131.02027027027026,6 7 8 9 12,-1
476,w0,100,2399,5,146,0,COMPLETED_WALLTIME_REACHED,21736,146,21882,19337,19483,133.44520547945206,0 1 2 13 14,-1
477,w0,100,2402,5,148,0,COMPLETED_WALLTIME_REACHED,21777,148,21925,19375,19523,131.91216216216216,3 4 5 10 11,-1
478,w0,100,2407,5,151,0,COMPLETED_WALLTIME_REACHED,21783,151,21934,19376,19527,129.31788079470198,6 7 8 9 12,-1
481,w0,100,2422,6,149,0,COMPLETED_WALLTIME_REACHED,21882,149,22031,19460,19609,131.60402684563758,0 1 2 13 14 15,-1
482,w0,100,2427,4,148,0,COMPLETED_WALLTIME_REACHED,21925,148,22073,19498,19646,132.74324324324326,3 4 5 10,-1
483,w0,100,2429,5,150,0,COMPLETED_WALLTIME_REACHED,21934,150,22084,19505,19655,131.03333333333333,6 7 8 9 11,-1
484,w0,100,2430,6,151,0,COMPLETED_WALLTIME_REACHED,22031,151,22182,19601,19752,130.80794701986756,0 1 2 12 13 14,-1
486,w0,100,2435,4,149,0,COMPLETED_WALLTIME_REACHED,22073,149,22222,19638,19787,132.7986577181208,3 4 5 10,-1
485,w0,100,2434,6,151,0,COMPLETED_WALLTIME_REACHED,22084,151,22235,19650,19801,131.13245033112582,6 7 8 9 11 15,-1
487,w0,100,2437,4,150,0,COMPLETED_WALLTIME_REACHED,22182,150,22332,19745,19895,132.63333333333333,0 1 2 12,-1
488,w0,100,2446,5,149,0,COMPLETED_WALLTIME_REACHED,22222,149,22371,19776,19925,133.7248322147651,3 4 5 10 13,-1
489,w0,100,2468,4,148,0,COMPLETED_WALLTIME_REACHED,22235,148,22383,19767,19915,134.5608108108108,6 7 8 9,-1
490,w0,100,2474,3,147,0,COMPLETED_WALLTIME_REACHED,22235,147,22382,19761,19908,135.42857142857142,11 14 15,-1
493,w0,100,2489,4,150,0,COMPLETED_WALLTIME_REACHED,22332,150,22482,19843,19993,133.28666666666666,0 1 2 12,-1
491,w0,100,2483,5,147,0,COMPLETED_WALLTIME_REACHED,22371,147,22518,19888,20035,136.2925170068027,3 4 5 10 13,-1
492,w0,100,2485,5,147,0,COMPLETED_WALLTIME_REACHED,22383,147,22530,19898,20045,136.36054421768708,6 7 8 9 11,-1
495,w0,100,2505,5,152,0,COMPLETED_WALLTIME_REACHED,22482,152,22634,19977,20129,132.42763157894737,0 1 2 12 14,-1
496,w0,100,2505,5,149,0,COMPLETED_WALLTIME_REACHED,22518,149,22667,20013,20162,135.31543624161074,3 4 5 10 13,-1
497,w0,100,2511,5,147,0,COMPLETED_WALLTIME_REACHED,22530,147,22677,20019,20166,137.18367346938774,6 7 8 9 11,-1
498,w0,100,2513,6,149,0,COMPLETED_WALLTIME_REACHED,22634,149,22783,20121,20270,136.04026845637583,0 1 2 12 14 15,-1
501,w0,100,2523,5,151,0,COMPLETED_WALLTIME_REACHED,22667,151,22818,20144,20295,134.40397350993376,3 4 5 10 13,-1
502,w0,100,2525,5,153,0,COMPLETED_WALLTIME_REACHED,22677,153,22830,20152,20305,132.71241830065358,6 7 8 9 11,-1
503,w0,100,2527,4,149,0,COMPLETED_WALLTIME_REACHED,22783,149,22932,20256,20405,136.94630872483222,0 1 2 12,-1
504,w0,100,2531,4,148,0,COMPLETED_WALLTIME_REACHED,22818,148,22966,20287,20435,138.07432432432432,3 4 5 10,-1
511,w0,100,2560,3,146,0,COMPLETED_WALLTIME_REACHED,22818,146,22964,20258,20404,139.75342465753425,13 14 15,-1
505,w0,100,2532,5,151,0,COMPLETED_WALLTIME_REACHED,22830,151,22981,20298,20449,135.42384105960264,6 7 8 9 11,-1
506,w0,100,2533,4,151,0,COMPLETED_WALLTIME_REACHED,22932,151,23083,20399,20550,136.09271523178808,0 1 2 12,-1
516,w0,100,2591,3,149,0,COMPLETED_WALLTIME_REACHED,22964,149,23113,20373,20522,137.73154362416108,13 14 15,-1
507,w0,100,2541,4,148,0,COMPLETED_WALLTIME_REACHED,22966,148,23114,20425,20573,139.00675675675674,3 4 5 10,-1
508,w0,100,2548,5,156,0,COMPLETED_WALLTIME_REACHED,22981,156,23137,20433,20589,131.98076923076923,6 7 8 9 11,-1
509,w0,100,2553,4,150,0,COMPLETED_WALLTIME_REACHED,23083,150,23233,20530,20680,137.86666666666667,0 1 2 12,-1
510,w0,100,2557,5,149,0,COMPLETED_WALLTIME_REACHED,23114,149,23263,20557,20706,138.96644295302013,3 4 5 10 13,-1
512,w0,100,2560,6,150,0,COMPLETED_WALLTIME_REACHED,23137,150,23287,20577,20727,138.18,6 7 8 9 11 14,-1
513,w0,100,2573,4,147,0,COMPLETED_WALLTIME_REACHED,23233,147,23380,20660,20807,141.54421768707482,0 1 2 12,-1
514,w0,100,2575,4,150,0,COMPLETED_WALLTIME_REACHED,23263,150,23413,20688,20838,138.92,3 4 5 10,-1
515,w0,100,2575,5,144,0,COMPLETED_WALLTIME_REACHED,23287,144,23431,20712,20856,144.83333333333334,6 7 8 9 11,-1
517,w0,100,2595,6,150,0,COMPLETED_WALLTIME_REACHED,23380,150,23530,20785,20935,139.56666666666666,0 1 2 12 13 14,-1
519,w0,100,2613,4,145,0,COMPLETED_WALLTIME_REACHED,23413,145,23558,20800,20945,144.44827586206895,3 4 5 10,-1
518,w0,100,2603,6,148,0,COMPLETED_WALLTIME_REACHED,23431,148,23579,20828,20976,141.72972972972974,6 7 8 9 11 15,-1
520,w0,100,2618,5,150,0,COMPLETED_WALLTIME_REACHED,23530,150,23680,20912,21062,140.41333333333333,0 1 2 12 13,-1
521,w0,100,2625,5,147,0,COMPLETED_WALLTIME_REACHED,23558,147,23705,20933,21080,143.40136054421768,3 4 5 10 14,-1
522,w0,100,2626,4,149,0,COMPLETED_WALLTIME_REACHED,23579,149,23728,20953,21102,141.6241610738255,6 7 8 9,-1
523,w0,100,2631,4,151,0,COMPLETED_WALLTIME_REACHED,23680,151,23831,21049,21200,140.39735099337747,0 1 2 11,-1
527,w0,100,2638,3,151,0,COMPLETED_WALLTIME_REACHED,23680,151,23831,21042,21193,140.35099337748343,12 13 15,-1
524,w0,100,2634,5,152,0,COMPLETED_WALLTIME_REACHED,23705,152,23857,21071,21223,139.625,3 4 5 10 14,-1
525,w0,100,2635,4,152,0,COMPLETED_WALLTIME_REACHED,23728,152,23880,21093,21245,139.76973684210526,6 7 8 9,-1
526,w0,100,2638,4,152,0,COMPLETED_WALLTIME_REACHED,23831,152,23983,21193,21345,140.42763157894737,0 1 2 11,-1
528,w0,100,2643,7,150,0,COMPLETED_WALLTIME_REACHED,23857,150,24007,21214,21364,142.42666666666668,3 4 5 10 12 13 14,-1
529,w0,100,2645,4,154,0,COMPLETED_WALLTIME_REACHED,23880,154,24034,21235,21389,138.8896103896104,6 7 8 9,-1
530,w0,100,2652,5,148,0,COMPLETED_WALLTIME_REACHED,23983,148,24131,21331,21479,145.1283783783784,0 1 2 11 15,-1
531,w0,100,2655,4,156,0,COMPLETED_WALLTIME_REACHED,24007,156,24163,21352,21508,137.87179487179486,3 4 5 10,-1
532,w0,100,2656,3,154,0,COMPLETED_WALLTIME_REACHED,24007,154,24161,21351,21505,139.64285714285714,12 13 14,-1
533,w0,100,2661,4,148,0,COMPLETED_WALLTIME_REACHED,24034,148,24182,21373,21521,145.41216216216216,6 7 8 9,-1
534,w0,100,2661,4,149,0,COMPLETED_WALLTIME_REACHED,24131,149,24280,21470,21619,145.09395973154363,0 1 2 11,-1
555,w0,100,2764,3,150,0,COMPLETED_WALLTIME_REACHED,24161,150,24311,21397,21547,143.64666666666668,12 13 14,-1
535,w0,100,2665,5,151,0,COMPLETED_WALLTIME_REACHED,24163,151,24314,21498,21649,143.3708609271523,3 4 5 10 15,-1
556,w0,100,2765,3,153,0,COMPLETED_WALLTIME_REACHED,24182,153,24335,21417,21570,140.98039215686273,6 7 8,-1
536,w0,100,2684,5,150,0,COMPLETED_WALLTIME_REACHED,24280,150,24430,21596,21746,144.97333333333333,0 1 2 9 11,-1
560,w0,100,2771,3,150,0,COMPLETED_WALLTIME_REACHED,24311,150,24461,21540,21690,144.6,12 13 14,-1
537,w0,100,2692,5,153,0,COMPLETED_WALLTIME_REACHED,24314,153,24467,21622,21775,142.3202614379085,3 4 5 10 15,-1
561,w0,100,2773,3,151,0,COMPLETED_WALLTIME_REACHED,24335,151,24486,21562,21713,143.79470198675497,6 7 8,-1
538,w0,100,2696,5,149,0,COMPLETED_WALLTIME_REACHED,24430,149,24579,21734,21883,146.86577181208054,0 1 2 9 11,-1
566,w0,100,2798,3,149,0,COMPLETED_WALLTIME_REACHED,24461,149,24610,21663,21812,146.38926174496643,12 13 14,-1
539,w0,100,2698,4,150,0,COMPLETED_WALLTIME_REACHED,24467,150,24617,21769,21919,146.12666666666667,3 4 5 10,-1
541,w0,100,2703,4,148,0,COMPLETED_WALLTIME_REACHED,24486,148,24634,21783,21931,148.18243243243242,6 7 8 15,-1
543,w0,100,2725,5,149,0,COMPLETED_WALLTIME_REACHED,24579,149,24728,21854,22003,147.6711409395973,0 1 2 9 11,-1
569,w0,100,2815,3,148,0,COMPLETED_WALLTIME_REACHED,24610,148,24758,21795,21943,148.26351351351352,12 13 14,-1
544,w0,100,2728,4,151,0,COMPLETED_WALLTIME_REACHED,24617,151,24768,21889,22040,145.96026490066225,3 4 5 10,-1
545,w0,100,2733,4,151,0,COMPLETED_WALLTIME_REACHED,24634,151,24785,21901,22052,146.03973509933775,6 7 8 15,-1
546,w0,100,2737,5,151,0,COMPLETED_WALLTIME_REACHED,24728,151,24879,21991,22142,146.63576158940398,0 1 2 9 11,-1
547,w0,100,2742,5,153,0,COMPLETED_WALLTIME_REACHED,24768,153,24921,22026,22179,144.9607843137255,3 4 5 10 12,-1
548,w0,100,2748,5,151,0,COMPLETED_WALLTIME_REACHED,24785,151,24936,22037,22188,146.94039735099338,6 7 8 13 14,-1
549,w0,100,2750,4,150,0,COMPLETED_WALLTIME_REACHED,24879,150,25029,22129,22279,148.52666666666667,0 1 2 9,-1
550,w0,100,2751,5,151,0,COMPLETED_WALLTIME_REACHED,24921,151,25072,22170,22321,147.82119205298014,3 4 5 10 11,-1
551,w0,100,2753,5,150,0,COMPLETED_WALLTIME_REACHED,24936,150,25086,22183,22333,148.88666666666666,6 7 8 12 13,-1
552,w0,100,2759,4,154,0,COMPLETED_WALLTIME_REACHED,25029,154,25183,22270,22424,145.6103896103896,0 1 2 9,-1
554,w0,100,2761,5,148,0,COMPLETED_WALLTIME_REACHED,25072,148,25220,22311,22459,151.75,3 4 5 10 11,-1
557,w0,100,2766,4,149,0,COMPLETED_WALLTIME_REACHED,25086,149,25235,22320,22469,150.7986577181208,6 7 8 12,-1
558,w0,100,2767,6,154,0,COMPLETED_WALLTIME_REACHED,25183,154,25337,22416,22570,146.55844155844156,0 1 2 9 13 14,-1
559,w0,100,2770,5,152,0,COMPLETED_WALLTIME_REACHED,25220,152,25372,22450,22602,148.69736842105263,3 4 5 10 11,-1
562,w0,100,2783,4,154,0,COMPLETED_WALLTIME_REACHED,25235,154,25389,22452,22606,146.7922077922078,6 7 8 12,-1
563,w0,100,2785,5,147,0,COMPLETED_WALLTIME_REACHED,25337,147,25484,22552,22699,154.41496598639455,0 1 2 9 13,-1
564,w0,100,2789,5,151,0,COMPLETED_WALLTIME_REACHED,25372,151,25523,22583,22734,150.5562913907285,3 4 5 10 11,-1
565,w0,100,2793,4,150,0,COMPLETED_WALLTIME_REACHED,25389,150,25539,22596,22746,151.64,6 7 8 12,-1
567,w0,100,2814,5,151,0,COMPLETED_WALLTIME_REACHED,25484,151,25635,22670,22821,151.13245033112582,0 1 2 9 13,-1
568,w0,100,2815,4,149,0,COMPLETED_WALLTIME_REACHED,25523,149,25672,22708,22857,153.40268456375838,3 4 5 10,-1
570,w0,100,2825,5,148,0,COMPLETED_WALLTIME_REACHED,25539,148,25687,22714,22862,154.47297297297297,6 7 8 11 12,-1
571,w0,100,2826,4,153,0,COMPLETED_WALLTIME_REACHED,25635,153,25788,22809,22962,150.07843137254903,0 1 2 9,-1
572,w0,100,2837,3,149,0,COMPLETED_WALLTIME_REACHED,25635,149,25784,22798,22947,154.00671140939596,13 14 15,-1
573,w0,100,2839,4,150,0,COMPLETED_WALLTIME_REACHED,25672,150,25822,22833,22983,153.22,3 4 5 10,-1
574,w0,100,2841,4,148,0,COMPLETED_WALLTIME_REACHED,25687,148,25835,22846,22994,155.36486486486487,6 7 8 11,-1
576,w0,100,2861,4,150,0,COMPLETED_WALLTIME_REACHED,25784,150,25934,22923,23073,153.82,12 13 14 15,-1
577,w0,100,2866,4,153,0,COMPLETED_WALLTIME_REACHED,25788,153,25941,22922,23075,150.81699346405227,0 1 2 9,-1
578,w0,100,2873,4,150,0,COMPLETED_WALLTIME_REACHED,25822,150,25972,22949,23099,153.99333333333334,3 4 5 10,-1
580,w0,100,2878,3,150,0,COMPLETED_WALLTIME_REACHED,25835,150,25985,22957,23107,154.04666666666665,6 7 8,-1
579,w0,100,2876,5,148,0,COMPLETED_WALLTIME_REACHED,25934,148,26082,23058,23206,156.7972972972973,11 12 13 14 15,-1
583,w0,100,2882,3,149,0,COMPLETED_WALLTIME_REACHED,25941,149,26090,23059,23208,155.75838926174498,0 1 2,-1
581,w0,100,2879,5,150,0,COMPLETED_WALLTIME_REACHED,25972,150,26122,23093,23243,154.95333333333335,3 4 5 9 10,-1
597,w0,100,2941,3,153,0,COMPLETED_WALLTIME_REACHED,25985,153,26138,23044,23197,151.6143790849673,6 7 8,-1
582,w0,100,2880,5,154,0,COMPLETED_WALLTIME_REACHED,26082,154,26236,23202,23356,151.66233766233765,11 12 13 14 15,-1
584,w0,100,2883,6,149,0,COMPLETED_WALLTIME_REACHED,26122,149,26271,23239,23388,156.96644295302013,0 1 2 3 4 5,-1
585,w0,100,2884,4,151,0,COMPLETED_WALLTIME_REACHED,26138,151,26289,23254,23405,155.0,6 7 8 9,-1
586,w0,100,2887,5,147,0,COMPLETED_WALLTIME_REACHED,26236,147,26383,23349,23496,159.83673469387756,10 11 12 13 14,-1
587,w0,100,2888,4,152,0,COMPLETED_WALLTIME_REACHED,26271,152,26423,23383,23535,154.83552631578948,0 1 2 3,-1
588,w0,100,2894,5,150,0,COMPLETED_WALLTIME_REACHED,26289,150,26439,23395,23545,156.96666666666667,4 5 6 7 8,-1
589,w0,100,2895,5,151,0,COMPLETED_WALLTIME_REACHED,26383,151,26534,23488,23639,156.5496688741722,9 10 11 12 13,-1
590,w0,100,2912,5,151,0,COMPLETED_WALLTIME_REACHED,26423,151,26574,23511,23662,156.7019867549669,0 1 2 3 14,-1
591,w0,100,2924,4,150,0,COMPLETED_WALLTIME_REACHED,26439,150,26589,23515,23665,157.76666666666668,4 5 6 7,-1
592,w0,100,2924,5,149,0,COMPLETED_WALLTIME_REACHED,26534,149,26683,23610,23759,159.45637583892616,8 9 10 11 12,-1
593,w0,100,2930,4,151,0,COMPLETED_WALLTIME_REACHED,26574,151,26725,23644,23795,157.58278145695365,0 1 2 3,-1
601,w0,100,2963,3,151,0,COMPLETED_WALLTIME_REACHED,26574,151,26725,23611,23762,157.36423841059602,13 14 15,-1
594,w0,100,2930,4,150,0,COMPLETED_WALLTIME_REACHED,26589,150,26739,23659,23809,158.72666666666666,4 5 6 7,-1
595,w0,100,2934,4,150,0,COMPLETED_WALLTIME_REACHED,26683,150,26833,23749,23899,159.32666666666665,8 9 10 11,-1
596,w0,100,2939,5,147,0,COMPLETED_WALLTIME_REACHED,26725,147,26872,23786,23933,162.8095238095238,0 1 2 3 12,-1
598,w0,100,2943,5,147,0,COMPLETED_WALLTIME_REACHED,26739,147,26886,23796,23943,162.87755102040816,4 5 6 7 13,-1
599,w0,100,2946,5,152,0,COMPLETED_WALLTIME_REACHED,26833,152,26985,23887,24039,158.15131578947367,8 9 10 11 14,-1
600,w0,100,2947,4,153,0,COMPLETED_WALLTIME_REACHED,26872,153,27025,23925,24078,157.37254901960785,0 1 2 3,-1
602,w0,100,2967,6,152,0,COMPLETED_WALLTIME_REACHED,26886,152,27038,23919,24071,158.36184210526315,4 5 6 7 12 13,-1
603,w0,100,2975,4,150,0,COMPLETED_WALLTIME_REACHED,26985,150,27135,24010,24160,161.06666666666666,8 9 10 11,-1
604,w0,100,2980,5,152,0,COMPLETED_WALLTIME_REACHED,27025,152,27177,24045,24197,159.19078947368422,0 1 2 3 14,-1
605,w0,100,2981,4,147,0,COMPLETED_WALLTIME_REACHED,27038,147,27185,24057,24204,164.6530612244898,4 5 6 7,-1
608,w0,100,2991,3,151,0,COMPLETED_WALLTIME_REACHED,27038,151,27189,24047,24198,160.25165562913907,12 13 15,-1
606,w0,100,2988,4,153,0,COMPLETED_WALLTIME_REACHED,27135,153,27288,24147,24300,158.8235294117647,8 9 10 11,-1
607,w0,100,2991,4,149,0,COMPLETED_WALLTIME_REACHED,27177,149,27326,24186,24335,163.3221476510067,0 1 2 3,-1
609,w0,100,2991,5,149,0,COMPLETED_WALLTIME_REACHED,27185,149,27334,24194,24343,163.3758389261745,4 5 6 7 14,-1
637,w0,100,3201,3,151,0,COMPLETED_WALLTIME_REACHED,27189,151,27340,23988,24139,159.86092715231788,12 13 15,-1
610,w0,100,2994,4,150,0,COMPLETED_WALLTIME_REACHED,27288,150,27438,24294,24444,162.96,8 9 10 11,-1
640,w0,100,3227,3,146,0,COMPLETED_WALLTIME_REACHED,27326,146,27472,24099,24245,166.06164383561645,0 1 2,-1
611,w0,100,3008,6,149,0,COMPLETED_WALLTIME_REACHED,27334,149,27483,24326,24475,164.26174496644296,3 4 5 6 7 14,-1
612,w0,100,3016,6,153,0,COMPLETED_WALLTIME_REACHED,27438,153,27591,24422,24575,160.62091503267973,8 9 10 11 12 13,-1
613,w0,100,3024,4,151,0,COMPLETED_WALLTIME_REACHED,27472,151,27623,24448,24599,162.90728476821192,0 1 2 15,-1
614,w0,100,3027,4,148,0,COMPLETED_WALLTIME_REACHED,27483,148,27631,24456,24604,166.24324324324326,3 4 5 6,-1
615,w0,100,3034,5,149,0,COMPLETED_WALLTIME_REACHED,27591,149,27740,24557,24706,165.81208053691276,7 8 9 10 11,-1
616,w0,100,3043,5,149,0,COMPLETED_WALLTIME_REACHED,27623,149,27772,24580,24729,165.96644295302013,0 1 2 12 13,-1
617,w0,100,3044,5,151,0,COMPLETED_WALLTIME_REACHED,27631,151,27782,24587,24738,163.82781456953643,3 4 5 6 14,-1
618,w0,100,3055,4,150,0,COMPLETED_WALLTIME_REACHED,27740,150,27890,24685,24835,165.56666666666666,7 8 9 10,-1
619,w0,100,3080,4,149,0,COMPLETED_WALLTIME_REACHED,27772,149,27921,24692,24841,166.71812080536913,0 1 2 11,-1
641,w0,100,3227,3,149,0,COMPLETED_WALLTIME_REACHED,27772,149,27921,24545,24694,165.73154362416108,12 13 15,-1
620,w0,100,3088,4,148,0,COMPLETED_WALLTIME_REACHED,27782,148,27930,24694,24842,167.85135135135135,3 4 5 6,-1
621,w0,100,3089,4,150,0,COMPLETED_WALLTIME_REACHED,27890,150,28040,24801,24951,166.34,7 8 9 10,-1
622,w0,100,3094,5,149,0,COMPLETED_WALLTIME_REACHED,27921,149,28070,24827,24976,167.6241610738255,0 1 2 11 12,-1
652,w0,100,3272,3,152,0,COMPLETED_WALLTIME_REACHED,27921,152,28073,24649,24801,163.16447368421052,13 14 15,-1
623,w0,100,3105,4,147,0,COMPLETED_WALLTIME_REACHED,27930,147,28077,24825,24972,169.87755102040816,3 4 5 6,-1
625,w0,100,3122,4,149,0,COMPLETED_WALLTIME_REACHED,28040,149,28189,24918,25067,168.23489932885906,7 8 9 10,-1
624,w0,100,3118,5,150,0,COMPLETED_WALLTIME_REACHED,28070,150,28220,24952,25102,167.34666666666666,0 1 2 11 12,-1
626,w0,100,3127,5,149,0,COMPLETED_WALLTIME_REACHED,28077,149,28226,24950,25099,168.4496644295302,3 4 5 6 13,-1
627,w0,100,3129,4,151,0,COMPLETED_WALLTIME_REACHED,28189,151,28340,25060,25211,166.96026490066225,7 8 9 10,-1
628,w0,100,3137,4,150,0,COMPLETED_WALLTIME_REACHED,28220,150,28370,25083,25233,168.22,0 1 2 11,-1
669,w0,100,3368,3,149,0,COMPLETED_WALLTIME_REACHED,28220,149,28369,24852,25001,167.79194630872485,12 14 15,-1
629,w0,100,3138,4,153,0,COMPLETED_WALLTIME_REACHED,28226,153,28379,25088,25241,164.9738562091503,3 4 5 6,-1
630,w0,100,3147,4,155,0,COMPLETED_WALLTIME_REACHED,28340,155,28495,25193,25348,163.53548387096774,7 8 9 10,-1
672,w0,100,3380,3,148,0,COMPLETED_WALLTIME_REACHED,28369,148,28517,24989,25137,169.84459459459458,12 13 14,-1
631,w0,100,3149,5,150,0,COMPLETED_WALLTIME_REACHED,28370,150,28520,25221,25371,169.14,0 1 2 11 15,-1
632,w0,100,3157,4,150,0,COMPLETED_WALLTIME_REACHED,28379,150,28529,25222,25372,169.14666666666668,3 4 5 6,-1
633,w0,100,3159,6,148,0,COMPLETED_WALLTIME_REACHED,28517,148,28665,25358,25506,172.33783783783784,7 8 9 10 12 13,-1
634,w0,100,3188,4,151,0,COMPLETED_WALLTIME_REACHED,28520,151,28671,25332,25483,168.76158940397352,0 1 2 11,-1
635,w0,100,3193,5,149,0,COMPLETED_WALLTIME_REACHED,28529,149,28678,25336,25485,171.04026845637583,3 4 5 6 14,-1
636,w0,100,3194,6,148,0,COMPLETED_WALLTIME_REACHED,28665,148,28813,25471,25619,173.10135135135135,7 8 9 10 12 13,-1
638,w0,100,3202,4,155,0,COMPLETED_WALLTIME_REACHED,28671,155,28826,25469,25624,165.31612903225806,0 1 2 11,-1
639,w0,100,3216,6,151,0,COMPLETED_WALLTIME_REACHED,28678,151,28829,25462,25613,169.6225165562914,3 4 5 6 14 15,-1
642,w0,100,3230,4,149,0,COMPLETED_WALLTIME_REACHED,28813,149,28962,25583,25732,172.6979865771812,7 8 9 10,-1
643,w0,100,3241,5,150,0,COMPLETED_WALLTIME_REACHED,28826,150,28976,25585,25735,171.56666666666666,0 1 2 11 12,-1
644,w0,100,3243,5,152,0,COMPLETED_WALLTIME_REACHED,28829,152,28981,25586,25738,169.32894736842104,3 4 5 6 13,-1
645,w0,100,3249,4,151,0,COMPLETED_WALLTIME_REACHED,28962,151,29113,25713,25864,171.28476821192052,7 8 9 10,-1
646,w0,100,3249,7,151,0,COMPLETED_WALLTIME_REACHED,28976,151,29127,25727,25878,171.3774834437086,0 1 2 11 12 14 15,-1
647,w0,100,3250,4,154,0,COMPLETED_WALLTIME_REACHED,28981,154,29135,25731,25885,168.08441558441558,3 4 5 6,-1
648,w0,100,3257,5,149,0,COMPLETED_WALLTIME_REACHED,29113,149,29262,25856,26005,174.53020134228188,7 8 9 10 13,-1
649,w0,100,3258,4,149,0,COMPLETED_WALLTIME_REACHED,29127,149,29276,25869,26018,174.61744966442953,0 1 2 11,-1
684,w0,100,3427,3,148,0,COMPLETED_WALLTIME_REACHED,29127,148,29275,25700,25848,174.64864864864865,12 14 15,-1
650,w0,100,3259,4,151,0,COMPLETED_WALLTIME_REACHED,29135,151,29286,25876,26027,172.36423841059602,3 4 5 6,-1
651,w0,100,3261,6,147,0,COMPLETED_WALLTIME_REACHED,29275,147,29422,26014,26161,177.96598639455783,7 8 9 10 12 13,-1
653,w0,100,3274,4,149,0,COMPLETED_WALLTIME_REACHED,29276,149,29425,26002,26151,175.51006711409397,0 1 2 11,-1
654,w0,100,3281,5,150,0,COMPLETED_WALLTIME_REACHED,29286,150,29436,26005,26155,174.36666666666667,3 4 5 6 14,-1
655,w0,100,3282,6,153,0,COMPLETED_WALLTIME_REACHED,29422,153,29575,26140,26293,171.84967320261438,7 8 9 10 12 13,-1
656,w0,100,3288,4,152,0,COMPLETED_WALLTIME_REACHED,29425,152,29577,26137,26289,172.95394736842104,0 1 2 11,-1
658,w0,100,3293,5,147,0,COMPLETED_WALLTIME_REACHED,29436,147,29583,26143,26290,178.843537414966,3 4 5 6 14,-1
657,w0,100,3291,7,151,0,COMPLETED_WALLTIME_REACHED,29575,151,29726,26284,26435,175.0662251655629,7 8 9 10 12 13 15,-1
685,w0,100,3433,3,152,0,COMPLETED_WALLTIME_REACHED,29577,152,29729,26144,26296,173.0,0 1 2,-1
659,w0,100,3300,6,148,0,COMPLETED_WALLTIME_REACHED,29583,148,29731,26283,26431,178.58783783783784,3 4 5 6 11 14,-1
660,w0,100,3301,6,152,0,COMPLETED_WALLTIME_REACHED,29726,152,29878,26425,26577,174.84868421052633,7 8 9 10 12 13,-1
662,w0,100,3323,4,150,0,COMPLETED_WALLTIME_REACHED,29729,150,29879,26406,26556,177.04,0 1 2 15,-1
661,w0,100,3317,5,147,0,COMPLETED_WALLTIME_REACHED,29731,147,29878,26414,26561,180.68707482993196,3 4 5 6 11,-1
663,w0,100,3324,4,152,0,COMPLETED_WALLTIME_REACHED,29878,152,30030,26554,26706,175.69736842105263,3 4 5 6,-1
664,w0,100,3334,5,148,0,COMPLETED_WALLTIME_REACHED,29878,148,30026,26544,26692,180.35135135135135,7 8 9 10 11,-1
666,w0,100,3352,5,154,0,COMPLETED_WALLTIME_REACHED,29879,154,30033,26527,26681,173.25324675324674,0 1 2 12 13,-1
667,w0,100,3356,5,147,0,COMPLETED_WALLTIME_REACHED,30026,147,30173,26670,26817,182.42857142857142,7 8 9 10 11,-1
670,w0,100,3374,4,151,0,COMPLETED_WALLTIME_REACHED,30030,151,30181,26656,26807,177.52980132450332,3 4 5 6,-1
671,w0,100,3375,6,149,0,COMPLETED_WALLTIME_REACHED,30033,149,30182,26658,26807,179.91275167785236,0 1 2 12 13 14,-1
673,w0,100,3380,4,150,0,COMPLETED_WALLTIME_REACHED,30173,150,30323,26793,26943,179.62,7 8 9 10,-1
674,w0,100,3381,4,153,0,COMPLETED_WALLTIME_REACHED,30181,153,30334,26800,26953,176.16339869281046,3 4 5 6,-1
675,w0,100,3384,4,149,0,COMPLETED_WALLTIME_REACHED,30182,149,30331,26798,26947,180.8523489932886,0 1 2 11,-1
676,w0,100,3394,4,149,0,COMPLETED_WALLTIME_REACHED,30182,149,30331,26788,26937,180.78523489932886,12 13 14 15,-1
677,w0,100,3397,4,149,0,COMPLETED_WALLTIME_REACHED,30323,149,30472,26926,27075,181.71140939597316,7 8 9 10,-1
678,w0,100,3402,5,151,0,COMPLETED_WALLTIME_REACHED,30331,151,30482,26929,27080,179.33774834437085,0 1 2 11 12,-1
688,w0,100,3476,3,146,0,COMPLETED_WALLTIME_REACHED,30331,146,30477,26855,27001,184.93835616438355,13 14 15,-1
679,w0,100,3405,4,150,0,COMPLETED_WALLTIME_REACHED,30334,150,30484,26929,27079,180.52666666666667,3 4 5 6,-1
680,w0,100,3406,6,148,0,COMPLETED_WALLTIME_REACHED,30477,148,30625,27071,27219,183.91216216216216,7 8 9 10 13 14,-1
681,w0,100,3412,5,153,0,COMPLETED_WALLTIME_REACHED,30482,153,30635,27070,27223,177.9281045751634,0 1 2 11 12,-1
682,w0,100,3414,4,149,0,COMPLETED_WALLTIME_REACHED,30484,149,30633,27070,27219,182.6778523489933,3 4 5 6,-1
683,w0,100,3423,5,150,0,COMPLETED_WALLTIME_REACHED,30625,150,30775,27202,27352,182.34666666666666,7 8 9 10 13,-1
686,w0,100,3446,5,152,0,COMPLETED_WALLTIME_REACHED,30633,152,30785,27187,27339,179.86184210526315,3 4 5 6 14,-1
687,w0,100,3463,6,152,0,COMPLETED_WALLTIME_REACHED,30635,152,30787,27172,27324,179.76315789473685,0 1 2 11 12 15,-1
689,w0,100,3479,3,148,0,COMPLETED_WALLTIME_REACHED,30775,148,30923,27296,27444,185.43243243243242,7 8 9,-1
690,w0,100,3481,4,145,0,COMPLETED_WALLTIME_REACHED,30785,145,30930,27304,27449,189.30344827586208,3 4 5 6,-1
702,w0,100,3529,3,153,0,COMPLETED_WALLTIME_REACHED,30785,153,30938,27256,27409,179.1437908496732,10 13 14,-1
691,w0,100,3481,4,146,0,COMPLETED_WALLTIME_REACHED,30787,146,30933,27306,27452,188.02739726027397,0 1 2 11,-1
692,w0,100,3483,4,151,0,COMPLETED_WALLTIME_REACHED,30923,151,31074,27440,27591,182.72185430463577,7 8 9 12,-1
693,w0,100,3487,5,149,0,COMPLETED_WALLTIME_REACHED,30930,149,31079,27443,27592,185.18120805369128,3 4 5 6 15,-1
694,w0,100,3489,4,149,0,COMPLETED_WALLTIME_REACHED,30933,149,31082,27444,27593,185.18791946308724,0 1 2 11,-1
706,w0,100,3550,3,146,0,COMPLETED_WALLTIME_REACHED,30938,146,31084,27388,27534,188.58904109589042,10 13 14,-1
695,w0,100,3498,4,150,0,COMPLETED_WALLTIME_REACHED,31074,150,31224,27576,27726,184.84,7 8 9 12,-1
696,w0,100,3502,5,149,0,COMPLETED_WALLTIME_REACHED,31079,149,31228,27577,27726,186.08053691275168,3 4 5 6 15,-1
697,w0,100,3502,6,153,0,COMPLETED_WALLTIME_REACHED,31084,153,31237,27582,27735,181.27450980392157,0 1 2 10 11 13,-1
698,w0,100,3511,5,151,0,COMPLETED_WALLTIME_REACHED,31224,151,31375,27713,27864,184.52980132450332,7 8 9 12 14,-1
699,w0,100,3512,4,152,0,COMPLETED_WALLTIME_REACHED,31228,152,31380,27716,27868,183.3421052631579,3 4 5 6,-1
700,w0,100,3518,4,150,0,COMPLETED_WALLTIME_REACHED,31237,150,31387,27719,27869,185.79333333333332,0 1 2 10,-1
701,w0,100,3520,6,150,0,COMPLETED_WALLTIME_REACHED,31375,150,31525,27855,28005,186.7,7 8 9 11 12 13,-1
703,w0,100,3539,5,149,0,COMPLETED_WALLTIME_REACHED,31380,149,31529,27841,27990,187.8523489932886,3 4 5 6 14,-1
704,w0,100,3547,5,149,0,COMPLETED_WALLTIME_REACHED,31387,149,31536,27840,27989,187.84563758389262,0 1 2 10 15,-1
705,w0,100,3549,4,150,0,COMPLETED_WALLTIME_REACHED,31525,150,31675,27976,28126,187.50666666666666,7 8 9 11,-1
707,w0,100,3551,3,153,0,COMPLETED_WALLTIME_REACHED,31529,153,31682,27978,28131,183.86274509803923,3 4 5,-1
708,w0,100,3554,4,152,0,COMPLETED_WALLTIME_REACHED,31529,152,31681,27975,28127,185.04605263157896,6 12 13 14,-1
709,w0,100,3557,4,150,0,COMPLETED_WALLTIME_REACHED,31536,150,31686,27979,28129,187.52666666666667,0 1 2 10,-1
710,w0,100,3557,4,152,0,COMPLETED_WALLTIME_REACHED,31675,152,31827,28118,28270,185.98684210526315,7 8 9 11,-1
711,w0,100,3559,4,149,0,COMPLETED_WALLTIME_REACHED,31681,149,31830,28122,28271,189.73825503355704,6 12 13 14,-1
712,w0,100,3569,4,152,0,COMPLETED_WALLTIME_REACHED,31682,152,31834,28113,28265,185.95394736842104,3 4 5 15,-1
713,w0,100,3569,3,150,0,COMPLETED_WALLTIME_REACHED,31686,150,31836,28117,28267,188.44666666666666,0 1 2,-1
714,w0,100,3572,5,147,0,COMPLETED_WALLTIME_REACHED,31827,147,31974,28255,28402,193.2108843537415,7 8 9 10 11,-1
715,w0,100,3572,4,152,0,COMPLETED_WALLTIME_REACHED,31830,152,31982,28258,28410,186.9078947368421,6 12 13 14,-1
716,w0,100,3582,4,148,0,COMPLETED_WALLTIME_REACHED,31834,148,31982,28252,28400,191.8918918918919,3 4 5 15,-1
717,w0,100,3589,6,150,0,COMPLETED_WALLTIME_REACHED,31974,150,32124,28385,28535,190.23333333333332,0 1 2 7 8 9,-1
719,w0,100,3608,4,150,0,COMPLETED_WALLTIME_REACHED,31982,150,32132,28374,28524,190.16,3 4 5 6,-1
720,w0,100,3620,6,149,0,COMPLETED_WALLTIME_REACHED,31982,149,32131,28362,28511,191.3489932885906,10 11 12 13 14 15,-1
721,w0,100,3621,5,145,0,COMPLETED_WALLTIME_REACHED,32124,145,32269,28503,28648,197.57241379310344,0 1 2 7 8,-1
722,w0,100,3628,6,152,0,COMPLETED_WALLTIME_REACHED,32131,152,32283,28503,28655,188.51973684210526,9 10 11 12 13 14,-1
723,w0,100,3629,5,151,0,COMPLETED_WALLTIME_REACHED,32132,151,32283,28503,28654,189.76158940397352,3 4 5 6 15,-1
724,w0,100,3630,4,146,0,COMPLETED_WALLTIME_REACHED,32269,146,32415,28639,28785,197.15753424657535,0 1 2 7,-1
725,w0,100,3637,6,151,0,COMPLETED_WALLTIME_REACHED,32283,151,32434,28646,28797,190.7086092715232,3 4 5 6 8 9,-1
726,w0,100,3641,5,147,0,COMPLETED_WALLTIME_REACHED,32283,147,32430,28642,28789,195.843537414966,10 11 12 13 14,-1
727,w0,100,3646,5,147,0,COMPLETED_WALLTIME_REACHED,32415,147,32562,28769,28916,196.7074829931973,0 1 2 7 15,-1
728,w0,100,3646,5,153,0,COMPLETED_WALLTIME_REACHED,32430,153,32583,28784,28937,189.13071895424838,10 11 12 13 14,-1
729,w0,100,3647,5,152,0,COMPLETED_WALLTIME_REACHED,32434,152,32586,28787,28939,190.38815789473685,3 4 5 6 8,-1
730,w0,100,3649,4,149,0,COMPLETED_WALLTIME_REACHED,32562,149,32711,28913,29062,195.04697986577182,0 1 2 7,-1
731,w0,100,3655,4,151,0,COMPLETED_WALLTIME_REACHED,32583,151,32734,28928,29079,192.57615894039736,9 10 11 12,-1
750,w0,100,3715,3,149,0,COMPLETED_WALLTIME_REACHED,32583,149,32732,28868,29017,194.74496644295303,13 14 15,-1
732,w0,100,3658,5,151,0,COMPLETED_WALLTIME_REACHED,32586,151,32737,28928,29079,192.57615894039736,3 4 5 6 8,-1
733,w0,100,3658,4,148,0,COMPLETED_WALLTIME_REACHED,32711,148,32859,29053,29201,197.30405405405406,0 1 2 7,-1
734,w0,100,3665,5,153,0,COMPLETED_WALLTIME_REACHED,32734,153,32887,29069,29222,190.99346405228758,9 10 11 12 13,-1
735,w0,100,3669,4,151,0,COMPLETED_WALLTIME_REACHED,32737,151,32888,29068,29219,193.50331125827816,3 4 5 6,-1
759,w0,100,3777,3,149,0,COMPLETED_WALLTIME_REACHED,32737,149,32886,28960,29109,195.36241610738256,8 14 15,-1
736,w0,100,3670,4,147,0,COMPLETED_WALLTIME_REACHED,32859,147,33006,29189,29336,199.56462585034015,0 1 2 7,-1
771,w0,100,3837,3,152,0,COMPLETED_WALLTIME_REACHED,32886,152,33038,29049,29201,192.11184210526315,8 14 15,-1
737,w0,100,3672,4,153,0,COMPLETED_WALLTIME_REACHED,32887,153,33040,29215,29368,191.94771241830065,9 10 11 12,-1
738,w0,100,3673,4,149,0,COMPLETED_WALLTIME_REACHED,32888,149,33037,29215,29364,197.0738255033557,3 4 5 6,-1
739,w0,100,3679,4,149,0,COMPLETED_WALLTIME_REACHED,33006,149,33155,29327,29476,197.8255033557047,0 1 2 7,-1
740,w0,100,3681,5,150,0,COMPLETED_WALLTIME_REACHED,33037,150,33187,29356,29506,196.70666666666668,3 4 5 6 13,-1
741,w0,100,3687,5,151,0,COMPLETED_WALLTIME_REACHED,33040,151,33191,29353,29504,195.39072847682118,8 9 10 11 12,-1
742,w0,100,3697,4,152,0,COMPLETED_WALLTIME_REACHED,33155,152,33307,29458,29610,194.80263157894737,0 1 2 7,-1
743,w0,100,3697,4,150,0,COMPLETED_WALLTIME_REACHED,33187,150,33337,29490,29640,197.6,3 4 5 6,-1
775,w0,100,3866,3,151,0,COMPLETED_WALLTIME_REACHED,33187,151,33338,29321,29472,195.17880794701986,13 14 15,-1
744,w0,100,3697,4,152,0,COMPLETED_WALLTIME_REACHED,33191,152,33343,29494,29646,195.03947368421052,8 9 10 11,-1
745,w0,100,3699,4,153,0,COMPLETED_WALLTIME_REACHED,33307,153,33460,29608,29761,194.51633986928104,0 1 2 7,-1
746,w0,100,3701,4,148,0,COMPLETED_WALLTIME_REACHED,33337,148,33485,29636,29784,201.24324324324326,3 4 5 6,-1
747,w0,100,3710,4,150,0,COMPLETED_WALLTIME_REACHED,33338,150,33488,29628,29778,198.52,12 13 14 15,-1
748,w0,100,3711,6,153,0,COMPLETED_WALLTIME_REACHED,33460,153,33613,29749,29902,195.43790849673204,0 1 2 7 8 9,-1
749,w0,100,3714,4,148,0,COMPLETED_WALLTIME_REACHED,33485,148,33633,29771,29919,202.15540540540542,3 4 5 6,-1
751,w0,100,3717,4,152,0,COMPLETED_WALLTIME_REACHED,33488,152,33640,29771,29923,196.86184210526315,10 11 12 13,-1
752,w0,100,3719,4,150,0,COMPLETED_WALLTIME_REACHED,33613,150,33763,29894,30044,200.29333333333332,0 1 2 7,-1
801,w0,100,3980,3,149,0,COMPLETED_WALLTIME_REACHED,33613,149,33762,29633,29782,199.8791946308725,8 9 14,-1
753,w0,100,3733,5,151,0,COMPLETED_WALLTIME_REACHED,33633,151,33784,29900,30051,199.01324503311258,3 4 5 6 15,-1
754,w0,100,3740,4,150,0,COMPLETED_WALLTIME_REACHED,33640,150,33790,29900,30050,200.33333333333334,10 11 12 13,-1
755,w0,100,3768,5,149,0,COMPLETED_WALLTIME_REACHED,33763,149,33912,29995,30144,202.30872483221478,0 1 2 7 8,-1
756,w0,100,3768,5,149,0,COMPLETED_WALLTIME_REACHED,33784,149,33933,30016,30165,202.4496644295302,3 4 5 6 9,-1
757,w0,100,3772,6,149,0,COMPLETED_WALLTIME_REACHED,33790,149,33939,30018,30167,202.46308724832215,10 11 12 13 14 15,-1
758,w0,100,3774,5,147,0,COMPLETED_WALLTIME_REACHED,33912,147,34059,30138,30285,206.0204081632653,0 1 2 7 8,-1
761,w0,100,3791,5,150,0,COMPLETED_WALLTIME_REACHED,33933,150,34083,30142,30292,201.94666666666666,3 4 5 6 9,-1
762,w0,100,3797,5,150,0,COMPLETED_WALLTIME_REACHED,33939,150,34089,30142,30292,201.94666666666666,10 11 12 13 14,-1
763,w0,100,3799,4,151,0,COMPLETED_WALLTIME_REACHED,34059,151,34210,30260,30411,201.39735099337747,0 1 2 7,-1
764,w0,100,3803,5,152,0,COMPLETED_WALLTIME_REACHED,34083,152,34235,30280,30432,200.21052631578948,3 4 5 6 8,-1
765,w0,100,3806,6,147,0,COMPLETED_WALLTIME_REACHED,34089,147,34236,30283,30430,207.00680272108843,9 10 11 12 13 14,-1
766,w0,100,3807,4,148,0,COMPLETED_WALLTIME_REACHED,34210,148,34358,30403,30551,206.42567567567568,0 1 2 7,-1
767,w0,100,3813,5,152,0,COMPLETED_WALLTIME_REACHED,34235,152,34387,30422,30574,201.14473684210526,3 4 5 6 8,-1
769,w0,100,3826,6,154,0,COMPLETED_WALLTIME_REACHED,34236,154,34390,30410,30564,198.46753246753246,9 10 11 12 13 14,-1
770,w0,100,3836,5,151,0,COMPLETED_WALLTIME_REACHED,34358,151,34509,30522,30673,203.13245033112582,0 1 2 7 15,-1
772,w0,100,3844,5,148,0,COMPLETED_WALLTIME_REACHED,34387,148,34535,30543,30691,207.3716216216216,3 4 5 6 8,-1
773,w0,100,3847,4,150,0,COMPLETED_WALLTIME_REACHED,34390,150,34540,30543,30693,204.62,9 10 11 12,-1
774,w0,100,3850,4,144,0,COMPLETED_WALLTIME_REACHED,34509,144,34653,30659,30803,213.90972222222223,0 1 2 7,-1
802,w0,100,3983,3,154,0,COMPLETED_WALLTIME_REACHED,34509,154,34663,30526,30680,199.2207792207792,13 14 15,-1
776,w0,100,3869,4,150,0,COMPLETED_WALLTIME_REACHED,34535,150,34685,30666,30816,205.44,3 4 5 6,-1
777,w0,100,3869,4,149,0,COMPLETED_WALLTIME_REACHED,34540,149,34689,30671,30820,206.84563758389262,8 9 10 11,-1
778,w0,100,3870,5,151,0,COMPLETED_WALLTIME_REACHED,34653,151,34804,30783,30934,204.86092715231788,0 1 2 7 12,-1
817,w0,100,4057,3,150,0,COMPLETED_WALLTIME_REACHED,34663,150,34813,30606,30756,205.04,13 14 15,-1
779,w0,100,3873,4,152,0,COMPLETED_WALLTIME_REACHED,34685,152,34837,30812,30964,203.71052631578948,3 4 5 6,-1
780,w0,100,3878,4,152,0,COMPLETED_WALLTIME_REACHED,34689,152,34841,30811,30963,203.70394736842104,8 9 10 11,-1
781,w0,100,3883,5,152,0,COMPLETED_WALLTIME_REACHED,34804,152,34956,30921,31073,204.42763157894737,0 1 2 7 12,-1
782,w0,100,3895,5,150,0,COMPLETED_WALLTIME_REACHED,34837,150,34987,30942,31092,207.28,3 4 5 6 13,-1
783,w0,100,3896,6,149,0,COMPLETED_WALLTIME_REACHED,34841,149,34990,30945,31094,208.68456375838926,8 9 10 11 14 15,-1
784,w0,100,3902,4,149,0,COMPLETED_WALLTIME_REACHED,34956,149,35105,31054,31203,209.41610738255034,0 1 2 7,-1
785,w0,100,3908,5,147,0,COMPLETED_WALLTIME_REACHED,34987,147,35134,31079,31226,212.42176870748298,3 4 5 6 12,-1
786,w0,100,3918,4,152,0,COMPLETED_WALLTIME_REACHED,34990,152,35142,31072,31224,205.42105263157896,8 9 10 11,-1
827,w0,100,4087,3,151,0,COMPLETED_WALLTIME_REACHED,34990,151,35141,30903,31054,205.65562913907286,13 14 15,-1
787,w0,100,3919,4,146,0,COMPLETED_WALLTIME_REACHED,35105,146,35251,31186,31332,214.6027397260274,0 1 2 7,-1
788,w0,100,3920,5,150,0,COMPLETED_WALLTIME_REACHED,35134,150,35284,31214,31364,209.09333333333333,3 4 5 6 12,-1
789,w0,100,3922,5,150,0,COMPLETED_WALLTIME_REACHED,35142,150,35292,31220,31370,209.13333333333333,8 9 10 11 13,-1
790,w0,100,3926,4,152,0,COMPLETED_WALLTIME_REACHED,35251,152,35403,31325,31477,207.08552631578948,0 1 2 7,-1
791,w0,100,3927,5,149,0,COMPLETED_WALLTIME_REACHED,35284,149,35433,31357,31506,211.4496644295302,3 4 5 6 12,-1
792,w0,100,3934,6,149,0,COMPLETED_WALLTIME_REACHED,35292,149,35441,31358,31507,211.45637583892616,8 9 10 11 13 14,-1
793,w0,100,3936,4,151,0,COMPLETED_WALLTIME_REACHED,35403,151,35554,31467,31618,209.39072847682118,0 1 2 7,-1
794,w0,100,3943,4,150,0,COMPLETED_WALLTIME_REACHED,35433,150,35583,31490,31640,210.93333333333334,3 4 5 6,-1
795,w0,100,3951,6,151,0,COMPLETED_WALLTIME_REACHED,35441,151,35592,31490,31641,209.5430463576159,8 9 10 11 12 13,-1
796,w0,100,3953,5,152,0,COMPLETED_WALLTIME_REACHED,35554,152,35706,31601,31753,208.90131578947367,0 1 2 7 14,-1
797,w0,100,3966,5,149,0,COMPLETED_WALLTIME_REACHED,35583,149,35732,31617,31766,213.19463087248323,3 4 5 6 15,-1
798,w0,100,3973,6,149,0,COMPLETED_WALLTIME_REACHED,35592,149,35741,31619,31768,213.20805369127515,8 9 10 11 12 13,-1
807,w0,100,4001,4,151,0,COMPLETED_WALLTIME_REACHED,35706,151,35857,31705,31856,210.96688741721854,0 1 2 7,-1
799,w0,100,3974,6,150,0,COMPLETED_WALLTIME_REACHED,35732,150,35882,31758,31908,212.72,3 4 5 6 14 15,-1
800,w0,100,3976,6,152,0,COMPLETED_WALLTIME_REACHED,35741,152,35893,31765,31917,209.98026315789474,8 9 10 11 12 13,-1
809,w0,100,4015,4,151,0,COMPLETED_WALLTIME_REACHED,35857,151,36008,31842,31993,211.87417218543047,0 1 2 7,-1
803,w0,100,3988,6,151,0,COMPLETED_WALLTIME_REACHED,35882,151,36033,31894,32045,212.2185430463576,3 4 5 6 14 15,-1
804,w0,100,3997,5,149,0,COMPLETED_WALLTIME_REACHED,35893,149,36042,31896,32045,215.06711409395973,8 9 10 11 12,-1
805,w0,100,3998,5,151,0,COMPLETED_WALLTIME_REACHED,36008,151,36159,32010,32161,212.98675496688742,0 1 2 7 13,-1
806,w0,100,3999,5,152,0,COMPLETED_WALLTIME_REACHED,36033,152,36185,32034,32186,211.75,3 4 5 6 14,-1
808,w0,100,4002,5,149,0,COMPLETED_WALLTIME_REACHED,36042,149,36191,32040,32189,216.03355704697987,8 9 10 11 12,-1
811,w0,100,4019,5,152,0,COMPLETED_WALLTIME_REACHED,36159,152,36311,32140,32292,212.44736842105263,0 1 2 7 13,-1
813,w0,100,4033,4,150,0,COMPLETED_WALLTIME_REACHED,36185,150,36335,32152,32302,215.34666666666666,3 4 5 6,-1
812,w0,100,4025,7,146,0,COMPLETED_WALLTIME_REACHED,36191,146,36337,32166,32312,221.31506849315068,8 9 10 11 12 14 15,-1
844,w0,100,4180,3,151,0,COMPLETED_WALLTIME_REACHED,36311,151,36462,32131,32282,213.78807947019868,0 1 2,-1
814,w0,100,4036,6,152,0,COMPLETED_WALLTIME_REACHED,36335,152,36487,32299,32451,213.4934210526316,3 4 5 6 7 13,-1
815,w0,100,4037,5,150,0,COMPLETED_WALLTIME_REACHED,36337,150,36487,32300,32450,216.33333333333334,8 9 10 11 12,-1
816,w0,100,4040,4,153,0,COMPLETED_WALLTIME_REACHED,36462,153,36615,32422,32575,212.90849673202615,0 1 2 14,-1
818,w0,100,4058,5,148,0,COMPLETED_WALLTIME_REACHED,36487,148,36635,32429,32577,220.11486486486487,3 4 5 6 7,-1
819,w0,100,4060,5,149,0,COMPLETED_WALLTIME_REACHED,36487,149,36636,32427,32576,218.63087248322148,8 9 10 11 12,-1
820,w0,100,4067,4,149,0,COMPLETED_WALLTIME_REACHED,36615,149,36764,32548,32697,219.44295302013424,0 1 2 13,-1
821,w0,100,4072,4,150,0,COMPLETED_WALLTIME_REACHED,36635,150,36785,32563,32713,218.08666666666667,3 4 5 6,-1
848,w0,100,4211,3,152,0,COMPLETED_WALLTIME_REACHED,36635,152,36787,32424,32576,214.31578947368422,7 14 15,-1
822,w0,100,4072,4,150,0,COMPLETED_WALLTIME_REACHED,36636,150,36786,32564,32714,218.09333333333333,8 9 10 11,-1
823,w0,100,4074,5,150,0,COMPLETED_WALLTIME_REACHED,36764,150,36914,32690,32840,218.93333333333334,0 1 2 12 13,-1
850,w0,100,4223,3,150,0,COMPLETED_WALLTIME_REACHED,36785,150,36935,32562,32712,218.08,3 4 5,-1
824,w0,100,4075,5,150,0,COMPLETED_WALLTIME_REACHED,36786,150,36936,32711,32861,219.07333333333332,6 8 9 10 11,-1
862,w0,100,4289,3,147,0,COMPLETED_WALLTIME_REACHED,36787,147,36934,32498,32645,222.0748299319728,7 14 15,-1
826,w0,100,4082,4,151,0,COMPLETED_WALLTIME_REACHED,36914,151,37065,32832,32983,218.43046357615893,0 1 2 12,-1
828,w0,100,4090,4,148,0,COMPLETED_WALLTIME_REACHED,36934,148,37082,32844,32992,222.9189189189189,7 13 14 15,-1
864,w0,100,4330,3,152,0,COMPLETED_WALLTIME_REACHED,36935,152,37087,32605,32757,215.5065789473684,3 4 5,-1
829,w0,100,4091,4,154,0,COMPLETED_WALLTIME_REACHED,36936,154,37090,32845,32999,214.2792207792208,6 8 9 10,-1
830,w0,100,4096,4,149,0,COMPLETED_WALLTIME_REACHED,37065,149,37214,32969,33118,222.26845637583892,0 1 2 11,-1
831,w0,100,4096,5,151,0,COMPLETED_WALLTIME_REACHED,37082,151,37233,32986,33137,219.4503311258278,7 12 13 14 15,-1
832,w0,100,4100,5,149,0,COMPLETED_WALLTIME_REACHED,37090,149,37239,32990,33139,222.40939597315437,3 4 5 6 8,-1
833,w0,100,4103,5,149,0,COMPLETED_WALLTIME_REACHED,37214,149,37363,33111,33260,223.2214765100671,0 1 2 9 10,-1
834,w0,100,4106,5,151,0,COMPLETED_WALLTIME_REACHED,37233,151,37384,33127,33278,220.3841059602649,7 11 12 13 14,-1
835,w0,100,4107,5,149,0,COMPLETED_WALLTIME_REACHED,37239,149,37388,33132,33281,223.36241610738256,3 4 5 6 8,-1
836,w0,100,4108,6,148,0,COMPLETED_WALLTIME_REACHED,37363,148,37511,33255,33403,225.69594594594594,0 1 2 9 10 15,-1
837,w0,100,4114,4,151,0,COMPLETED_WALLTIME_REACHED,37384,151,37535,33270,33421,221.33112582781456,7 11 12 13,-1
838,w0,100,4118,5,146,0,COMPLETED_WALLTIME_REACHED,37388,146,37534,33270,33416,228.87671232876713,3 4 5 6 8,-1
839,w0,100,4121,6,148,0,COMPLETED_WALLTIME_REACHED,37511,148,37659,33390,33538,226.6081081081081,0 1 2 9 10 14,-1
840,w0,100,4143,4,152,0,COMPLETED_WALLTIME_REACHED,37534,152,37686,33391,33543,220.67763157894737,3 4 5 6,-1
841,w0,100,4150,4,151,0,COMPLETED_WALLTIME_REACHED,37535,151,37686,33385,33536,222.09271523178808,7 8 11 12,-1
842,w0,100,4165,5,154,0,COMPLETED_WALLTIME_REACHED,37659,154,37813,33494,33648,218.4935064935065,0 1 2 9 10,-1
865,w0,100,4339,3,150,0,COMPLETED_WALLTIME_REACHED,37659,150,37809,33320,33470,223.13333333333333,13 14 15,-1
843,w0,100,4172,4,149,0,COMPLETED_WALLTIME_REACHED,37686,149,37835,33514,33663,225.9261744966443,3 4 5 6,-1
845,w0,100,4187,4,150,0,COMPLETED_WALLTIME_REACHED,37686,150,37836,33499,33649,224.32666666666665,7 8 11 12,-1
846,w0,100,4199,6,153,0,COMPLETED_WALLTIME_REACHED,37813,153,37966,33614,33767,220.69934640522877,0 1 2 9 10 13,-1
847,w0,100,4204,6,151,0,COMPLETED_WALLTIME_REACHED,37835,151,37986,33631,33782,223.72185430463577,3 4 5 6 14 15,-1
854,w0,100,4247,4,149,0,COMPLETED_WALLTIME_REACHED,37836,149,37985,33589,33738,226.4295302013423,7 8 11 12,-1
849,w0,100,4219,5,151,0,COMPLETED_WALLTIME_REACHED,37966,151,38117,33747,33898,224.49006622516555,0 1 2 9 10,-1
867,w0,100,4350,3,148,0,COMPLETED_WALLTIME_REACHED,37985,148,38133,33635,33783,228.26351351351352,7 8 11,-1
851,w0,100,4224,8,148,0,COMPLETED_WALLTIME_REACHED,37986,148,38134,33762,33910,229.1216216216216,3 4 5 6 12 13 14 15,-1
852,w0,100,4244,5,147,0,COMPLETED_WALLTIME_REACHED,38117,147,38264,33873,34020,231.42857142857142,0 1 2 9 10,-1
875,w0,100,4410,3,148,0,COMPLETED_WALLTIME_REACHED,38133,148,38281,33723,33871,228.8581081081081,7 8 11,-1
853,w0,100,4246,6,147,0,COMPLETED_WALLTIME_REACHED,38134,147,38281,33888,34035,231.53061224489795,3 4 5 6 12 13,-1
855,w0,100,4252,4,151,0,COMPLETED_WALLTIME_REACHED,38264,151,38415,34012,34163,226.24503311258277,0 1 2 9,-1
876,w0,100,4415,3,151,0,COMPLETED_WALLTIME_REACHED,38264,151,38415,33849,34000,225.16556291390728,10 14 15,-1
856,w0,100,4254,6,153,0,COMPLETED_WALLTIME_REACHED,38281,153,38434,34027,34180,223.3986928104575,3 4 5 6 7 8,-1
885,w0,100,4449,3,149,0,COMPLETED_WALLTIME_REACHED,38281,149,38430,33832,33981,228.06040268456377,11 12 13,-1
857,w0,100,4258,6,151,0,COMPLETED_WALLTIME_REACHED,38415,151,38566,34157,34308,227.20529801324503,0 1 2 9 10 14,-1
858,w0,100,4266,4,149,0,COMPLETED_WALLTIME_REACHED,38430,149,38579,34164,34313,230.28859060402684,11 12 13 15,-1
859,w0,100,4271,5,148,0,COMPLETED_WALLTIME_REACHED,38434,148,38582,34163,34311,231.8310810810811,3 4 5 6 7,-1
860,w0,100,4278,5,149,0,COMPLETED_WALLTIME_REACHED,38566,149,38715,34288,34437,231.1208053691275,0 1 2 8 9,-1
861,w0,100,4286,5,148,0,COMPLETED_WALLTIME_REACHED,38579,148,38727,34293,34441,232.70945945945945,10 11 12 13 14,-1
863,w0,100,4301,4,148,0,COMPLETED_WALLTIME_REACHED,38582,148,38730,34281,34429,232.6283783783784,3 4 5 6,-1
866,w0,100,4346,5,151,0,COMPLETED_WALLTIME_REACHED,38715,151,38866,34369,34520,228.60927152317882,0 1 2 7 8,-1
868,w0,100,4360,6,151,0,COMPLETED_WALLTIME_REACHED,38727,151,38878,34367,34518,228.59602649006624,9 10 11 12 13 14,-1
869,w0,100,4366,5,147,0,COMPLETED_WALLTIME_REACHED,38730,147,38877,34364,34511,234.7687074829932,3 4 5 6 15,-1
871,w0,100,4374,4,150,0,COMPLETED_WALLTIME_REACHED,38866,150,39016,34492,34642,230.94666666666666,0 1 2 7,-1
870,w0,100,4370,6,150,0,COMPLETED_WALLTIME_REACHED,38877,150,39027,34507,34657,231.04666666666665,3 4 5 6 8 15,-1
872,w0,100,4387,5,148,0,COMPLETED_WALLTIME_REACHED,38878,148,39026,34491,34639,234.0472972972973,9 10 11 12 13,-1
874,w0,100,4406,4,149,0,COMPLETED_WALLTIME_REACHED,39016,149,39165,34610,34759,233.28187919463087,0 1 2 7,-1
877,w0,100,4417,6,148,0,COMPLETED_WALLTIME_REACHED,39026,148,39174,34609,34757,234.84459459459458,9 10 11 12 13 14,-1
878,w0,100,4420,4,150,0,COMPLETED_WALLTIME_REACHED,39027,150,39177,34607,34757,231.71333333333334,3 4 5 6,-1
879,w0,100,4420,4,149,0,COMPLETED_WALLTIME_REACHED,39165,149,39314,34745,34894,234.18791946308724,0 1 2 7,-1
880,w0,100,4424,4,151,0,COMPLETED_WALLTIME_REACHED,39174,151,39325,34750,34901,231.13245033112582,8 9 10 11,-1
881,w0,100,4430,4,148,0,COMPLETED_WALLTIME_REACHED,39174,148,39322,34744,34892,235.75675675675674,12 13 14 15,-1
882,w0,100,4435,6,151,0,COMPLETED_WALLTIME_REACHED,39314,151,39465,34879,35030,231.98675496688742,0 1 2 3 4 5,-1
883,w0,100,4446,4,149,0,COMPLETED_WALLTIME_REACHED,39322,149,39471,34876,35025,235.06711409395973,6 7 12 13,-1
886,w0,100,4461,5,147,0,COMPLETED_WALLTIME_REACHED,39325,147,39472,34864,35011,238.17006802721087,8 9 10 11 14,-1
887,w0,100,4465,5,152,0,COMPLETED_WALLTIME_REACHED,39465,152,39617,35000,35152,231.26315789473685,0 1 2 3 4,-1
888,w0,100,4467,5,149,0,COMPLETED_WALLTIME_REACHED,39471,149,39620,35004,35153,235.9261744966443,5 6 7 12 13,-1
889,w0,100,4468,3,151,0,COMPLETED_WALLTIME_REACHED,39472,151,39623,35004,35155,232.81456953642385,8 9 10,-1
891,w0,100,4478,3,152,0,COMPLETED_WALLTIME_REACHED,39472,152,39624,34994,35146,231.22368421052633,11 14 15,-1
890,w0,100,4472,5,152,0,COMPLETED_WALLTIME_REACHED,39617,152,39769,35145,35297,232.2171052631579,0 1 2 3 4,-1
892,w0,100,4485,5,151,0,COMPLETED_WALLTIME_REACHED,39620,151,39771,35135,35286,233.68211920529802,5 6 7 12 13,-1
893,w0,100,4497,6,149,0,COMPLETED_WALLTIME_REACHED,39624,149,39773,35127,35276,236.751677852349,8 9 10 11 14 15,-1
894,w0,100,4498,4,148,0,COMPLETED_WALLTIME_REACHED,39769,148,39917,35271,35419,239.31756756756758,0 1 2 3,-1
895,w0,100,4513,4,152,0,COMPLETED_WALLTIME_REACHED,39771,152,39923,35258,35410,232.96052631578948,4 5 6 7,-1
896,w0,100,4516,3,149,0,COMPLETED_WALLTIME_REACHED,39773,149,39922,35257,35406,237.6241610738255,8 9 10,-1
897,w0,100,4517,5,147,0,COMPLETED_WALLTIME_REACHED,39773,147,39920,35256,35403,240.83673469387756,11 12 13 14 15,-1
898,w0,100,4517,7,150,0,COMPLETED_WALLTIME_REACHED,39920,150,40070,35403,35553,237.02,0 1 2 3 11 12 13,-1
899,w0,100,4523,3,150,0,COMPLETED_WALLTIME_REACHED,39922,150,40072,35399,35549,236.99333333333334,8 9 10,-1
900,w0,100,4524,3,146,0,COMPLETED_WALLTIME_REACHED,39923,146,40069,35399,35545,243.45890410958904,4 5 6,-1
990,w0,100,4941,3,146,0,COMPLETED_WALLTIME_REACHED,39923,146,40069,34982,35128,240.6027397260274,7 14 15,-1
901,w0,100,4527,5,151,0,COMPLETED_WALLTIME_REACHED,40069,151,40220,35542,35693,236.3774834437086,4 5 6 7 14,-1
902,w0,100,4530,5,149,0,COMPLETED_WALLTIME_REACHED,40070,149,40219,35540,35689,239.5234899328859,0 1 2 3 11,-1
903,w0,100,4533,5,154,0,COMPLETED_WALLTIME_REACHED,40072,154,40226,35539,35693,231.77272727272728,8 9 10 12 13,-1
904,w0,100,4539,3,151,0,COMPLETED_WALLTIME_REACHED,40219,151,40370,35680,35831,237.2913907284768,0 1 2,-1
910,w0,100,4568,3,150,0,COMPLETED_WALLTIME_REACHED,40219,150,40369,35651,35801,238.67333333333335,3 11 15,-1
905,w0,100,4547,5,151,0,COMPLETED_WALLTIME_REACHED,40220,151,40371,35673,35824,237.24503311258277,4 5 6 7 14,-1
906,w0,100,4551,6,148,0,COMPLETED_WALLTIME_REACHED,40369,148,40517,35818,35966,243.01351351351352,3 8 9 10 11 12,-1
907,w0,100,4552,5,153,0,COMPLETED_WALLTIME_REACHED,40370,153,40523,35818,35971,235.1045751633987,0 1 2 13 15,-1
908,w0,100,4553,4,149,0,COMPLETED_WALLTIME_REACHED,40371,149,40520,35818,35967,241.38926174496643,4 5 6 7,-1
909,w0,100,4558,5,147,0,COMPLETED_WALLTIME_REACHED,40517,147,40664,35959,36106,245.61904761904762,3 8 9 10 11,-1
911,w0,100,4569,4,148,0,COMPLETED_WALLTIME_REACHED,40520,148,40668,35951,36099,243.91216216216216,4 5 6 7,-1
912,w0,100,4572,3,151,0,COMPLETED_WALLTIME_REACHED,40523,151,40674,35951,36102,239.08609271523179,0 1 2,-1
913,w0,100,4573,4,154,0,COMPLETED_WALLTIME_REACHED,40523,154,40677,35950,36104,234.44155844155844,12 13 14 15,-1
914,w0,100,4579,4,152,0,COMPLETED_WALLTIME_REACHED,40664,152,40816,36085,36237,238.40131578947367,3 8 9 10,-1
915,w0,100,4588,6,152,0,COMPLETED_WALLTIME_REACHED,40674,152,40826,36086,36238,238.4078947368421,0 1 2 4 5 6,-1
916,w0,100,4589,5,151,0,COMPLETED_WALLTIME_REACHED,40677,151,40828,36088,36239,239.9933774834437,7 11 12 13 14,-1
917,w0,100,4591,5,148,0,COMPLETED_WALLTIME_REACHED,40816,148,40964,36225,36373,245.76351351351352,3 8 9 10 15,-1
918,w0,100,4593,5,149,0,COMPLETED_WALLTIME_REACHED,40826,149,40975,36233,36382,244.1744966442953,0 1 2 4 5,-1
919,w0,100,4594,6,151,0,COMPLETED_WALLTIME_REACHED,40828,151,40979,36234,36385,240.96026490066225,6 7 11 12 13 14,-1
920,w0,100,4614,3,149,0,COMPLETED_WALLTIME_REACHED,40964,149,41113,36350,36499,244.95973154362417,3 8 9,-1
921,w0,100,4624,6,151,0,COMPLETED_WALLTIME_REACHED,40975,151,41126,36351,36502,241.73509933774835,0 1 2 4 5 10,-1
922,w0,100,4629,6,149,0,COMPLETED_WALLTIME_REACHED,40979,149,41128,36350,36499,244.95973154362417,6 7 11 12 13 14,-1
924,w0,100,4655,4,149,0,COMPLETED_WALLTIME_REACHED,41113,149,41262,36458,36607,245.68456375838926,3 8 9 15,-1
923,w0,100,4634,5,149,0,COMPLETED_WALLTIME_REACHED,41126,149,41275,36492,36641,245.91275167785236,0 1 2 4 5,-1
925,w0,100,4659,5,152,0,COMPLETED_WALLTIME_REACHED,41128,152,41280,36469,36621,240.92763157894737,6 7 10 11 12,-1
926,w0,100,4660,4,151,0,COMPLETED_WALLTIME_REACHED,41262,151,41413,36602,36753,243.39735099337747,3 8 9 13,-1
927,w0,100,4660,5,150,0,COMPLETED_WALLTIME_REACHED,41275,150,41425,36615,36765,245.1,0 1 2 4 5,-1
928,w0,100,4669,5,151,0,COMPLETED_WALLTIME_REACHED,41280,151,41431,36611,36762,243.4569536423841,6 7 10 11 12,-1
929,w0,100,4677,4,150,0,COMPLETED_WALLTIME_REACHED,41413,150,41563,36736,36886,245.90666666666667,3 8 9 13,-1
930,w0,100,4683,5,149,0,COMPLETED_WALLTIME_REACHED,41425,149,41574,36742,36891,247.59060402684563,0 1 2 4 5,-1
931,w0,100,4683,4,150,0,COMPLETED_WALLTIME_REACHED,41431,150,41581,36748,36898,245.98666666666668,6 7 10 11,-1
940,w0,100,4734,3,151,0,COMPLETED_WALLTIME_REACHED,41431,151,41582,36697,36848,244.02649006622516,12 14 15,-1
932,w0,100,4683,4,154,0,COMPLETED_WALLTIME_REACHED,41563,154,41717,36880,37034,240.4805194805195,3 8 9 13,-1
933,w0,100,4689,5,148,0,COMPLETED_WALLTIME_REACHED,41574,148,41722,36885,37033,250.22297297297297,0 1 2 4 5,-1
934,w0,100,4690,4,150,0,COMPLETED_WALLTIME_REACHED,41581,150,41731,36891,37041,246.94,6 7 10 11,-1
943,w0,100,4751,3,150,0,COMPLETED_WALLTIME_REACHED,41582,150,41732,36831,36981,246.54,12 14 15,-1
935,w0,100,4701,4,147,0,COMPLETED_WALLTIME_REACHED,41717,147,41864,37016,37163,252.8095238095238,3 8 9 13,-1
936,w0,100,4703,5,148,0,COMPLETED_WALLTIME_REACHED,41722,148,41870,37019,37167,251.1283783783784,0 1 2 4 5,-1
937,w0,100,4710,4,152,0,COMPLETED_WALLTIME_REACHED,41731,152,41883,37021,37173,244.55921052631578,6 7 10 11,-1
980,w0,100,4890,3,151,0,COMPLETED_WALLTIME_REACHED,41732,151,41883,36842,36993,244.98675496688742,12 14 15,-1
938,w0,100,4713,4,152,0,COMPLETED_WALLTIME_REACHED,41864,152,42016,37151,37303,245.41447368421052,3 8 9 13,-1
939,w0,100,4718,5,151,0,COMPLETED_WALLTIME_REACHED,41870,151,42021,37152,37303,247.03973509933775,0 1 2 4 5,-1
941,w0,100,4742,5,150,0,COMPLETED_WALLTIME_REACHED,41883,150,42033,37141,37291,248.60666666666665,6 7 10 11 12,-1
942,w0,100,4745,6,147,0,COMPLETED_WALLTIME_REACHED,42016,147,42163,37271,37418,254.54421768707482,3 8 9 13 14 15,-1
944,w0,100,4753,5,150,0,COMPLETED_WALLTIME_REACHED,42021,150,42171,37268,37418,249.45333333333335,0 1 2 4 5,-1
945,w0,100,4762,5,152,0,COMPLETED_WALLTIME_REACHED,42033,152,42185,37271,37423,246.20394736842104,6 7 10 11 12,-1
946,w0,100,4765,4,150,0,COMPLETED_WALLTIME_REACHED,42163,150,42313,37398,37548,250.32,3 8 9 13,-1
947,w0,100,4773,5,151,0,COMPLETED_WALLTIME_REACHED,42171,151,42322,37398,37549,248.66887417218544,0 1 2 4 5,-1
948,w0,100,4776,5,152,0,COMPLETED_WALLTIME_REACHED,42185,152,42337,37409,37561,247.11184210526315,6 7 10 11 12,-1
949,w0,100,4777,5,152,0,COMPLETED_WALLTIME_REACHED,42313,152,42465,37536,37688,247.94736842105263,3 8 9 13 14,-1
950,w0,100,4781,4,151,0,COMPLETED_WALLTIME_REACHED,42322,151,42473,37541,37692,249.6158940397351,0 1 2 4,-1
951,w0,100,4782,6,149,0,COMPLETED_WALLTIME_REACHED,42337,149,42486,37555,37704,253.04697986577182,5 6 7 10 11 12,-1
952,w0,100,4792,4,150,0,COMPLETED_WALLTIME_REACHED,42465,150,42615,37673,37823,252.15333333333334,3 8 9 13,-1
954,w0,100,4801,4,153,0,COMPLETED_WALLTIME_REACHED,42473,153,42626,37672,37825,247.22222222222223,0 1 2 4,-1
953,w0,100,4797,7,151,0,COMPLETED_WALLTIME_REACHED,42486,151,42637,37689,37840,250.59602649006624,5 6 7 10 11 12 14,-1
955,w0,100,4801,4,147,0,COMPLETED_WALLTIME_REACHED,42615,147,42762,37814,37961,258.23809523809524,3 8 9 13,-1
957,w0,100,4802,5,148,0,COMPLETED_WALLTIME_REACHED,42626,148,42774,37824,37972,256.56756756756755,0 1 2 4 15,-1
956,w0,100,4802,6,146,0,COMPLETED_WALLTIME_REACHED,42637,146,42783,37835,37981,260.14383561643837,5 6 7 10 11 12,-1
958,w0,100,4812,5,150,0,COMPLETED_WALLTIME_REACHED,42762,150,42912,37950,38100,254.0,3 8 9 13 14,-1
959,w0,100,4813,4,147,0,COMPLETED_WALLTIME_REACHED,42774,147,42921,37961,38108,259.23809523809524,0 1 2 4,-1
960,w0,100,4825,4,148,0,COMPLETED_WALLTIME_REACHED,42783,148,42931,37958,38106,257.47297297297297,5 6 7 10,-1
982,w0,100,4894,3,154,0,COMPLETED_WALLTIME_REACHED,42783,154,42937,37889,38043,247.03246753246754,11 12 15,-1
961,w0,100,4826,5,152,0,COMPLETED_WALLTIME_REACHED,42912,152,43064,38086,38238,251.56578947368422,3 8 9 13 14,-1
1000,w0,100,5022,3,150,0,COMPLETED_WALLTIME_REACHED,42921,150,43071,37899,38049,253.66,0 1 2,-1
962,w0,100,4827,5,150,0,COMPLETED_WALLTIME_REACHED,42931,150,43081,38104,38254,255.02666666666667,4 5 6 7 10,-1
963,w0,100,4833,5,150,0,COMPLETED_WALLTIME_REACHED,43064,150,43214,38231,38381,255.87333333333333,3 8 9 11 12,-1
964,w0,100,4833,5,148,0,COMPLETED_WALLTIME_REACHED,43071,148,43219,38238,38386,259.36486486486484,0 1 2 13 14,-1
965,w0,100,4836,5,145,0,COMPLETED_WALLTIME_REACHED,43081,145,43226,38245,38390,264.7586206896552,4 5 6 7 10,-1
966,w0,100,4848,5,151,0,COMPLETED_WALLTIME_REACHED,43214,151,43365,38366,38517,255.0794701986755,3 8 9 11 12,-1
967,w0,100,4851,5,150,0,COMPLETED_WALLTIME_REACHED,43219,150,43369,38368,38518,256.7866666666667,0 1 2 13 14,-1
968,w0,100,4851,5,147,0,COMPLETED_WALLTIME_REACHED,43226,147,43373,38375,38522,262.05442176870747,4 5 6 7 10,-1
969,w0,100,4852,5,150,0,COMPLETED_WALLTIME_REACHED,43365,150,43515,38513,38663,257.75333333333333,3 8 9 11 12,-1
970,w0,100,4854,4,149,0,COMPLETED_WALLTIME_REACHED,43369,149,43518,38515,38664,259.48993288590606,0 1 2 13,-1
971,w0,100,4856,4,150,0,COMPLETED_WALLTIME_REACHED,43373,150,43523,38517,38667,257.78,4 5 6 7,-1
972,w0,100,4859,5,148,0,COMPLETED_WALLTIME_REACHED,43515,148,43663,38656,38804,262.18918918918916,3 8 9 10 11,-1
973,w0,100,4865,5,150,0,COMPLETED_WALLTIME_REACHED,43518,150,43668,38653,38803,258.68666666666667,0 1 2 12 13,-1
974,w0,100,4872,6,146,0,COMPLETED_WALLTIME_REACHED,43523,146,43669,38651,38797,265.7328767123288,4 5 6 7 14 15,-1
975,w0,100,4873,5,147,0,COMPLETED_WALLTIME_REACHED,43663,147,43810,38790,38937,264.8775510204082,3 8 9 10 11,-1
977,w0,100,4885,4,144,0,COMPLETED_WALLTIME_REACHED,43668,144,43812,38783,38927,270.3263888888889,0 1 2 12,-1
976,w0,100,4874,7,150,0,COMPLETED_WALLTIME_REACHED,43669,150,43819,38795,38945,259.6333333333333,4 5 6 7 13 14 15,-1
978,w0,100,4887,5,148,0,COMPLETED_WALLTIME_REACHED,43810,148,43958,38923,39071,263.9932432432432,3 8 9 10 11,-1
981,w0,100,4893,4,148,0,COMPLETED_WALLTIME_REACHED,43812,148,43960,38919,39067,263.9662162162162,0 1 2 12,-1
979,w0,100,4889,5,150,0,COMPLETED_WALLTIME_REACHED,43819,150,43969,38930,39080,260.53333333333336,4 5 6 7 13,-1
983,w0,100,4904,5,150,0,COMPLETED_WALLTIME_REACHED,43958,150,44108,39054,39204,261.36,3 8 9 10 11,-1
984,w0,100,4912,5,149,0,COMPLETED_WALLTIME_REACHED,43960,149,44109,39048,39197,263.06711409395973,0 1 2 12 14,-1
985,w0,100,4920,5,152,0,COMPLETED_WALLTIME_REACHED,43969,152,44121,39049,39201,257.9013157894737,4 5 6 7 13,-1
986,w0,100,4923,6,148,0,COMPLETED_WALLTIME_REACHED,44108,148,44256,39185,39333,265.7635135135135,3 8 9 10 11 15,-1
987,w0,100,4923,5,152,0,COMPLETED_WALLTIME_REACHED,44109,152,44261,39186,39338,258.80263157894734,0 1 2 12 14,-1
988,w0,100,4927,4,149,0,COMPLETED_WALLTIME_REACHED,44121,149,44270,39194,39343,264.0469798657718,4 5 6 7,-1
991,w0,100,4953,5,150,0,COMPLETED_WALLTIME_REACHED,44256,150,44406,39303,39453,263.02,3 8 9 10 11,-1
993,w0,100,4985,5,149,0,COMPLETED_WALLTIME_REACHED,44261,149,44410,39276,39425,264.5973154362416,0 1 2 12 13,-1
994,w0,100,4996,6,152,0,COMPLETED_WALLTIME_REACHED,44270,152,44422,39274,39426,259.38157894736844,4 5 6 7 14 15,-1
995,w0,100,4996,6,152,0,COMPLETED_WALLTIME_REACHED,44410,152,44562,39414,39566,260.30263157894734,0 1 2 3 8 9,-1
997,w0,100,5004,5,150,0,COMPLETED_WALLTIME_REACHED,44422,150,44572,39418,39568,263.7866666666667,4 5 6 7 10,-1
998,w0,100,5013,5,154,0,COMPLETED_WALLTIME_REACHED,44422,154,44576,39409,39563,256.9025974025974,11 12 13 14 15,-1
999,w0,100,5021,5,151,0,COMPLETED_WALLTIME_REACHED,44562,151,44713,39541,39692,262.86092715231786,0 1 2 3 8,-1
