job_id,workload_name,profile,submission_time,requested_number_of_resources,requested_time,success,final_state,starting_time,execution_time,finish_time,waiting_time,turnaround_time,stretch,allocated_resources,consumed_energy
1,w0,100,1,3,151,0,COMPLETED_WALLTIME_REACHED,1,151,152,0,151,1.0,0 1 2,-1
2,w0,100,1,4,153,0,COMPLETED_WALLTIME_REACHED,1,153,154,0,153,1.0,3 4 5 6,-1
3,w0,100,23,4,146,0,COMPLETED_WALLTIME_REACHED,152,146,298,129,275,1.8835616438356164,0 1 2 7,-1
4,w0,100,30,4,149,0,COMPLETED_WALLTIME_REACHED,154,149,303,124,273,1.832214765100671,3 4 5 6,-1
5,w0,100,34,4,150,0,COMPLETED_WALLTIME_REACHED,298,150,448,264,414,2.76,0 1 2 7,-1
6,w0,100,35,2,147,0,COMPLETED_WALLTIME_REACHED,303,147,450,268,415,2.82312925170068,3 4,-1
11,w0,100,58,2,150,0,COMPLETED_WALLTIME_REACHED,303,150,453,245,395,2.6333333333333333,5 6,-1
7,w0,100,36,3,149,0,COMPLETED_WALLTIME_REACHED,448,149,597,412,561,3.7651006711409396,0 1 2,-1
8,w0,100,42,3,151,0,COMPLETED_WALLTIME_REACHED,450,151,601,408,559,3.7019867549668874,3 4 7,-1
18,w0,100,88,1,150,0,COMPLETED_WALLTIME_REACHED,453,150,603,365,515,3.433333333333333,5,-1
9,w0,100,50,4,151,0,COMPLETED_WALLTIME_REACHED,597,151,748,547,698,4.622516556291391,0 1 2 6,-1
10,w0,100,55,4,152,0,COMPLETED_WALLTIME_REACHED,603,152,755,548,700,4.605263157894737,3 4 5 7,-1
12,w0,100,66,3,151,0,COMPLETED_WALLTIME_REACHED,748,151,899,682,833,5.516556291390729,0 1 2,-1
13,w0,100,67,4,149,0,COMPLETED_WALLTIME_REACHED,755,149,904,688,837,5.617449664429531,3 4 5 6,-1
14,w0,100,70,4,150,0,COMPLETED_WALLTIME_REACHED,899,150,1049,829,979,6.526666666666666,0 1 2 7,-1
15,w0,100,70,2,153,0,COMPLETED_WALLTIME_REACHED,904,153,1057,834,987,6.450980392156863,3 4,-1
19,w0,100,89,2,149,0,COMPLETED_WALLTIME_REACHED,904,149,1053,815,964,6.469798657718121,5 6,-1
16,w0,100,82,4,150,0,COMPLETED_WALLTIME_REACHED,1049,150,1199,967,1117,7.446666666666666,0 1 2 7,-1
17,w0,100,84,4,149,0,COMPLETED_WALLTIME_REACHED,1057,149,1206,973,1122,7.530201342281879,3 4 5 6,-1
20,w0,100,93,3,150,0,COMPLETED_WALLTIME_REACHED,1199,150,1349,1106,1256,8.373333333333333,0 1 2,-1
