job_id,workload_name,profile,submission_time,requested_number_of_resources,requested_time,success,final_state,starting_time,execution_time,finish_time,waiting_time,turnaround_time,stretch,allocated_resources,consumed_energy
1,w0,100,1,3,151,0,COMPLETED_WALLTIME_REACHED,1,151,152,0,151,1.0,0 1 2,-1
2,w0,100,1,4,153,0,COMPLETED_WALLTIME_REACHED,1,153,154,0,153,1.0,3 4 5 6,-1
4,w0,100,30,4,149,0,COMPLETED_WALLTIME_REACHED,154,149,303,124,273,1.832214765100671,3 4 5 6,-1
3,w0,100,23,4,146,0,COMPLETED_WALLTIME_REACHED,157,146,303,134,280,1.917808219178082,0 1 2 7,-1
5,w0,100,34,4,150,0,COMPLETED_WALLTIME_REACHED,303,150,453,269,419,2.7933333333333334,0 1 2 3,-1
6,w0,100,35,2,147,0,COMPLETED_WALLTIME_REACHED,303,147,450,268,415,2.82312925170068,4 5,-1
8,w0,100,42,3,151,0,COMPLETED_WALLTIME_REACHED,453,151,604,411,562,3.7218543046357615,0 1 2,-1
7,w0,100,36,3,149,0,COMPLETED_WALLTIME_REACHED,455,149,604,419,568,3.8120805369127515,4 5 6,-1
9,w0,100,50,4,151,0,COMPLETED_WALLTIME_REACHED,604,151,755,554,705,4.66887417218543,0 1 2 4,-1
10,w0,100,55,4,152,0,COMPLETED_WALLTIME_REACHED,609,152,761,554,706,4.644736842105263,5 6 3 7,-1
11,w0,100,58,2,150,0,COMPLETED_WALLTIME_REACHED,755,150,905,697,847,5.6466666666666665,0 1,-1
12,w0,100,66,3,151,0,COMPLETED_WALLTIME_REACHED,761,151,912,695,846,5.602649006622516,2 3 4,-1
13,w0,100,67,4,149,0,COMPLETED_WALLTIME_REACHED,910,149,1059,843,992,6.657718120805369,0 1 5 6,-1
14,w0,100,70,4,150,0,COMPLETED_WALLTIME_REACHED,917,150,1067,847,997,6.6466666666666665,2 3 4 7,-1
15,w0,100,70,2,153,0,COMPLETED_WALLTIME_REACHED,1059,153,1212,989,1142,7.4640522875816995,0 1,-1
16,w0,100,82,4,150,0,COMPLETED_WALLTIME_REACHED,1067,150,1217,985,1135,7.566666666666666,2 3 4 5,-1
17,w0,100,84,4,149,0,COMPLETED_WALLTIME_REACHED,1217,149,1366,1133,1282,8.604026845637584,0 1 6 7,-1
18,w0,100,88,1,150,0,COMPLETED_WALLTIME_REACHED,1217,150,1367,1129,1279,8.526666666666667,2,-1
19,w0,100,89,2,149,0,COMPLETED_WALLTIME_REACHED,1217,149,1366,1128,1277,8.570469798657719,3 4,-1
20,w0,100,93,3,150,0,COMPLETED_WALLTIME_REACHED,1366,150,1516,1273,1423,9.486666666666666,0 1 3,-1
