job_id,workload_name,profile,submission_time,requested_number_of_resources,requested_time,success,final_state,starting_time,execution_time,finish_time,waiting_time,turnaround_time,stretch,allocated_resources,consumed_energy
1,w0,100,2,4,144,0,COMPLETED_WALLTIME_REACHED,2,144,146,0,144,1.0,0 1 2 3,-1
2,w0,100,23,3,151,0,COMPLETED_WALLTIME_REACHED,23,151,174,0,151,1.0,4 5 6,-1
3,w0,100,31,4,150,0,COMPLETED_WALLTIME_REACHED,146,150,296,115,265,1.7666666666666666,0 1 2 3,-1
4,w0,100,34,2,151,0,COMPLETED_WALLTIME_REACHED,174,151,325,140,291,1.9271523178807948,4 5,-1
5,w0,100,47,4,148,0,COMPLETED_WALLTIME_REACHED,296,148,444,249,397,2.6824324324324325,0 1 2 3,-1
6,w0,100,47,4,149,0,COMPLETED_WALLTIME_REACHED,330,149,479,283,432,2.8993288590604025,4 5 6 7,-1
7,w0,100,55,3,148,0,COMPLETED_WALLTIME_REACHED,444,148,592,389,537,3.6283783783783785,0 1 2,-1
8,w0,100,64,4,150,0,COMPLETED_WALLTIME_REACHED,479,150,629,415,565,3.7666666666666666,4 5 6 7,-1
9,w0,100,78,2,153,0,COMPLETED_WALLTIME_REACHED,592,153,745,514,667,4.359477124183006,0 1,-1
10,w0,100,89,4,153,0,COMPLETED_WALLTIME_REACHED,629,153,782,540,693,4.529411764705882,4 5 6 7,-1
11,w0,100,97,3,150,0,COMPLETED_WALLTIME_REACHED,750,150,900,653,803,5.3533333333333335,0 1 2,-1
12,w0,100,97,4,151,0,COMPLETED_WALLTIME_REACHED,782,151,933,685,836,5.5364238410596025,4 5 6 7,-1
13,w0,100,111,2,151,0,COMPLETED_WALLTIME_REACHED,900,151,1051,789,940,6.225165562913907,0 1,-1
14,w0,100,117,2,148,0,COMPLETED_WALLTIME_REACHED,905,148,1053,788,936,6.324324324324325,2 3,-1
15,w0,100,126,2,150,0,COMPLETED_WALLTIME_REACHED,933,150,1083,807,957,6.38,4 5,-1
16,w0,100,127,3,150,0,COMPLETED_WALLTIME_REACHED,1056,150,1206,929,1079,7.193333333333333,0 1 6,-1
17,w0,100,134,3,152,0,COMPLETED_WALLTIME_REACHED,1058,152,1210,924,1076,7.078947368421052,2 3 7,-1
18,w0,100,134,3,147,0,COMPLETED_WALLTIME_REACHED,1206,147,1353,1072,1219,8.29251700680272,0 1 6,-1
19,w0,100,136,4,148,0,COMPLETED_WALLTIME_REACHED,1215,148,1363,1079,1227,8.29054054054054,2 3 7 4,-1
20,w0,100,138,4,151,0,COMPLETED_WALLTIME_REACHED,1358,151,1509,1220,1371,9.079470198675496,0 1 6 5,-1
