job_id,workload_name,profile,submission_time,requested_number_of_resources,requested_time,success,final_state,starting_time,execution_time,finish_time,waiting_time,turnaround_time,stretch,allocated_resources,consumed_energy
1,w0,100,2,4,144,0,COMPLETED_WALLTIME_REACHED,2,144,146,0,144,1.0,0 1 2 3,-1
2,w0,100,23,3,151,0,COMPLETED_WALLTIME_REACHED,23,151,174,0,151,1.0,4 5 6,-1
3,w0,100,31,4,150,0,COMPLETED_WALLTIME_REACHED,146,150,296,115,265,1.7666666666666666,0 1 2 3,-1
4,w0,100,34,2,151,0,COMPLETED_WALLTIME_REACHED,174,151,325,140,291,1.9271523178807948,4 5,-1
9,w0,100,78,2,153,0,COMPLETED_WALLTIME_REACHED,174,153,327,96,249,1.6274509803921569,6 7,-1
5,w0,100,47,4,148,0,COMPLETED_WALLTIME_REACHED,296,148,444,249,397,2.6824324324324325,0 1 2 3,-1
6,w0,100,47,4,149,0,COMPLETED_WALLTIME_REACHED,327,149,476,280,429,2.879194630872483,4 5 6 7,-1
7,w0,100,55,3,148,0,COMPLETED_WALLTIME_REACHED,444,148,592,389,537,3.6283783783783785,0 1 2,-1
8,w0,100,64,4,150,0,COMPLETED_WALLTIME_REACHED,476,150,626,412,562,3.7466666666666666,3 4 5 6,-1
10,w0,100,89,4,153,0,COMPLETED_WALLTIME_REACHED,592,153,745,503,656,4.287581699346405,0 1 2 7,-1
11,w0,100,97,3,150,0,COMPLETED_WALLTIME_REACHED,626,150,776,529,679,4.526666666666666,3 4 5,-1
12,w0,100,97,4,151,0,COMPLETED_WALLTIME_REACHED,745,151,896,648,799,5.291390728476821,0 1 2 6,-1
13,w0,100,111,2,151,0,COMPLETED_WALLTIME_REACHED,776,151,927,665,816,5.403973509933775,3 4,-1
14,w0,100,117,2,148,0,COMPLETED_WALLTIME_REACHED,776,148,924,659,807,5.452702702702703,5 7,-1
15,w0,100,126,2,150,0,COMPLETED_WALLTIME_REACHED,896,150,1046,770,920,6.133333333333334,0 1,-1
16,w0,100,127,3,150,0,COMPLETED_WALLTIME_REACHED,924,150,1074,797,947,6.3133333333333335,2 5 6,-1
17,w0,100,134,3,152,0,COMPLETED_WALLTIME_REACHED,927,152,1079,793,945,6.217105263157895,3 4 7,-1
18,w0,100,134,3,147,0,COMPLETED_WALLTIME_REACHED,1074,147,1221,940,1087,7.394557823129252,0 1 2,-1
19,w0,100,136,4,148,0,COMPLETED_WALLTIME_REACHED,1079,148,1227,943,1091,7.371621621621622,3 4 5 6,-1
20,w0,100,138,4,151,0,COMPLETED_WALLTIME_REACHED,1221,151,1372,1083,1234,8.172185430463577,0 1 2 7,-1
