job_id,workload_name,profile,submission_time,requested_number_of_resources,requested_time,success,final_state,starting_time,execution_time,finish_time,waiting_time,turnaround_time,stretch,allocated_resources,consumed_energy
1,w0,100,4,4,151,0,COMPLETED_WALLTIME_REACHED,14,151,165,10,161,1.0662251655629138,3 4 5 7,-1
2,w0,100,6,5,152,0,COMPLETED_WALLTIME_REACHED,24,152,176,18,170,1.118421052631579,0 1 2 6 8,-1
3,w0,100,8,4,152,0,COMPLETED_WALLTIME_REACHED,24,152,176,16,168,1.105263157894737,9 10 11 14,-1
5,w0,100,11,4,150,0,COMPLETED_WALLTIME_REACHED,180,150,330,169,319,2.1266666666666665,3 4 5 7,-1
4,w0,100,9,6,151,0,COMPLETED_WALLTIME_REACHED,196,151,347,187,338,2.23841059602649,2 9 10 11 12 13,-1
6,w0,100,12,6,149,0,COMPLETED_WALLTIME_REACHED,241,149,390,229,378,2.5369127516778525,0 1 6 8 14 15,-1
7,w0,100,14,4,150,0,COMPLETED_WALLTIME_REACHED,350,150,500,336,486,3.24,3 4 5 7,-1
8,w0,100,14,5,153,0,COMPLETED_WALLTIME_REACHED,360,153,513,346,499,3.261437908496732,2 9 10 12 13,-1
9,w0,100,17,4,147,0,COMPLETED_WALLTIME_REACHED,400,147,547,383,530,3.6054421768707483,1 6 8 11,-1
10,w0,100,18,4,147,0,COMPLETED_WALLTIME_REACHED,510,147,657,492,639,4.346938775510204,0 3 4 5,-1
