job_id,workload_name,profile,submission_time,requested_number_of_resources,requested_time,success,final_state,starting_time,execution_time,finish_time,waiting_time,turnaround_time,stretch,allocated_resources,consumed_energy
1,w0,100,13,6,150,0,COMPLETED_WALLTIME_REACHED,13,150,163,0,150,1.0,0 1 2 3 4 5,-1
2,w0,100,36,4,151,0,COMPLETED_WALLTIME_REACHED,36,151,187,0,151,1.0,6 7 8 9,-1
3,w0,100,42,6,152,0,COMPLETED_WALLTIME_REACHED,42,152,194,0,152,1.0,10 11 12 13 14 15,-1
4,w0,100,47,6,154,0,COMPLETED_WALLTIME_REACHED,163,154,317,116,270,1.7532467532467533,0 1 2 3 4 5,-1
6,w0,100,67,4,153,0,COMPLETED_WALLTIME_REACHED,187,153,340,120,273,1.7843137254901962,6 7 8 9,-1
5,w0,100,66,5,155,0,COMPLETED_WALLTIME_REACHED,194,155,349,128,283,1.8258064516129033,10 11 12 13 14,-1
7,w0,100,77,3,147,0,COMPLETED_WALLTIME_REACHED,317,147,464,240,387,2.63265306122449,0 1 2,-1
15,w0,100,107,3,154,0,COMPLETED_WALLTIME_REACHED,317,154,471,210,364,2.3636363636363638,3 4 5,-1
8,w0,100,81,5,152,0,COMPLETED_WALLTIME_REACHED,345,152,497,264,416,2.736842105263158,6 7 8 9 15,-1
9,w0,100,85,5,152,0,COMPLETED_WALLTIME_REACHED,349,152,501,264,416,2.736842105263158,10 11 12 13 14,-1
10,w0,100,97,6,150,0,COMPLETED_WALLTIME_REACHED,471,150,621,374,524,3.493333333333333,0 1 2 3 4 5,-1
11,w0,100,98,5,151,0,COMPLETED_WALLTIME_REACHED,497,151,648,399,550,3.642384105960265,6 7 8 9 15,-1
12,w0,100,99,4,150,0,COMPLETED_WALLTIME_REACHED,501,150,651,402,552,3.68,10 11 12 13,-1
13,w0,100,100,4,149,0,COMPLETED_WALLTIME_REACHED,621,149,770,521,670,4.496644295302014,0 1 2 3,-1
28,w0,100,156,3,150,0,COMPLETED_WALLTIME_REACHED,626,150,776,470,620,4.133333333333334,4 5 14,-1
14,w0,100,101,4,147,0,COMPLETED_WALLTIME_REACHED,648,147,795,547,694,4.72108843537415,6 7 8 9,-1
16,w0,100,108,4,147,0,COMPLETED_WALLTIME_REACHED,651,147,798,543,690,4.6938775510204085,10 11 12 13,-1
43,w0,100,254,2,149,0,COMPLETED_WALLTIME_REACHED,770,149,919,516,665,4.4630872483221475,0 1,-1
17,w0,100,113,6,151,0,COMPLETED_WALLTIME_REACHED,781,151,932,668,819,5.423841059602649,2 3 4 5 14 15,-1
35,w0,100,208,3,153,0,COMPLETED_WALLTIME_REACHED,795,153,948,587,740,4.836601307189542,6 7 8,-1
18,w0,100,114,5,151,0,COMPLETED_WALLTIME_REACHED,798,151,949,684,835,5.529801324503311,9 10 11 12 13,-1
19,w0,100,115,4,148,0,COMPLETED_WALLTIME_REACHED,932,148,1080,817,965,6.52027027027027,0 1 2 3,-1
20,w0,100,121,5,151,0,COMPLETED_WALLTIME_REACHED,948,151,1099,827,978,6.47682119205298,4 5 6 7 8,-1
21,w0,100,134,5,149,0,COMPLETED_WALLTIME_REACHED,949,149,1098,815,964,6.469798657718121,9 10 11 12 13,-1
196,w0,100,1057,1,152,0,COMPLETED_WALLTIME_REACHED,1062,152,1214,5,157,1.0328947368421053,14,-1
22,w0,100,138,5,152,0,COMPLETED_WALLTIME_REACHED,1085,152,1237,947,1099,7.230263157894737,0 1 2 3 15,-1
30,w0,100,171,4,149,0,COMPLETED_WALLTIME_REACHED,1098,149,1247,927,1076,7.221476510067114,9 10 11 12,-1
23,w0,100,138,6,151,0,COMPLETED_WALLTIME_REACHED,1099,151,1250,961,1112,7.364238410596027,4 5 6 7 8 13,-1
24,w0,100,142,5,145,0,COMPLETED_WALLTIME_REACHED,1237,145,1382,1095,1240,8.551724137931034,0 1 2 3 14,-1
26,w0,100,153,5,147,0,COMPLETED_WALLTIME_REACHED,1247,147,1394,1094,1241,8.4421768707483,9 10 11 12 15,-1
25,w0,100,152,6,147,0,COMPLETED_WALLTIME_REACHED,1250,147,1397,1098,1245,8.46938775510204,4 5 6 7 8 13,-1
27,w0,100,153,5,146,0,COMPLETED_WALLTIME_REACHED,1382,146,1528,1229,1375,9.417808219178083,0 1 2 3 14,-1
31,w0,100,175,5,151,0,COMPLETED_WALLTIME_REACHED,1394,151,1545,1219,1370,9.072847682119205,9 10 11 12 15,-1
29,w0,100,171,6,151,0,COMPLETED_WALLTIME_REACHED,1397,151,1548,1226,1377,9.119205298013245,4 5 6 7 8 13,-1
32,w0,100,190,4,151,0,COMPLETED_WALLTIME_REACHED,1528,151,1679,1338,1489,9.860927152317881,0 1 2 3,-1
33,w0,100,199,4,148,0,COMPLETED_WALLTIME_REACHED,1545,148,1693,1346,1494,10.094594594594595,9 10 11 12,-1
258,w0,100,1315,2,151,0,COMPLETED_WALLTIME_REACHED,1545,151,1696,230,381,2.5231788079470197,14 15,-1
34,w0,100,202,4,149,0,COMPLETED_WALLTIME_REACHED,1548,149,1697,1346,1495,10.033557046979865,4 5 6 7,-1
263,w0,100,1352,2,151,0,COMPLETED_WALLTIME_REACHED,1548,151,1699,196,347,2.2980132450331126,8 13,-1
36,w0,100,208,3,150,0,COMPLETED_WALLTIME_REACHED,1679,150,1829,1471,1621,10.806666666666667,0 1 2,-1
37,w0,100,211,5,153,0,COMPLETED_WALLTIME_REACHED,1693,153,1846,1482,1635,10.686274509803921,3 9 10 11 12,-1
325,w0,100,1601,1,150,0,COMPLETED_WALLTIME_REACHED,1696,150,1846,95,245,1.6333333333333333,14,-1
38,w0,100,229,5,151,0,COMPLETED_WALLTIME_REACHED,1697,151,1848,1468,1619,10.721854304635762,4 5 6 7 15,-1
39,w0,100,237,5,149,0,COMPLETED_WALLTIME_REACHED,1834,149,1983,1597,1746,11.718120805369127,0 1 2 8 13,-1
40,w0,100,239,6,150,0,COMPLETED_WALLTIME_REACHED,1846,150,1996,1607,1757,11.713333333333333,3 9 10 11 12 14,-1
41,w0,100,246,3,151,0,COMPLETED_WALLTIME_REACHED,1848,151,1999,1602,1753,11.609271523178808,4 5 6,-1
290,w0,100,1450,2,152,0,COMPLETED_WALLTIME_REACHED,1848,152,2000,398,550,3.6184210526315788,7 15,-1
42,w0,100,250,5,149,0,COMPLETED_WALLTIME_REACHED,1983,149,2132,1733,1882,12.630872483221477,0 1 2 8 13,-1
44,w0,100,261,6,149,0,COMPLETED_WALLTIME_REACHED,1996,149,2145,1735,1884,12.644295302013424,3 9 10 11 12 14,-1
45,w0,100,273,4,150,0,COMPLETED_WALLTIME_REACHED,2000,150,2150,1727,1877,12.513333333333334,4 5 6 7,-1
46,w0,100,285,5,148,0,COMPLETED_WALLTIME_REACHED,2132,148,2280,1847,1995,13.47972972972973,0 1 2 8 13,-1
47,w0,100,286,5,151,0,COMPLETED_WALLTIME_REACHED,2145,151,2296,1859,2010,13.311258278145695,3 9 10 11 12,-1
382,w0,100,1902,2,153,0,COMPLETED_WALLTIME_REACHED,2150,153,2303,248,401,2.6209150326797386,14 15,-1
48,w0,100,294,4,149,0,COMPLETED_WALLTIME_REACHED,2150,149,2299,1856,2005,13.456375838926174,4 5 6 7,-1
49,w0,100,305,5,151,0,COMPLETED_WALLTIME_REACHED,2280,151,2431,1975,2126,14.079470198675496,0 1 2 8 13,-1
57,w0,100,360,3,149,0,COMPLETED_WALLTIME_REACHED,2296,149,2445,1936,2085,13.993288590604028,3 9 10,-1
50,w0,100,306,6,152,0,COMPLETED_WALLTIME_REACHED,2299,152,2451,1993,2145,14.111842105263158,4 5 6 7 11 12,-1
405,w0,100,2033,2,151,0,COMPLETED_WALLTIME_REACHED,2303,151,2454,270,421,2.7880794701986753,14 15,-1
51,w0,100,308,4,150,0,COMPLETED_WALLTIME_REACHED,2431,150,2581,2123,2273,15.153333333333334,0 1 2 8,-1
52,w0,100,330,4,148,0,COMPLETED_WALLTIME_REACHED,2445,148,2593,2115,2263,15.29054054054054,3 9 10 13,-1
53,w0,100,335,5,147,0,COMPLETED_WALLTIME_REACHED,2451,147,2598,2116,2263,15.394557823129253,4 5 6 7 11,-1
416,w0,100,2083,2,147,0,COMPLETED_WALLTIME_REACHED,2454,147,2601,371,518,3.5238095238095237,12 14,-1
54,w0,100,335,5,148,0,COMPLETED_WALLTIME_REACHED,2586,148,2734,2251,2399,16.20945945945946,0 1 2 8 15,-1
55,w0,100,338,4,152,0,COMPLETED_WALLTIME_REACHED,2593,152,2745,2255,2407,15.835526315789474,3 9 10 13,-1
56,w0,100,350,5,147,0,COMPLETED_WALLTIME_REACHED,2598,147,2745,2248,2395,16.292517006802722,4 5 6 7 11,-1
58,w0,100,363,6,150,0,COMPLETED_WALLTIME_REACHED,2739,150,2889,2376,2526,16.84,0 1 2 8 12 14,-1
59,w0,100,367,6,150,0,COMPLETED_WALLTIME_REACHED,2745,150,2895,2378,2528,16.85333333333333,3 4 5 6 7 9,-1
64,w0,100,419,4,148,0,COMPLETED_WALLTIME_REACHED,2745,148,2893,2326,2474,16.716216216216218,10 11 13 15,-1
60,w0,100,376,5,146,0,COMPLETED_WALLTIME_REACHED,2889,146,3035,2513,2659,18.21232876712329,0 1 2 8 12,-1
62,w0,100,407,5,149,0,COMPLETED_WALLTIME_REACHED,2893,149,3042,2486,2635,17.684563758389263,10 11 13 14 15,-1
61,w0,100,398,6,152,0,COMPLETED_WALLTIME_REACHED,2895,152,3047,2497,2649,17.42763157894737,3 4 5 6 7 9,-1
63,w0,100,409,5,148,0,COMPLETED_WALLTIME_REACHED,3035,148,3183,2626,2774,18.743243243243242,0 1 2 8 12,-1
65,w0,100,420,5,149,0,COMPLETED_WALLTIME_REACHED,3042,149,3191,2622,2771,18.59731543624161,10 11 13 14 15,-1
66,w0,100,433,5,152,0,COMPLETED_WALLTIME_REACHED,3047,152,3199,2614,2766,18.19736842105263,3 4 5 6 7,-1
67,w0,100,446,6,147,0,COMPLETED_WALLTIME_REACHED,3188,147,3335,2742,2889,19.653061224489797,0 1 2 8 9 12,-1
68,w0,100,450,5,149,0,COMPLETED_WALLTIME_REACHED,3191,149,3340,2741,2890,19.395973154362416,10 11 13 14 15,-1
69,w0,100,452,4,149,0,COMPLETED_WALLTIME_REACHED,3199,149,3348,2747,2896,19.436241610738254,3 4 5 6,-1
77,w0,100,485,3,155,0,COMPLETED_WALLTIME_REACHED,3335,155,3490,2850,3005,19.387096774193548,8 9 12,-1
70,w0,100,455,4,148,0,COMPLETED_WALLTIME_REACHED,3340,148,3488,2885,3033,20.493243243243242,0 1 2 7,-1
71,w0,100,460,4,153,0,COMPLETED_WALLTIME_REACHED,3340,153,3493,2880,3033,19.823529411764707,10 11 13 14,-1
86,w0,100,527,3,148,0,COMPLETED_WALLTIME_REACHED,3348,148,3496,2821,2969,20.06081081081081,3 4 5,-1
88,w0,100,545,3,152,0,COMPLETED_WALLTIME_REACHED,3490,152,3642,2945,3097,20.375,8 9 12,-1
72,w0,100,460,6,148,0,COMPLETED_WALLTIME_REACHED,3493,148,3641,3033,3181,21.493243243243242,0 1 2 6 7 15,-1
73,w0,100,461,4,150,0,COMPLETED_WALLTIME_REACHED,3493,150,3643,3032,3182,21.213333333333335,10 11 13 14,-1
90,w0,100,551,3,150,0,COMPLETED_WALLTIME_REACHED,3496,150,3646,2945,3095,20.633333333333333,3 4 5,-1
74,w0,100,467,5,153,0,COMPLETED_WALLTIME_REACHED,3641,153,3794,3174,3327,21.745098039215687,0 1 2 6 7,-1
119,w0,100,742,3,152,0,COMPLETED_WALLTIME_REACHED,3642,152,3794,2900,3052,20.07894736842105,8 9 12,-1
75,w0,100,475,5,150,0,COMPLETED_WALLTIME_REACHED,3643,150,3793,3168,3318,22.12,10 11 13 14 15,-1
120,w0,100,744,3,150,0,COMPLETED_WALLTIME_REACHED,3646,150,3796,2902,3052,20.346666666666668,3 4 5,-1
76,w0,100,476,5,153,0,COMPLETED_WALLTIME_REACHED,3793,153,3946,3317,3470,22.679738562091504,10 11 13 14 15,-1
78,w0,100,487,6,149,0,COMPLETED_WALLTIME_REACHED,3794,149,3943,3307,3456,23.19463087248322,0 1 2 6 7 8,-1
79,w0,100,492,5,146,0,COMPLETED_WALLTIME_REACHED,3796,146,3942,3304,3450,23.63013698630137,3 4 5 9 12,-1
80,w0,100,498,5,150,0,COMPLETED_WALLTIME_REACHED,3942,150,4092,3444,3594,23.96,3 4 5 9 12,-1
81,w0,100,506,5,153,0,COMPLETED_WALLTIME_REACHED,3943,153,4096,3437,3590,23.464052287581698,0 1 2 6 7,-1
82,w0,100,507,5,148,0,COMPLETED_WALLTIME_REACHED,3946,148,4094,3439,3587,24.236486486486488,8 10 11 13 14,-1
83,w0,100,518,4,152,0,COMPLETED_WALLTIME_REACHED,4092,152,4244,3574,3726,24.513157894736842,3 4 5 9,-1
84,w0,100,519,4,153,0,COMPLETED_WALLTIME_REACHED,4094,153,4247,3575,3728,24.366013071895424,8 10 11 13,-1
85,w0,100,520,4,151,0,COMPLETED_WALLTIME_REACHED,4096,151,4247,3576,3727,24.68211920529801,0 1 2 6,-1
494,w0,100,2498,2,149,0,COMPLETED_WALLTIME_REACHED,4096,149,4245,1598,1747,11.724832214765101,7 14,-1
443,w0,100,2226,2,149,0,COMPLETED_WALLTIME_REACHED,4097,149,4246,1871,2020,13.557046979865772,12 15,-1
87,w0,100,544,4,151,0,COMPLETED_WALLTIME_REACHED,4244,151,4395,3700,3851,25.503311258278146,3 4 5 9,-1
500,w0,100,2521,2,147,0,COMPLETED_WALLTIME_REACHED,4245,147,4392,1724,1871,12.727891156462585,7 14,-1
540,w0,100,2701,2,149,0,COMPLETED_WALLTIME_REACHED,4246,149,4395,1545,1694,11.369127516778523,12 15,-1
89,w0,100,548,6,150,0,COMPLETED_WALLTIME_REACHED,4247,150,4397,3699,3849,25.66,0 1 2 6 8 10,-1
92,w0,100,553,5,148,0,COMPLETED_WALLTIME_REACHED,4395,148,4543,3842,3990,26.95945945945946,3 4 5 9 12,-1
91,w0,100,552,4,147,0,COMPLETED_WALLTIME_REACHED,4397,147,4544,3845,3992,27.156462585034014,7 11 13 14,-1
93,w0,100,560,6,149,0,COMPLETED_WALLTIME_REACHED,4397,149,4546,3837,3986,26.751677852348994,0 1 2 6 8 10,-1
94,w0,100,566,5,153,0,COMPLETED_WALLTIME_REACHED,4543,153,4696,3977,4130,26.99346405228758,3 4 5 9 12,-1
100,w0,100,603,4,146,0,COMPLETED_WALLTIME_REACHED,4544,146,4690,3941,4087,27.993150684931507,7 11 13 14,-1
95,w0,100,569,7,151,0,COMPLETED_WALLTIME_REACHED,4551,151,4702,3982,4133,27.370860927152318,0 1 2 6 8 10 15,-1
101,w0,100,610,4,150,0,COMPLETED_WALLTIME_REACHED,4690,150,4840,4080,4230,28.2,7 11 13 14,-1
96,w0,100,575,5,151,0,COMPLETED_WALLTIME_REACHED,4696,151,4847,4121,4272,28.29139072847682,3 4 5 9 12,-1
97,w0,100,579,5,149,0,COMPLETED_WALLTIME_REACHED,4702,149,4851,4123,4272,28.671140939597315,0 1 2 6 8,-1
98,w0,100,583,6,149,0,COMPLETED_WALLTIME_REACHED,4845,149,4994,4262,4411,29.604026845637584,7 10 11 13 14 15,-1
99,w0,100,588,5,149,0,COMPLETED_WALLTIME_REACHED,4847,149,4996,4259,4408,29.583892617449663,3 4 5 9 12,-1
102,w0,100,618,4,149,0,COMPLETED_WALLTIME_REACHED,4851,149,5000,4233,4382,29.409395973154364,0 1 2 6,-1
104,w0,100,635,4,148,0,COMPLETED_WALLTIME_REACHED,4996,148,5144,4361,4509,30.466216216216218,3 4 5 9,-1
103,w0,100,632,6,150,0,COMPLETED_WALLTIME_REACHED,4999,150,5149,4367,4517,30.113333333333333,7 8 10 11 13 14,-1
105,w0,100,636,6,153,0,COMPLETED_WALLTIME_REACHED,5000,153,5153,4364,4517,29.522875816993466,0 1 2 6 12 15,-1
108,w0,100,655,4,150,0,COMPLETED_WALLTIME_REACHED,5144,150,5294,4489,4639,30.926666666666666,3 4 5 9,-1
106,w0,100,652,6,152,0,COMPLETED_WALLTIME_REACHED,5149,152,5301,4497,4649,30.585526315789473,7 8 10 11 13 14,-1
107,w0,100,653,5,153,0,COMPLETED_WALLTIME_REACHED,5153,153,5306,4500,4653,30.41176470588235,0 1 2 6 12,-1
110,w0,100,664,5,148,0,COMPLETED_WALLTIME_REACHED,5299,148,5447,4635,4783,32.317567567567565,3 4 5 9 15,-1
109,w0,100,657,6,149,0,COMPLETED_WALLTIME_REACHED,5301,149,5450,4644,4793,32.16778523489933,7 8 10 11 13 14,-1
111,w0,100,666,5,149,0,COMPLETED_WALLTIME_REACHED,5306,149,5455,4640,4789,32.14093959731544,0 1 2 6 12,-1
113,w0,100,688,4,152,0,COMPLETED_WALLTIME_REACHED,5447,152,5599,4759,4911,32.30921052631579,3 4 5 9,-1
112,w0,100,681,7,149,0,COMPLETED_WALLTIME_REACHED,5450,149,5599,4769,4918,33.006711409395976,7 8 10 11 13 14 15,-1
114,w0,100,688,5,147,0,COMPLETED_WALLTIME_REACHED,5455,147,5602,4767,4914,33.42857142857143,0 1 2 6 12,-1
115,w0,100,693,6,150,0,COMPLETED_WALLTIME_REACHED,5599,150,5749,4906,5056,33.70666666666666,3 4 5 7 8 9,-1
116,w0,100,718,5,149,0,COMPLETED_WALLTIME_REACHED,5599,149,5748,4881,5030,33.758389261744966,10 11 13 14 15,-1
117,w0,100,739,5,150,0,COMPLETED_WALLTIME_REACHED,5602,150,5752,4863,5013,33.42,0 1 2 6 12,-1
118,w0,100,741,5,154,0,COMPLETED_WALLTIME_REACHED,5748,154,5902,5007,5161,33.51298701298701,10 11 13 14 15,-1
121,w0,100,756,4,148,0,COMPLETED_WALLTIME_REACHED,5749,148,5897,4993,5141,34.736486486486484,3 4 5 7,-1
542,w0,100,2713,2,147,0,COMPLETED_WALLTIME_REACHED,5749,147,5896,3036,3183,21.653061224489797,8 9,-1
122,w0,100,757,4,146,0,COMPLETED_WALLTIME_REACHED,5752,146,5898,4995,5141,35.21232876712329,0 1 2 6,-1
123,w0,100,763,6,149,0,COMPLETED_WALLTIME_REACHED,5897,149,6046,5134,5283,35.45637583892618,3 4 5 7 8 9,-1
125,w0,100,775,3,151,0,COMPLETED_WALLTIME_REACHED,5902,151,6053,5127,5278,34.95364238410596,10 11 13,-1
553,w0,100,2761,2,150,0,COMPLETED_WALLTIME_REACHED,5902,150,6052,3141,3291,21.94,14 15,-1
124,w0,100,770,5,151,0,COMPLETED_WALLTIME_REACHED,5903,151,6054,5133,5284,34.99337748344371,0 1 2 6 12,-1
126,w0,100,775,3,149,0,COMPLETED_WALLTIME_REACHED,6046,149,6195,5271,5420,36.375838926174495,3 4 5,-1
127,w0,100,776,4,149,0,COMPLETED_WALLTIME_REACHED,6052,149,6201,5276,5425,36.40939597315436,7 8 9 14,-1
575,w0,100,2847,2,151,0,COMPLETED_WALLTIME_REACHED,6053,151,6204,3206,3357,22.2317880794702,10 11,-1
128,w0,100,782,7,150,0,COMPLETED_WALLTIME_REACHED,6054,150,6204,5272,5422,36.14666666666667,0 1 2 6 12 13 15,-1
129,w0,100,782,7,149,0,COMPLETED_WALLTIME_REACHED,6201,149,6350,5419,5568,37.369127516778526,3 4 5 7 8 9 14,-1
130,w0,100,784,3,148,0,COMPLETED_WALLTIME_REACHED,6204,148,6352,5420,5568,37.62162162162162,0 1 2,-1
131,w0,100,791,3,150,0,COMPLETED_WALLTIME_REACHED,6204,150,6354,5413,5563,37.086666666666666,6 10 11,-1
146,w0,100,864,3,153,0,COMPLETED_WALLTIME_REACHED,6204,153,6357,5340,5493,35.90196078431372,12 13 15,-1
132,w0,100,797,6,146,0,COMPLETED_WALLTIME_REACHED,6350,146,6496,5553,5699,39.034246575342465,3 4 5 7 8 9,-1
133,w0,100,800,4,154,0,COMPLETED_WALLTIME_REACHED,6352,154,6506,5552,5706,37.05194805194805,0 1 2 14,-1
665,w0,100,3341,2,149,0,COMPLETED_WALLTIME_REACHED,6354,149,6503,3013,3162,21.221476510067113,6 10,-1
134,w0,100,802,4,152,0,COMPLETED_WALLTIME_REACHED,6357,152,6509,5555,5707,37.546052631578945,11 12 13 15,-1
135,w0,100,807,6,150,0,COMPLETED_WALLTIME_REACHED,6496,150,6646,5689,5839,38.92666666666667,3 4 5 7 8 9,-1
136,w0,100,818,5,153,0,COMPLETED_WALLTIME_REACHED,6506,153,6659,5688,5841,38.1764705882353,0 1 2 6 10,-1
137,w0,100,819,5,149,0,COMPLETED_WALLTIME_REACHED,6509,149,6658,5690,5839,39.18791946308725,11 12 13 14 15,-1
138,w0,100,821,4,152,0,COMPLETED_WALLTIME_REACHED,6646,152,6798,5825,5977,39.32236842105263,3 4 5 7,-1
668,w0,100,3367,2,153,0,COMPLETED_WALLTIME_REACHED,6646,153,6799,3279,3432,22.431372549019606,8 9,-1
139,w0,100,822,4,151,0,COMPLETED_WALLTIME_REACHED,6658,151,6809,5836,5987,39.64900662251656,11 12 13 14,-1
140,w0,100,823,5,152,0,COMPLETED_WALLTIME_REACHED,6659,152,6811,5836,5988,39.39473684210526,0 1 2 6 10,-1
141,w0,100,828,4,150,0,COMPLETED_WALLTIME_REACHED,6798,150,6948,5970,6120,40.8,3 4 5 7,-1
142,w0,100,833,6,149,0,COMPLETED_WALLTIME_REACHED,6809,149,6958,5976,6125,41.10738255033557,8 9 11 12 13 14,-1
143,w0,100,838,5,150,0,COMPLETED_WALLTIME_REACHED,6811,150,6961,5973,6123,40.82,0 1 2 6 10,-1
144,w0,100,840,5,152,0,COMPLETED_WALLTIME_REACHED,6953,152,7105,6113,6265,41.2171052631579,3 4 5 7 15,-1
145,w0,100,847,4,152,0,COMPLETED_WALLTIME_REACHED,6958,152,7110,6111,6263,41.203947368421055,8 9 11 12,-1
718,w0,100,3597,2,148,0,COMPLETED_WALLTIME_REACHED,6958,148,7106,3361,3509,23.70945945945946,13 14,-1
147,w0,100,867,3,151,0,COMPLETED_WALLTIME_REACHED,6961,151,7112,6094,6245,41.35761589403973,0 1 2,-1
760,w0,100,3785,2,151,0,COMPLETED_WALLTIME_REACHED,6961,151,7112,3176,3327,22.033112582781456,6 10,-1
148,w0,100,868,4,148,0,COMPLETED_WALLTIME_REACHED,7105,148,7253,6237,6385,43.141891891891895,3 4 5 7,-1
768,w0,100,3818,2,151,0,COMPLETED_WALLTIME_REACHED,7106,151,7257,3288,3439,22.774834437086092,13 14,-1
149,w0,100,872,5,147,0,COMPLETED_WALLTIME_REACHED,7110,147,7257,6238,6385,43.435374149659864,8 9 11 12 15,-1
150,w0,100,880,4,151,0,COMPLETED_WALLTIME_REACHED,7112,151,7263,6232,6383,42.271523178807946,0 1 2 6,-1
151,w0,100,884,4,149,0,COMPLETED_WALLTIME_REACHED,7253,149,7402,6369,6518,43.74496644295302,3 4 5 7,-1
154,w0,100,901,3,153,0,COMPLETED_WALLTIME_REACHED,7257,153,7410,6356,6509,42.54248366013072,11 12 13,-1
152,w0,100,894,3,152,0,COMPLETED_WALLTIME_REACHED,7262,152,7414,6368,6520,42.89473684210526,8 9 10,-1
153,w0,100,897,6,150,0,COMPLETED_WALLTIME_REACHED,7263,150,7413,6366,6516,43.44,0 1 2 6 14 15,-1
810,w0,100,4017,2,149,0,COMPLETED_WALLTIME_REACHED,7402,149,7551,3385,3534,23.71812080536913,3 4,-1
155,w0,100,904,5,147,0,COMPLETED_WALLTIME_REACHED,7410,147,7557,6506,6653,45.25850340136054,5 7 11 12 13,-1
156,w0,100,907,4,148,0,COMPLETED_WALLTIME_REACHED,7413,148,7561,6506,6654,44.95945945945946,0 1 2 6,-1
157,w0,100,911,4,150,0,COMPLETED_WALLTIME_REACHED,7414,150,7564,6503,6653,44.35333333333333,8 9 10 14,-1
825,w0,100,4079,2,149,0,COMPLETED_WALLTIME_REACHED,7551,149,7700,3472,3621,24.302013422818792,3 4,-1
170,w0,100,959,3,154,0,COMPLETED_WALLTIME_REACHED,7561,154,7715,6602,6756,43.87012987012987,0 1 2,-1
158,w0,100,911,6,151,0,COMPLETED_WALLTIME_REACHED,7562,151,7713,6651,6802,45.04635761589404,5 7 11 12 13 15,-1
159,w0,100,911,5,152,0,COMPLETED_WALLTIME_REACHED,7564,152,7716,6653,6805,44.76973684210526,6 8 9 10 14,-1
873,w0,100,4397,2,148,0,COMPLETED_WALLTIME_REACHED,7700,148,7848,3303,3451,23.31756756756757,3 4,-1
160,w0,100,914,6,150,0,COMPLETED_WALLTIME_REACHED,7713,150,7863,6799,6949,46.32666666666667,5 7 11 12 13 15,-1
173,w0,100,961,3,148,0,COMPLETED_WALLTIME_REACHED,7715,148,7863,6754,6902,46.63513513513514,0 1 2,-1
161,w0,100,918,4,153,0,COMPLETED_WALLTIME_REACHED,7716,153,7869,6798,6951,45.431372549019606,6 8 9 10,-1
174,w0,100,968,3,153,0,COMPLETED_WALLTIME_REACHED,7853,153,8006,6885,7038,46.0,3 4 14,-1
162,w0,100,925,4,149,0,COMPLETED_WALLTIME_REACHED,7863,149,8012,6938,7087,47.56375838926174,0 1 2 5,-1
163,w0,100,938,4,150,0,COMPLETED_WALLTIME_REACHED,7863,150,8013,6925,7075,47.166666666666664,7 11 12 13,-1
164,w0,100,938,4,152,0,COMPLETED_WALLTIME_REACHED,7869,152,8021,6931,7083,46.598684210526315,6 8 9 10,-1
884,w0,100,4447,2,147,0,COMPLETED_WALLTIME_REACHED,8006,147,8153,3559,3706,25.210884353741495,3 4,-1
989,w0,100,4931,2,151,0,COMPLETED_WALLTIME_REACHED,8013,151,8164,3082,3233,21.410596026490065,7 11,-1
165,w0,100,940,6,150,0,COMPLETED_WALLTIME_REACHED,8017,150,8167,7077,7227,48.18,0 1 2 5 14 15,-1
166,w0,100,942,6,149,0,COMPLETED_WALLTIME_REACHED,8021,149,8170,7079,7228,48.51006711409396,6 8 9 10 12 13,-1
992,w0,100,4955,2,150,0,COMPLETED_WALLTIME_REACHED,8153,150,8303,3198,3348,22.32,3 4,-1
996,w0,100,5003,2,150,0,COMPLETED_WALLTIME_REACHED,8164,150,8314,3161,3311,22.073333333333334,7 11,-1
167,w0,100,945,6,148,0,COMPLETED_WALLTIME_REACHED,8167,148,8315,7222,7370,49.7972972972973,0 1 2 5 14 15,-1
168,w0,100,952,4,150,0,COMPLETED_WALLTIME_REACHED,8170,150,8320,7218,7368,49.12,6 8 9 10,-1
171,w0,100,959,5,150,0,COMPLETED_WALLTIME_REACHED,8315,150,8465,7356,7506,50.04,0 1 2 5 14,-1
169,w0,100,954,6,149,0,COMPLETED_WALLTIME_REACHED,8319,149,8468,7365,7514,50.42953020134228,3 4 7 11 12 13,-1
172,w0,100,959,5,152,0,COMPLETED_WALLTIME_REACHED,8320,152,8472,7361,7513,49.42763157894737,6 8 9 10 15,-1
175,w0,100,968,4,152,0,COMPLETED_WALLTIME_REACHED,8465,152,8617,7497,7649,50.32236842105263,0 1 2 5,-1
176,w0,100,970,4,151,0,COMPLETED_WALLTIME_REACHED,8468,151,8619,7498,7649,50.65562913907285,3 4 7 11,-1
178,w0,100,974,3,151,0,COMPLETED_WALLTIME_REACHED,8468,151,8619,7494,7645,50.629139072847686,12 13 14,-1
177,w0,100,973,5,149,0,COMPLETED_WALLTIME_REACHED,8472,149,8621,7499,7648,51.328859060402685,6 8 9 10 15,-1
179,w0,100,979,3,151,0,COMPLETED_WALLTIME_REACHED,8617,151,8768,7638,7789,51.58278145695364,0 1 2,-1
180,w0,100,986,4,148,0,COMPLETED_WALLTIME_REACHED,8619,148,8767,7633,7781,52.57432432432432,3 4 5 7,-1
182,w0,100,997,3,155,0,COMPLETED_WALLTIME_REACHED,8619,155,8774,7622,7777,50.174193548387095,11 12 13,-1
181,w0,100,997,6,147,0,COMPLETED_WALLTIME_REACHED,8621,147,8768,7624,7771,52.863945578231295,6 8 9 10 14 15,-1
183,w0,100,1006,4,153,0,COMPLETED_WALLTIME_REACHED,8767,153,8920,7761,7914,51.72549019607843,3 4 5 7,-1
184,w0,100,1007,4,153,0,COMPLETED_WALLTIME_REACHED,8768,153,8921,7761,7914,51.72549019607843,0 1 2 6,-1
185,w0,100,1009,5,151,0,COMPLETED_WALLTIME_REACHED,8768,151,8919,7759,7910,52.384105960264904,8 9 10 14 15,-1
499,w0,100,2520,3,144,0,COMPLETED_WALLTIME_REACHED,8774,144,8918,6254,6398,44.43055555555556,11 12 13,-1
186,w0,100,1013,6,150,0,COMPLETED_WALLTIME_REACHED,8919,150,9069,7906,8056,53.70666666666666,8 9 10 11 12 13,-1
187,w0,100,1017,6,152,0,COMPLETED_WALLTIME_REACHED,8920,152,9072,7903,8055,52.99342105263158,3 4 5 7 14 15,-1
189,w0,100,1031,3,152,0,COMPLETED_WALLTIME_REACHED,8921,152,9073,7890,8042,52.9078947368421,0 1 2,-1
190,w0,100,1032,5,147,0,COMPLETED_WALLTIME_REACHED,9072,147,9219,8040,8187,55.69387755102041,3 4 5 7 12,-1
191,w0,100,1035,5,152,0,COMPLETED_WALLTIME_REACHED,9073,152,9225,8038,8190,53.88157894736842,0 1 2 13 14,-1
188,w0,100,1022,5,146,0,COMPLETED_WALLTIME_REACHED,9074,146,9220,8052,8198,56.15068493150685,6 8 9 10 11,-1
192,w0,100,1042,5,151,0,COMPLETED_WALLTIME_REACHED,9219,151,9370,8177,8328,55.152317880794705,3 4 5 7 12,-1
193,w0,100,1044,4,147,0,COMPLETED_WALLTIME_REACHED,9220,147,9367,8176,8323,56.61904761904762,6 8 9 10,-1
194,w0,100,1045,4,149,0,COMPLETED_WALLTIME_REACHED,9225,149,9374,8180,8329,55.899328859060404,0 1 2 11,-1
197,w0,100,1059,3,148,0,COMPLETED_WALLTIME_REACHED,9370,148,9518,8311,8459,57.1554054054054,3 4 5,-1
195,w0,100,1048,6,150,0,COMPLETED_WALLTIME_REACHED,9372,150,9522,8324,8474,56.49333333333333,6 8 9 10 13 14,-1
198,w0,100,1060,4,149,0,COMPLETED_WALLTIME_REACHED,9374,149,9523,8314,8463,56.79865771812081,0 1 2 11,-1
201,w0,100,1066,3,150,0,COMPLETED_WALLTIME_REACHED,9375,150,9525,8309,8459,56.39333333333333,7 12 15,-1
203,w0,100,1072,3,148,0,COMPLETED_WALLTIME_REACHED,9518,148,9666,8446,8594,58.067567567567565,3 4 5,-1
199,w0,100,1061,5,148,0,COMPLETED_WALLTIME_REACHED,9522,148,9670,8461,8609,58.16891891891892,6 8 9 10 13,-1
200,w0,100,1062,4,150,0,COMPLETED_WALLTIME_REACHED,9523,150,9673,8461,8611,57.406666666666666,0 1 2 11,-1
204,w0,100,1073,4,150,0,COMPLETED_WALLTIME_REACHED,9670,150,9820,8597,8747,58.31333333333333,6 8 9 10,-1
202,w0,100,1069,6,148,0,COMPLETED_WALLTIME_REACHED,9671,148,9819,8602,8750,59.12162162162162,3 4 5 7 12 14,-1
205,w0,100,1073,6,151,0,COMPLETED_WALLTIME_REACHED,9678,151,9829,8605,8756,57.98675496688742,0 1 2 11 13 15,-1
206,w0,100,1074,5,150,0,COMPLETED_WALLTIME_REACHED,9819,150,9969,8745,8895,59.3,3 4 5 7 12,-1
207,w0,100,1083,5,148,0,COMPLETED_WALLTIME_REACHED,9820,148,9968,8737,8885,60.03378378378378,6 8 9 10 14,-1
208,w0,100,1085,4,150,0,COMPLETED_WALLTIME_REACHED,9829,150,9979,8744,8894,59.29333333333334,0 1 2 11,-1
210,w0,100,1089,4,149,0,COMPLETED_WALLTIME_REACHED,9969,149,10118,8880,9029,60.59731543624161,3 4 5 7,-1
209,w0,100,1085,5,148,0,COMPLETED_WALLTIME_REACHED,9973,148,10121,8888,9036,61.054054054054056,6 8 9 10 13,-1
211,w0,100,1093,5,152,0,COMPLETED_WALLTIME_REACHED,9979,152,10131,8886,9038,59.46052631578947,0 1 2 11 12,-1
212,w0,100,1109,4,150,0,COMPLETED_WALLTIME_REACHED,10118,150,10268,9009,9159,61.06,3 4 5 7,-1
213,w0,100,1111,4,147,0,COMPLETED_WALLTIME_REACHED,10121,147,10268,9010,9157,62.29251700680272,6 8 9 10,-1
234,w0,100,1208,3,148,0,COMPLETED_WALLTIME_REACHED,10126,148,10274,8918,9066,61.25675675675676,13 14 15,-1
214,w0,100,1118,5,149,0,COMPLETED_WALLTIME_REACHED,10131,149,10280,9013,9162,61.48993288590604,0 1 2 11 12,-1
215,w0,100,1135,4,147,0,COMPLETED_WALLTIME_REACHED,10268,147,10415,9133,9280,63.12925170068027,3 4 5 6,-1
216,w0,100,1136,5,153,0,COMPLETED_WALLTIME_REACHED,10274,153,10427,9138,9291,60.72549019607843,7 8 9 10 13,-1
217,w0,100,1144,5,150,0,COMPLETED_WALLTIME_REACHED,10280,150,10430,9136,9286,61.906666666666666,0 1 2 11 12,-1
218,w0,100,1145,4,147,0,COMPLETED_WALLTIME_REACHED,10415,147,10562,9270,9417,64.06122448979592,3 4 5 6,-1
219,w0,100,1150,4,150,0,COMPLETED_WALLTIME_REACHED,10427,150,10577,9277,9427,62.846666666666664,7 8 9 10,-1
220,w0,100,1152,4,150,0,COMPLETED_WALLTIME_REACHED,10430,150,10580,9278,9428,62.85333333333333,0 1 2 11,-1
257,w0,100,1314,3,148,0,COMPLETED_WALLTIME_REACHED,10432,148,10580,9118,9266,62.608108108108105,13 14 15,-1
221,w0,100,1164,4,148,0,COMPLETED_WALLTIME_REACHED,10562,148,10710,9398,9546,64.5,3 4 5 6,-1
223,w0,100,1172,4,149,0,COMPLETED_WALLTIME_REACHED,10580,149,10729,9408,9557,64.14093959731544,0 1 2 11,-1
260,w0,100,1334,3,150,0,COMPLETED_WALLTIME_REACHED,10580,150,10730,9246,9396,62.64,13 14 15,-1
222,w0,100,1170,5,150,0,COMPLETED_WALLTIME_REACHED,10582,150,10732,9412,9562,63.74666666666667,7 8 9 10 12,-1
224,w0,100,1172,4,148,0,COMPLETED_WALLTIME_REACHED,10710,148,10858,9538,9686,65.44594594594595,3 4 5 6,-1
225,w0,100,1181,5,152,0,COMPLETED_WALLTIME_REACHED,10730,152,10882,9549,9701,63.82236842105263,0 1 2 11 13,-1
226,w0,100,1185,4,147,0,COMPLETED_WALLTIME_REACHED,10732,147,10879,9547,9694,65.94557823129252,7 8 9 10,-1
227,w0,100,1187,5,151,0,COMPLETED_WALLTIME_REACHED,10863,151,11014,9676,9827,65.0794701986755,3 4 5 6 12,-1
229,w0,100,1196,4,151,0,COMPLETED_WALLTIME_REACHED,10882,151,11033,9686,9837,65.1456953642384,0 1 2 11,-1
228,w0,100,1192,5,150,0,COMPLETED_WALLTIME_REACHED,10884,150,11034,9692,9842,65.61333333333333,7 8 9 10 14,-1
230,w0,100,1200,4,153,0,COMPLETED_WALLTIME_REACHED,11014,153,11167,9814,9967,65.14379084967321,3 4 5 6,-1
267,w0,100,1361,3,148,0,COMPLETED_WALLTIME_REACHED,11019,148,11167,9658,9806,66.25675675675676,12 13 15,-1
231,w0,100,1201,4,152,0,COMPLETED_WALLTIME_REACHED,11033,152,11185,9832,9984,65.6842105263158,0 1 2 11,-1
232,w0,100,1202,5,148,0,COMPLETED_WALLTIME_REACHED,11034,148,11182,9832,9980,67.43243243243244,7 8 9 10 14,-1
233,w0,100,1204,4,148,0,COMPLETED_WALLTIME_REACHED,11167,148,11315,9963,10111,68.31756756756756,3 4 5 6,-1
271,w0,100,1385,3,151,0,COMPLETED_WALLTIME_REACHED,11167,151,11318,9782,9933,65.78145695364239,12 13 15,-1
235,w0,100,1221,5,149,0,COMPLETED_WALLTIME_REACHED,11182,149,11331,9961,10110,67.85234899328859,7 8 9 10 14,-1
236,w0,100,1226,4,148,0,COMPLETED_WALLTIME_REACHED,11185,148,11333,9959,10107,68.29054054054055,0 1 2 11,-1
237,w0,100,1229,6,149,0,COMPLETED_WALLTIME_REACHED,11318,149,11467,10089,10238,68.71140939597315,3 4 5 6 12 13,-1
238,w0,100,1230,4,153,0,COMPLETED_WALLTIME_REACHED,11331,153,11484,10101,10254,67.01960784313725,7 8 9 10,-1
239,w0,100,1230,5,148,0,COMPLETED_WALLTIME_REACHED,11333,148,11481,10103,10251,69.26351351351352,0 1 2 11 14,-1
240,w0,100,1233,4,151,0,COMPLETED_WALLTIME_REACHED,11467,151,11618,10234,10385,68.7748344370861,3 4 5 6,-1
281,w0,100,1423,3,149,0,COMPLETED_WALLTIME_REACHED,11472,149,11621,10049,10198,68.44295302013423,12 13 15,-1
241,w0,100,1241,4,148,0,COMPLETED_WALLTIME_REACHED,11481,148,11629,10240,10388,70.1891891891892,0 1 2 11,-1
242,w0,100,1241,5,152,0,COMPLETED_WALLTIME_REACHED,11484,152,11636,10243,10395,68.38815789473684,7 8 9 10 14,-1
243,w0,100,1243,4,152,0,COMPLETED_WALLTIME_REACHED,11618,152,11770,10375,10527,69.25657894736842,3 4 5 6,-1
244,w0,100,1244,5,148,0,COMPLETED_WALLTIME_REACHED,11629,148,11777,10385,10533,71.16891891891892,0 1 2 11 12,-1
245,w0,100,1252,4,156,0,COMPLETED_WALLTIME_REACHED,11636,156,11792,10384,10540,67.56410256410257,7 8 9 10,-1
246,w0,100,1257,5,148,0,COMPLETED_WALLTIME_REACHED,11775,148,11923,10518,10666,72.06756756756756,3 4 5 6 13,-1
247,w0,100,1260,5,148,0,COMPLETED_WALLTIME_REACHED,11777,148,11925,10517,10665,72.0608108108108,0 1 2 11 12,-1
248,w0,100,1261,5,152,0,COMPLETED_WALLTIME_REACHED,11797,152,11949,10536,10688,70.3157894736842,7 8 9 10 14,-1
249,w0,100,1269,4,149,0,COMPLETED_WALLTIME_REACHED,11923,149,12072,10654,10803,72.50335570469798,3 4 5 6,-1
250,w0,100,1272,6,147,0,COMPLETED_WALLTIME_REACHED,11925,147,12072,10653,10800,73.46938775510205,0 1 2 11 12 13,-1
251,w0,100,1285,6,152,0,COMPLETED_WALLTIME_REACHED,11954,152,12106,10669,10821,71.1907894736842,7 8 9 10 14 15,-1
252,w0,100,1288,6,152,0,COMPLETED_WALLTIME_REACHED,12072,152,12224,10784,10936,71.94736842105263,0 1 2 3 4 5,-1
253,w0,100,1295,4,151,0,COMPLETED_WALLTIME_REACHED,12072,151,12223,10777,10928,72.37086092715232,6 11 12 13,-1
254,w0,100,1302,4,148,0,COMPLETED_WALLTIME_REACHED,12106,148,12254,10804,10952,74.0,7 8 9 10,-1
255,w0,100,1306,4,147,0,COMPLETED_WALLTIME_REACHED,12223,147,12370,10917,11064,75.26530612244898,6 11 12 13,-1
256,w0,100,1310,5,150,0,COMPLETED_WALLTIME_REACHED,12224,150,12374,10914,11064,73.76,0 1 2 3 4,-1
284,w0,100,1426,3,152,0,COMPLETED_WALLTIME_REACHED,12229,152,12381,10803,10955,72.07236842105263,5 14 15,-1
259,w0,100,1325,4,151,0,COMPLETED_WALLTIME_REACHED,12254,151,12405,10929,11080,73.37748344370861,7 8 9 10,-1
261,w0,100,1338,4,151,0,COMPLETED_WALLTIME_REACHED,12370,151,12521,11032,11183,74.05960264900662,6 11 12 13,-1
262,w0,100,1350,5,151,0,COMPLETED_WALLTIME_REACHED,12374,151,12525,11024,11175,74.00662251655629,0 1 2 3 4,-1
264,w0,100,1353,6,154,0,COMPLETED_WALLTIME_REACHED,12405,154,12559,11052,11206,72.76623376623377,5 7 8 9 10 14,-1
265,w0,100,1358,4,150,0,COMPLETED_WALLTIME_REACHED,12521,150,12671,11163,11313,75.42,6 11 12 13,-1
266,w0,100,1358,5,149,0,COMPLETED_WALLTIME_REACHED,12525,149,12674,11167,11316,75.94630872483222,0 1 2 3 4,-1
268,w0,100,1374,5,152,0,COMPLETED_WALLTIME_REACHED,12559,152,12711,11185,11337,74.58552631578948,5 7 8 9 10,-1
269,w0,100,1376,4,148,0,COMPLETED_WALLTIME_REACHED,12671,148,12819,11295,11443,77.31756756756756,6 11 12 13,-1
270,w0,100,1381,5,152,0,COMPLETED_WALLTIME_REACHED,12674,152,12826,11293,11445,75.29605263157895,0 1 2 3 4,-1
272,w0,100,1389,4,153,0,COMPLETED_WALLTIME_REACHED,12711,153,12864,11322,11475,75.0,5 7 8 9,-1
273,w0,100,1391,6,150,0,COMPLETED_WALLTIME_REACHED,12824,150,12974,11433,11583,77.22,6 10 11 12 13 14,-1
274,w0,100,1404,5,148,0,COMPLETED_WALLTIME_REACHED,12826,148,12974,11422,11570,78.17567567567568,0 1 2 3 4,-1
275,w0,100,1404,5,154,0,COMPLETED_WALLTIME_REACHED,12869,154,13023,11465,11619,75.44805194805195,5 7 8 9 15,-1
276,w0,100,1408,5,149,0,COMPLETED_WALLTIME_REACHED,12974,149,13123,11566,11715,78.6241610738255,0 1 2 3 4,-1
277,w0,100,1413,5,148,0,COMPLETED_WALLTIME_REACHED,12974,148,13122,11561,11709,79.11486486486487,6 10 11 12 13,-1
278,w0,100,1416,6,152,0,COMPLETED_WALLTIME_REACHED,13028,152,13180,11612,11764,77.39473684210526,5 7 8 9 14 15,-1
279,w0,100,1419,5,150,0,COMPLETED_WALLTIME_REACHED,13122,150,13272,11703,11853,79.02,6 10 11 12 13,-1
280,w0,100,1421,5,152,0,COMPLETED_WALLTIME_REACHED,13123,152,13275,11702,11854,77.98684210526316,0 1 2 3 4,-1
282,w0,100,1425,5,152,0,COMPLETED_WALLTIME_REACHED,13180,152,13332,11755,11907,78.33552631578948,5 7 8 9 14,-1
283,w0,100,1426,4,149,0,COMPLETED_WALLTIME_REACHED,13272,149,13421,11846,11995,80.50335570469798,6 10 11 12,-1
285,w0,100,1430,4,149,0,COMPLETED_WALLTIME_REACHED,13275,149,13424,11845,11994,80.49664429530202,0 1 2 3,-1
286,w0,100,1431,3,152,0,COMPLETED_WALLTIME_REACHED,13280,152,13432,11849,12001,78.95394736842105,4 13 15,-1
287,w0,100,1434,4,149,0,COMPLETED_WALLTIME_REACHED,13332,149,13481,11898,12047,80.85234899328859,5 7 8 9,-1
293,w0,100,1460,3,147,0,COMPLETED_WALLTIME_REACHED,13421,147,13568,11961,12108,82.36734693877551,6 10 11,-1
288,w0,100,1440,6,151,0,COMPLETED_WALLTIME_REACHED,13429,151,13580,11989,12140,80.39735099337749,0 1 2 3 12 14,-1
306,w0,100,1503,3,147,0,COMPLETED_WALLTIME_REACHED,13432,147,13579,11929,12076,82.14965986394557,4 13 15,-1
289,w0,100,1444,4,150,0,COMPLETED_WALLTIME_REACHED,13481,150,13631,12037,12187,81.24666666666667,5 7 8 9,-1
291,w0,100,1454,4,153,0,COMPLETED_WALLTIME_REACHED,13579,153,13732,12125,12278,80.2483660130719,4 6 10 11,-1
292,w0,100,1457,4,151,0,COMPLETED_WALLTIME_REACHED,13580,151,13731,12123,12274,81.28476821192054,0 1 2 3,-1
294,w0,100,1464,4,152,0,COMPLETED_WALLTIME_REACHED,13580,152,13732,12116,12268,80.71052631578948,12 13 14 15,-1
295,w0,100,1468,4,150,0,COMPLETED_WALLTIME_REACHED,13631,150,13781,12163,12313,82.08666666666667,5 7 8 9,-1
298,w0,100,1477,4,149,0,COMPLETED_WALLTIME_REACHED,13731,149,13880,12254,12403,83.24161073825503,0 1 2 3,-1
296,w0,100,1474,6,144,0,COMPLETED_WALLTIME_REACHED,13732,144,13876,12258,12402,86.125,4 6 10 11 12 13,-1
297,w0,100,1476,5,151,0,COMPLETED_WALLTIME_REACHED,13786,151,13937,12310,12461,82.52317880794702,5 7 8 9 14,-1
299,w0,100,1480,4,154,0,COMPLETED_WALLTIME_REACHED,13876,154,14030,12396,12550,81.49350649350649,4 6 10 11,-1
300,w0,100,1486,4,151,0,COMPLETED_WALLTIME_REACHED,13880,151,14031,12394,12545,83.0794701986755,0 1 2 3,-1
308,w0,100,1507,3,151,0,COMPLETED_WALLTIME_REACHED,13881,151,14032,12374,12525,82.94701986754967,12 13 15,-1
301,w0,100,1487,5,148,0,COMPLETED_WALLTIME_REACHED,13937,148,14085,12450,12598,85.12162162162163,5 7 8 9 14,-1
302,w0,100,1491,4,152,0,COMPLETED_WALLTIME_REACHED,14030,152,14182,12539,12691,83.49342105263158,4 6 10 11,-1
303,w0,100,1491,4,151,0,COMPLETED_WALLTIME_REACHED,14031,151,14182,12540,12691,84.04635761589404,0 1 2 3,-1
304,w0,100,1496,7,151,0,COMPLETED_WALLTIME_REACHED,14090,151,14241,12594,12745,84.40397350993378,5 7 8 9 12 13 14,-1
305,w0,100,1502,4,153,0,COMPLETED_WALLTIME_REACHED,14182,153,14335,12680,12833,83.87581699346406,0 1 2 3,-1
307,w0,100,1504,4,151,0,COMPLETED_WALLTIME_REACHED,14182,151,14333,12678,12829,84.96026490066225,4 6 10 11,-1
309,w0,100,1512,4,150,0,COMPLETED_WALLTIME_REACHED,14241,150,14391,12729,12879,85.86,5 7 8 9,-1
312,w0,100,1550,3,147,0,COMPLETED_WALLTIME_REACHED,14335,147,14482,12785,12932,87.97278911564626,0 1 2,-1
310,w0,100,1539,7,149,0,COMPLETED_WALLTIME_REACHED,14338,149,14487,12799,12948,86.8993288590604,4 6 10 11 12 13 14,-1
311,w0,100,1544,6,151,0,COMPLETED_WALLTIME_REACHED,14396,151,14547,12852,13003,86.11258278145695,3 5 7 8 9 15,-1
313,w0,100,1553,3,148,0,COMPLETED_WALLTIME_REACHED,14482,148,14630,12929,13077,88.35810810810811,0 1 2,-1
314,w0,100,1554,5,150,0,COMPLETED_WALLTIME_REACHED,14487,150,14637,12933,13083,87.22,4 6 10 11 12,-1
315,w0,100,1559,6,151,0,COMPLETED_WALLTIME_REACHED,14552,151,14703,12993,13144,87.04635761589404,3 5 7 8 9 13,-1
316,w0,100,1570,3,151,0,COMPLETED_WALLTIME_REACHED,14630,151,14781,13060,13211,87.49006622516556,0 1 2,-1
317,w0,100,1572,4,149,0,COMPLETED_WALLTIME_REACHED,14637,149,14786,13065,13214,88.68456375838926,4 6 10 11,-1
319,w0,100,1581,3,152,0,COMPLETED_WALLTIME_REACHED,14642,152,14794,13061,13213,86.92763157894737,12 14 15,-1
318,w0,100,1578,5,152,0,COMPLETED_WALLTIME_REACHED,14703,152,14855,13125,13277,87.34868421052632,3 5 7 8 9,-1
320,w0,100,1585,4,145,0,COMPLETED_WALLTIME_REACHED,14786,145,14931,13201,13346,92.04137931034482,0 1 2 13,-1
321,w0,100,1587,4,148,0,COMPLETED_WALLTIME_REACHED,14786,148,14934,13199,13347,90.18243243243244,4 6 10 11,-1
324,w0,100,1595,3,148,0,COMPLETED_WALLTIME_REACHED,14794,148,14942,13199,13347,90.18243243243244,12 14 15,-1
322,w0,100,1590,4,149,0,COMPLETED_WALLTIME_REACHED,14855,149,15004,13265,13414,90.02684563758389,3 5 7 8,-1
326,w0,100,1606,5,150,0,COMPLETED_WALLTIME_REACHED,14934,150,15084,13328,13478,89.85333333333334,4 6 10 11 13,-1
323,w0,100,1591,4,153,0,COMPLETED_WALLTIME_REACHED,14936,153,15089,13345,13498,88.22222222222223,0 1 2 9,-1
331,w0,100,1626,3,153,0,COMPLETED_WALLTIME_REACHED,14942,153,15095,13316,13469,88.0326797385621,12 14 15,-1
327,w0,100,1613,4,149,0,COMPLETED_WALLTIME_REACHED,15004,149,15153,13391,13540,90.87248322147651,3 5 7 8,-1
328,w0,100,1614,4,147,0,COMPLETED_WALLTIME_REACHED,15084,147,15231,13470,13617,92.63265306122449,4 6 10 11,-1
329,w0,100,1619,4,152,0,COMPLETED_WALLTIME_REACHED,15089,152,15241,13470,13622,89.61842105263158,0 1 2 9,-1
330,w0,100,1625,4,151,0,COMPLETED_WALLTIME_REACHED,15095,151,15246,13470,13621,90.20529801324503,12 13 14 15,-1
332,w0,100,1627,6,151,0,COMPLETED_WALLTIME_REACHED,15236,151,15387,13609,13760,91.12582781456953,3 4 5 6 7 8,-1
333,w0,100,1632,3,149,0,COMPLETED_WALLTIME_REACHED,15241,149,15390,13609,13758,92.33557046979865,0 1 2,-1
334,w0,100,1639,5,148,0,COMPLETED_WALLTIME_REACHED,15246,148,15394,13607,13755,92.9391891891892,9 10 11 12 13,-1
335,w0,100,1649,5,148,0,COMPLETED_WALLTIME_REACHED,15387,148,15535,13738,13886,93.82432432432432,3 4 5 6 7,-1
336,w0,100,1654,4,148,0,COMPLETED_WALLTIME_REACHED,15390,148,15538,13736,13884,93.8108108108108,0 1 2 8,-1
337,w0,100,1655,4,146,0,COMPLETED_WALLTIME_REACHED,15394,146,15540,13739,13885,95.1027397260274,9 10 11 12,-1
341,w0,100,1698,3,149,0,COMPLETED_WALLTIME_REACHED,15399,149,15548,13701,13850,92.95302013422818,13 14 15,-1
338,w0,100,1680,5,149,0,COMPLETED_WALLTIME_REACHED,15535,149,15684,13855,14004,93.98657718120805,3 4 5 6 7,-1
339,w0,100,1692,4,150,0,COMPLETED_WALLTIME_REACHED,15538,150,15688,13846,13996,93.30666666666667,0 1 2 8,-1
340,w0,100,1695,6,149,0,COMPLETED_WALLTIME_REACHED,15548,149,15697,13853,14002,93.97315436241611,9 10 11 12 13 14,-1
342,w0,100,1700,3,149,0,COMPLETED_WALLTIME_REACHED,15684,149,15833,13984,14133,94.85234899328859,3 4 5,-1
343,w0,100,1701,6,149,0,COMPLETED_WALLTIME_REACHED,15688,149,15837,13987,14136,94.87248322147651,0 1 2 6 7 8,-1
344,w0,100,1701,5,151,0,COMPLETED_WALLTIME_REACHED,15697,151,15848,13996,14147,93.6887417218543,9 10 11 12 13,-1
345,w0,100,1703,6,151,0,COMPLETED_WALLTIME_REACHED,15837,151,15988,14134,14285,94.60264900662251,0 1 2 6 7 8,-1
347,w0,100,1719,5,153,0,COMPLETED_WALLTIME_REACHED,15838,153,15991,14119,14272,93.28104575163398,3 4 5 14 15,-1
348,w0,100,1724,4,151,0,COMPLETED_WALLTIME_REACHED,15848,151,15999,14124,14275,94.5364238410596,9 10 11 12,-1
346,w0,100,1717,6,152,0,COMPLETED_WALLTIME_REACHED,15988,152,16140,14271,14423,94.88815789473684,0 1 2 6 7 8,-1
349,w0,100,1728,5,146,0,COMPLETED_WALLTIME_REACHED,15996,146,16142,14268,14414,98.72602739726027,3 4 5 13 14,-1
350,w0,100,1733,5,150,0,COMPLETED_WALLTIME_REACHED,15999,150,16149,14266,14416,96.10666666666667,9 10 11 12 15,-1
351,w0,100,1734,5,152,0,COMPLETED_WALLTIME_REACHED,16140,152,16292,14406,14558,95.77631578947368,0 1 2 6 7,-1
352,w0,100,1740,5,148,0,COMPLETED_WALLTIME_REACHED,16142,148,16290,14402,14550,98.3108108108108,3 4 5 8 13,-1
353,w0,100,1743,4,151,0,COMPLETED_WALLTIME_REACHED,16149,151,16300,14406,14557,96.40397350993378,9 10 11 12,-1
354,w0,100,1745,5,150,0,COMPLETED_WALLTIME_REACHED,16290,150,16440,14545,14695,97.96666666666667,3 4 5 8 13,-1
355,w0,100,1747,3,150,0,COMPLETED_WALLTIME_REACHED,16292,150,16442,14545,14695,97.96666666666667,0 1 2,-1
356,w0,100,1758,4,153,0,COMPLETED_WALLTIME_REACHED,16297,153,16450,14539,14692,96.02614379084967,6 7 14 15,-1
357,w0,100,1765,4,153,0,COMPLETED_WALLTIME_REACHED,16300,153,16453,14535,14688,96.0,9 10 11 12,-1
358,w0,100,1765,4,145,0,COMPLETED_WALLTIME_REACHED,16440,145,16585,14675,14820,102.20689655172414,3 4 5 8,-1
359,w0,100,1774,7,151,0,COMPLETED_WALLTIME_REACHED,16450,151,16601,14676,14827,98.19205298013244,0 1 2 6 7 13 14,-1
360,w0,100,1775,5,151,0,COMPLETED_WALLTIME_REACHED,16453,151,16604,14678,14829,98.20529801324503,9 10 11 12 15,-1
362,w0,100,1787,3,150,0,COMPLETED_WALLTIME_REACHED,16585,150,16735,14798,14948,99.65333333333334,3 4 5,-1
361,w0,100,1779,6,152,0,COMPLETED_WALLTIME_REACHED,16601,152,16753,14822,14974,98.51315789473684,0 1 2 6 7 8,-1
363,w0,100,1793,3,150,0,COMPLETED_WALLTIME_REACHED,16604,150,16754,14811,14961,99.74,9 10 11,-1
364,w0,100,1794,5,150,0,COMPLETED_WALLTIME_REACHED,16740,150,16890,14946,15096,100.64,3 4 5 12 13,-1
365,w0,100,1794,6,152,0,COMPLETED_WALLTIME_REACHED,16753,152,16905,14959,15111,99.41447368421052,0 1 2 6 7 8,-1
366,w0,100,1827,3,153,0,COMPLETED_WALLTIME_REACHED,16754,153,16907,14927,15080,98.56209150326798,9 10 11,-1
367,w0,100,1828,3,147,0,COMPLETED_WALLTIME_REACHED,16890,147,17037,15062,15209,103.4625850340136,3 4 5,-1
370,w0,100,1834,4,152,0,COMPLETED_WALLTIME_REACHED,16895,152,17047,15061,15213,100.08552631578948,12 13 14 15,-1
368,w0,100,1829,6,151,0,COMPLETED_WALLTIME_REACHED,16905,151,17056,15076,15227,100.84105960264901,0 1 2 6 7 8,-1
369,w0,100,1829,5,151,0,COMPLETED_WALLTIME_REACHED,17042,151,17193,15213,15364,101.74834437086092,3 4 5 9 10,-1
371,w0,100,1839,4,146,0,COMPLETED_WALLTIME_REACHED,17052,146,17198,15213,15359,105.1986301369863,11 12 13 14,-1
372,w0,100,1846,4,149,0,COMPLETED_WALLTIME_REACHED,17056,149,17205,15210,15359,103.08053691275168,0 1 2 6,-1
373,w0,100,1851,3,153,0,COMPLETED_WALLTIME_REACHED,17056,153,17209,15205,15358,100.37908496732027,7 8 15,-1
374,w0,100,1851,5,148,0,COMPLETED_WALLTIME_REACHED,17193,148,17341,15342,15490,104.66216216216216,3 4 5 9 10,-1
375,w0,100,1853,6,152,0,COMPLETED_WALLTIME_REACHED,17205,152,17357,15352,15504,102.0,0 1 2 6 11 12,-1
376,w0,100,1853,4,147,0,COMPLETED_WALLTIME_REACHED,17209,147,17356,15356,15503,105.4625850340136,7 8 13 14,-1
377,w0,100,1856,4,149,0,COMPLETED_WALLTIME_REACHED,17341,149,17490,15485,15634,104.9261744966443,3 4 5 9,-1
387,w0,100,1935,3,147,0,COMPLETED_WALLTIME_REACHED,17357,147,17504,15422,15569,105.91156462585035,0 1 2,-1
378,w0,100,1890,6,149,0,COMPLETED_WALLTIME_REACHED,17361,149,17510,15471,15620,104.83221476510067,7 8 10 13 14 15,-1
379,w0,100,1890,7,152,0,COMPLETED_WALLTIME_REACHED,17495,152,17647,15605,15757,103.66447368421052,3 4 5 6 9 11 12,-1
389,w0,100,1939,3,148,0,COMPLETED_WALLTIME_REACHED,17504,148,17652,15565,15713,106.16891891891892,0 1 2,-1
380,w0,100,1891,4,152,0,COMPLETED_WALLTIME_REACHED,17510,152,17662,15619,15771,103.75657894736842,7 8 10 13,-1
381,w0,100,1900,5,154,0,COMPLETED_WALLTIME_REACHED,17647,154,17801,15747,15901,103.25324675324676,3 4 5 6 9,-1
383,w0,100,1902,5,151,0,COMPLETED_WALLTIME_REACHED,17652,151,17803,15750,15901,105.30463576158941,0 1 2 11 12,-1
384,w0,100,1914,4,154,0,COMPLETED_WALLTIME_REACHED,17662,154,17816,15748,15902,103.25974025974025,7 8 10 13,-1
385,w0,100,1917,4,152,0,COMPLETED_WALLTIME_REACHED,17801,152,17953,15884,16036,105.5,3 4 5 6,-1
386,w0,100,1920,5,150,0,COMPLETED_WALLTIME_REACHED,17803,150,17953,15883,16033,106.88666666666667,0 1 2 11 12,-1
394,w0,100,1983,3,150,0,COMPLETED_WALLTIME_REACHED,17806,150,17956,15823,15973,106.48666666666666,9 14 15,-1
391,w0,100,1948,4,148,0,COMPLETED_WALLTIME_REACHED,17816,148,17964,15868,16016,108.21621621621621,7 8 10 13,-1
388,w0,100,1935,5,152,0,COMPLETED_WALLTIME_REACHED,17953,152,18105,16018,16170,106.38157894736842,0 1 2 3 4,-1
390,w0,100,1947,5,150,0,COMPLETED_WALLTIME_REACHED,17956,150,18106,16009,16159,107.72666666666667,5 6 9 11 12,-1
392,w0,100,1957,5,151,0,COMPLETED_WALLTIME_REACHED,17964,151,18115,16007,16158,107.00662251655629,7 8 10 13 14,-1
393,w0,100,1962,5,149,0,COMPLETED_WALLTIME_REACHED,18105,149,18254,16143,16292,109.34228187919463,0 1 2 3 4,-1
395,w0,100,1988,5,152,0,COMPLETED_WALLTIME_REACHED,18106,152,18258,16118,16270,107.03947368421052,5 6 9 11 12,-1
396,w0,100,1990,4,153,0,COMPLETED_WALLTIME_REACHED,18115,153,18268,16125,16278,106.3921568627451,7 8 10 13,-1
397,w0,100,1991,5,150,0,COMPLETED_WALLTIME_REACHED,18254,150,18404,16263,16413,109.42,0 1 2 3 4,-1
398,w0,100,2012,3,150,0,COMPLETED_WALLTIME_REACHED,18258,150,18408,16246,16396,109.30666666666667,5 6 9,-1
399,w0,100,2021,3,151,0,COMPLETED_WALLTIME_REACHED,18263,151,18414,16242,16393,108.56291390728477,11 12 14,-1
400,w0,100,2023,4,147,0,COMPLETED_WALLTIME_REACHED,18268,147,18415,16245,16392,111.51020408163265,7 8 10 13,-1
401,w0,100,2023,6,152,0,COMPLETED_WALLTIME_REACHED,18409,152,18561,16386,16538,108.80263157894737,0 1 2 3 4 15,-1
402,w0,100,2028,4,150,0,COMPLETED_WALLTIME_REACHED,18414,150,18564,16386,16536,110.24,5 6 9 11,-1
403,w0,100,2030,3,149,0,COMPLETED_WALLTIME_REACHED,18415,149,18564,16385,16534,110.96644295302013,7 8 10,-1
413,w0,100,2066,3,146,0,COMPLETED_WALLTIME_REACHED,18415,146,18561,16349,16495,112.97945205479452,12 13 14,-1
404,w0,100,2030,5,151,0,COMPLETED_WALLTIME_REACHED,18561,151,18712,16531,16682,110.47682119205298,0 1 2 3 4,-1
406,w0,100,2034,4,150,0,COMPLETED_WALLTIME_REACHED,18561,150,18711,16527,16677,111.18,12 13 14 15,-1
407,w0,100,2038,4,152,0,COMPLETED_WALLTIME_REACHED,18564,152,18716,16526,16678,109.72368421052632,5 6 7 8,-1
468,w0,100,2325,3,147,0,COMPLETED_WALLTIME_REACHED,18564,147,18711,16239,16386,111.46938775510205,9 10 11,-1
408,w0,100,2044,6,146,0,COMPLETED_WALLTIME_REACHED,18711,146,18857,16667,16813,115.15753424657534,9 10 11 12 13 14,-1
409,w0,100,2050,5,148,0,COMPLETED_WALLTIME_REACHED,18712,148,18860,16662,16810,113.58108108108108,0 1 2 3 4,-1
410,w0,100,2050,4,153,0,COMPLETED_WALLTIME_REACHED,18716,153,18869,16666,16819,109.9281045751634,5 6 7 8,-1
411,w0,100,2054,4,149,0,COMPLETED_WALLTIME_REACHED,18857,149,19006,16803,16952,113.77181208053692,9 10 11 12,-1
412,w0,100,2063,5,153,0,COMPLETED_WALLTIME_REACHED,18860,153,19013,16797,16950,110.7843137254902,0 1 2 3 4,-1
441,w0,100,2216,3,151,0,COMPLETED_WALLTIME_REACHED,18862,151,19013,16646,16797,111.23841059602648,13 14 15,-1
414,w0,100,2070,4,152,0,COMPLETED_WALLTIME_REACHED,18869,152,19021,16799,16951,111.51973684210526,5 6 7 8,-1
417,w0,100,2086,4,151,0,COMPLETED_WALLTIME_REACHED,19006,151,19157,16920,17071,113.05298013245033,9 10 11 12,-1
415,w0,100,2077,7,149,0,COMPLETED_WALLTIME_REACHED,19013,149,19162,16936,17085,114.66442953020135,0 1 2 3 4 13 14,-1
418,w0,100,2094,4,151,0,COMPLETED_WALLTIME_REACHED,19021,151,19172,16927,17078,113.09933774834437,5 6 7 8,-1
419,w0,100,2098,5,148,0,COMPLETED_WALLTIME_REACHED,19162,148,19310,17064,17212,116.29729729729729,9 10 11 12 15,-1
420,w0,100,2109,5,149,0,COMPLETED_WALLTIME_REACHED,19162,149,19311,17053,17202,115.4496644295302,0 1 2 3 4,-1
421,w0,100,2109,5,149,0,COMPLETED_WALLTIME_REACHED,19172,149,19321,17063,17212,115.51677852348993,5 6 7 8 13,-1
422,w0,100,2113,4,148,0,COMPLETED_WALLTIME_REACHED,19310,148,19458,17197,17345,117.19594594594595,9 10 11 12,-1
423,w0,100,2116,5,151,0,COMPLETED_WALLTIME_REACHED,19311,151,19462,17195,17346,114.87417218543047,0 1 2 3 4,-1
424,w0,100,2117,4,151,0,COMPLETED_WALLTIME_REACHED,19321,151,19472,17204,17355,114.93377483443709,5 6 7 8,-1
449,w0,100,2253,3,154,0,COMPLETED_WALLTIME_REACHED,19326,154,19480,17073,17227,111.86363636363636,13 14 15,-1
425,w0,100,2117,4,152,0,COMPLETED_WALLTIME_REACHED,19458,152,19610,17341,17493,115.08552631578948,9 10 11 12,-1
426,w0,100,2127,4,152,0,COMPLETED_WALLTIME_REACHED,19462,152,19614,17335,17487,115.04605263157895,0 1 2 3,-1
427,w0,100,2141,5,152,0,COMPLETED_WALLTIME_REACHED,19472,152,19624,17331,17483,115.01973684210526,4 5 6 7 8,-1
428,w0,100,2152,6,145,0,COMPLETED_WALLTIME_REACHED,19615,145,19760,17463,17608,121.43448275862069,9 10 11 12 13 14,-1
429,w0,100,2154,5,150,0,COMPLETED_WALLTIME_REACHED,19619,150,19769,17465,17615,117.43333333333334,0 1 2 3 15,-1
430,w0,100,2163,5,149,0,COMPLETED_WALLTIME_REACHED,19624,149,19773,17461,17610,118.18791946308725,4 5 6 7 8,-1
431,w0,100,2170,4,149,0,COMPLETED_WALLTIME_REACHED,19760,149,19909,17590,17739,119.05369127516778,9 10 11 12,-1
432,w0,100,2173,6,148,0,COMPLETED_WALLTIME_REACHED,19769,148,19917,17596,17744,119.89189189189189,0 1 2 3 13 14,-1
433,w0,100,2180,4,149,0,COMPLETED_WALLTIME_REACHED,19773,149,19922,17593,17742,119.0738255033557,4 5 6 7,-1
434,w0,100,2188,5,154,0,COMPLETED_WALLTIME_REACHED,19914,154,20068,17726,17880,116.1038961038961,8 9 10 11 12,-1
435,w0,100,2196,7,146,0,COMPLETED_WALLTIME_REACHED,19922,146,20068,17726,17872,122.41095890410959,0 1 2 3 13 14 15,-1
437,w0,100,2201,4,150,0,COMPLETED_WALLTIME_REACHED,19922,150,20072,17721,17871,119.14,4 5 6 7,-1
436,w0,100,2198,6,151,0,COMPLETED_WALLTIME_REACHED,20068,151,20219,17870,18021,119.34437086092716,0 1 2 3 8 9,-1
438,w0,100,2201,4,150,0,COMPLETED_WALLTIME_REACHED,20068,150,20218,17867,18017,120.11333333333333,10 11 12 13,-1
439,w0,100,2210,5,147,0,COMPLETED_WALLTIME_REACHED,20072,147,20219,17862,18009,122.51020408163265,4 5 6 7 14,-1
442,w0,100,2222,4,148,0,COMPLETED_WALLTIME_REACHED,20219,148,20367,17997,18145,122.60135135135135,0 1 2 3,-1
444,w0,100,2228,6,151,0,COMPLETED_WALLTIME_REACHED,20219,151,20370,17991,18142,120.1456953642384,4 5 6 7 8 9,-1
440,w0,100,2213,5,153,0,COMPLETED_WALLTIME_REACHED,20223,153,20376,18010,18163,118.7124183006536,10 11 12 13 15,-1
445,w0,100,2236,4,149,0,COMPLETED_WALLTIME_REACHED,20367,149,20516,18131,18280,122.68456375838926,0 1 2 3,-1
446,w0,100,2240,5,149,0,COMPLETED_WALLTIME_REACHED,20370,149,20519,18130,18279,122.67785234899328,4 5 6 7 8,-1
447,w0,100,2242,4,151,0,COMPLETED_WALLTIME_REACHED,20376,151,20527,18134,18285,121.09271523178808,9 10 11 12,-1
450,w0,100,2256,3,149,0,COMPLETED_WALLTIME_REACHED,20519,149,20668,18263,18412,123.57046979865771,4 5 6,-1
448,w0,100,2243,6,149,0,COMPLETED_WALLTIME_REACHED,20521,149,20670,18278,18427,123.67114093959732,0 1 2 3 13 14,-1
465,w0,100,2310,3,150,0,COMPLETED_WALLTIME_REACHED,20524,150,20674,18214,18364,122.42666666666666,7 8 15,-1
451,w0,100,2257,4,149,0,COMPLETED_WALLTIME_REACHED,20527,149,20676,18270,18419,123.61744966442953,9 10 11 12,-1
479,w0,100,2407,3,150,0,COMPLETED_WALLTIME_REACHED,20668,150,20818,18261,18411,122.74,4 5 6,-1
452,w0,100,2259,4,152,0,COMPLETED_WALLTIME_REACHED,20670,152,20822,18411,18563,122.125,0 1 2 3,-1
490,w0,100,2474,3,147,0,COMPLETED_WALLTIME_REACHED,20674,147,20821,18200,18347,124.80952380952381,7 8 13,-1
453,w0,100,2262,6,150,0,COMPLETED_WALLTIME_REACHED,20676,150,20826,18414,18564,123.76,9 10 11 12 14 15,-1
454,w0,100,2268,6,149,0,COMPLETED_WALLTIME_REACHED,20821,149,20970,18553,18702,125.51677852348993,4 5 6 7 8 13,-1
458,w0,100,2283,4,149,0,COMPLETED_WALLTIME_REACHED,20822,149,20971,18539,18688,125.42281879194631,0 1 2 3,-1
455,w0,100,2269,6,149,0,COMPLETED_WALLTIME_REACHED,20826,149,20975,18557,18706,125.54362416107382,9 10 11 12 14 15,-1
456,w0,100,2270,6,152,0,COMPLETED_WALLTIME_REACHED,20970,152,21122,18700,18852,124.02631578947368,4 5 6 7 8 13,-1
462,w0,100,2299,4,151,0,COMPLETED_WALLTIME_REACHED,20971,151,21122,18672,18823,124.65562913907284,0 1 2 3,-1
457,w0,100,2272,5,151,0,COMPLETED_WALLTIME_REACHED,20975,151,21126,18703,18854,124.86092715231788,9 10 11 12 14,-1
459,w0,100,2288,5,148,0,COMPLETED_WALLTIME_REACHED,21122,148,21270,18834,18982,128.25675675675674,0 1 2 3 4,-1
461,w0,100,2292,5,154,0,COMPLETED_WALLTIME_REACHED,21126,154,21280,18834,18988,123.2987012987013,9 10 11 12 14,-1
460,w0,100,2290,6,149,0,COMPLETED_WALLTIME_REACHED,21127,149,21276,18837,18986,127.42281879194631,5 6 7 8 13 15,-1
464,w0,100,2302,4,150,0,COMPLETED_WALLTIME_REACHED,21270,150,21420,18968,19118,127.45333333333333,0 1 2 3,-1
463,w0,100,2299,6,147,0,COMPLETED_WALLTIME_REACHED,21276,147,21423,18977,19124,130.0952380952381,4 5 6 7 8 13,-1
466,w0,100,2316,5,148,0,COMPLETED_WALLTIME_REACHED,21280,148,21428,18964,19112,129.13513513513513,9 10 11 12 14,-1
467,w0,100,2318,4,147,0,COMPLETED_WALLTIME_REACHED,21420,147,21567,19102,19249,130.94557823129253,0 1 2 3,-1
469,w0,100,2345,4,149,0,COMPLETED_WALLTIME_REACHED,21423,149,21572,19078,19227,129.04026845637583,4 5 6 7,-1
470,w0,100,2349,7,147,0,COMPLETED_WALLTIME_REACHED,21428,147,21575,19079,19226,130.7891156462585,8 9 10 11 12 13 14,-1
471,w0,100,2357,5,150,0,COMPLETED_WALLTIME_REACHED,21572,150,21722,19215,19365,129.1,0 1 2 3 15,-1
480,w0,100,2415,4,151,0,COMPLETED_WALLTIME_REACHED,21572,151,21723,19157,19308,127.86754966887418,4 5 6 7,-1
472,w0,100,2381,5,152,0,COMPLETED_WALLTIME_REACHED,21575,152,21727,19194,19346,127.27631578947368,8 9 10 11 12,-1
482,w0,100,2427,4,148,0,COMPLETED_WALLTIME_REACHED,21723,148,21871,19296,19444,131.3783783783784,4 5 6 7,-1
473,w0,100,2381,7,152,0,COMPLETED_WALLTIME_REACHED,21727,152,21879,19346,19498,128.27631578947367,0 1 2 3 13 14 15,-1
474,w0,100,2382,5,151,0,COMPLETED_WALLTIME_REACHED,21727,151,21878,19345,19496,129.11258278145695,8 9 10 11 12,-1
486,w0,100,2435,4,149,0,COMPLETED_WALLTIME_REACHED,21871,149,22020,19436,19585,131.44295302013424,4 5 6 7,-1
475,w0,100,2392,5,148,0,COMPLETED_WALLTIME_REACHED,21878,148,22026,19486,19634,132.66216216216216,8 9 10 11 12,-1
476,w0,100,2399,5,146,0,COMPLETED_WALLTIME_REACHED,21879,146,22025,19480,19626,134.42465753424656,0 1 2 3 13,-1
477,w0,100,2402,5,148,0,COMPLETED_WALLTIME_REACHED,22025,148,22173,19623,19771,133.58783783783784,4 5 6 7 14,-1
478,w0,100,2407,5,151,0,COMPLETED_WALLTIME_REACHED,22025,151,22176,19618,19769,130.9205298013245,0 1 2 3 13,-1
481,w0,100,2422,6,149,0,COMPLETED_WALLTIME_REACHED,22031,149,22180,19609,19758,132.60402684563758,8 9 10 11 12 15,-1
483,w0,100,2429,5,150,0,COMPLETED_WALLTIME_REACHED,22173,150,22323,19744,19894,132.62666666666667,4 5 6 7 14,-1
487,w0,100,2437,4,150,0,COMPLETED_WALLTIME_REACHED,22176,150,22326,19739,19889,132.59333333333333,0 1 2 3,-1
484,w0,100,2430,6,151,0,COMPLETED_WALLTIME_REACHED,22180,151,22331,19750,19901,131.79470198675497,8 9 10 11 12 13,-1
489,w0,100,2468,4,148,0,COMPLETED_WALLTIME_REACHED,22326,148,22474,19858,20006,135.17567567567568,0 1 2 3,-1
485,w0,100,2434,6,151,0,COMPLETED_WALLTIME_REACHED,22328,151,22479,19894,20045,132.74834437086093,4 5 6 7 14 15,-1
488,w0,100,2446,5,149,0,COMPLETED_WALLTIME_REACHED,22331,149,22480,19885,20034,134.45637583892616,8 9 10 11 12,-1
491,w0,100,2483,5,147,0,COMPLETED_WALLTIME_REACHED,22479,147,22626,19996,20143,137.02721088435374,0 1 2 3 13,-1
492,w0,100,2485,5,147,0,COMPLETED_WALLTIME_REACHED,22479,147,22626,19994,20141,137.01360544217687,4 5 6 7 14,-1
493,w0,100,2489,4,150,0,COMPLETED_WALLTIME_REACHED,22480,150,22630,19991,20141,134.27333333333334,8 9 10 11,-1
495,w0,100,2505,5,152,0,COMPLETED_WALLTIME_REACHED,22626,152,22778,20121,20273,133.375,0 1 2 3 4,-1
497,w0,100,2511,5,147,0,COMPLETED_WALLTIME_REACHED,22630,147,22777,20119,20266,137.8639455782313,8 9 10 11 14,-1
496,w0,100,2505,5,149,0,COMPLETED_WALLTIME_REACHED,22631,149,22780,20126,20275,136.0738255033557,5 6 7 12 13,-1
501,w0,100,2523,5,151,0,COMPLETED_WALLTIME_REACHED,22778,151,22929,20255,20406,135.13907284768212,0 1 2 3 4,-1
502,w0,100,2525,5,153,0,COMPLETED_WALLTIME_REACHED,22780,153,22933,20255,20408,133.3856209150327,5 6 7 12 13,-1
498,w0,100,2513,6,149,0,COMPLETED_WALLTIME_REACHED,22782,149,22931,20269,20418,137.03355704697987,8 9 10 11 14 15,-1
503,w0,100,2527,4,149,0,COMPLETED_WALLTIME_REACHED,22929,149,23078,20402,20551,137.9261744966443,0 1 2 3,-1
504,w0,100,2531,4,148,0,COMPLETED_WALLTIME_REACHED,22931,148,23079,20400,20548,138.83783783783784,4 8 9 10,-1
511,w0,100,2560,3,146,0,COMPLETED_WALLTIME_REACHED,22931,146,23077,20371,20517,140.52739726027397,11 14 15,-1
505,w0,100,2532,5,151,0,COMPLETED_WALLTIME_REACHED,22933,151,23084,20401,20552,136.10596026490066,5 6 7 12 13,-1
516,w0,100,2591,3,149,0,COMPLETED_WALLTIME_REACHED,23077,149,23226,20486,20635,138.48993288590603,11 14 15,-1
506,w0,100,2533,4,151,0,COMPLETED_WALLTIME_REACHED,23078,151,23229,20545,20696,137.05960264900662,0 1 2 3,-1
507,w0,100,2541,4,148,0,COMPLETED_WALLTIME_REACHED,23079,148,23227,20538,20686,139.77027027027026,4 8 9 10,-1
508,w0,100,2548,5,156,0,COMPLETED_WALLTIME_REACHED,23084,156,23240,20536,20692,132.64102564102564,5 6 7 12 13,-1
527,w0,100,2638,3,151,0,COMPLETED_WALLTIME_REACHED,23226,151,23377,20588,20739,137.34437086092714,11 14 15,-1
509,w0,100,2553,4,150,0,COMPLETED_WALLTIME_REACHED,23227,150,23377,20674,20824,138.82666666666665,4 8 9 10,-1
513,w0,100,2573,4,147,0,COMPLETED_WALLTIME_REACHED,23229,147,23376,20656,20803,141.51700680272108,0 1 2 3,-1
510,w0,100,2557,5,149,0,COMPLETED_WALLTIME_REACHED,23240,149,23389,20683,20832,139.81208053691276,5 6 7 12 13,-1
514,w0,100,2575,4,150,0,COMPLETED_WALLTIME_REACHED,23376,150,23526,20801,20951,139.67333333333335,0 1 2 3,-1
512,w0,100,2560,6,150,0,COMPLETED_WALLTIME_REACHED,23377,150,23527,20817,20967,139.78,4 8 9 10 11 14,-1
515,w0,100,2575,5,144,0,COMPLETED_WALLTIME_REACHED,23389,144,23533,20814,20958,145.54166666666666,5 6 7 12 13,-1
519,w0,100,2613,4,145,0,COMPLETED_WALLTIME_REACHED,23526,145,23671,20913,21058,145.22758620689655,0 1 2 3,-1
517,w0,100,2595,6,150,0,COMPLETED_WALLTIME_REACHED,23527,150,23677,20932,21082,140.54666666666665,4 8 9 10 11 14,-1
518,w0,100,2603,6,148,0,COMPLETED_WALLTIME_REACHED,23538,148,23686,20935,21083,142.4527027027027,5 6 7 12 13 15,-1
522,w0,100,2626,4,149,0,COMPLETED_WALLTIME_REACHED,23671,149,23820,21045,21194,142.24161073825502,0 1 2 3,-1
520,w0,100,2618,5,150,0,COMPLETED_WALLTIME_REACHED,23677,150,23827,21059,21209,141.39333333333335,4 8 9 10 11,-1
521,w0,100,2625,5,147,0,COMPLETED_WALLTIME_REACHED,23686,147,23833,21061,21208,144.2721088435374,5 6 7 12 13,-1
523,w0,100,2631,4,151,0,COMPLETED_WALLTIME_REACHED,23820,151,23971,21189,21340,141.32450331125827,0 1 2 3,-1
524,w0,100,2634,5,152,0,COMPLETED_WALLTIME_REACHED,23827,152,23979,21193,21345,140.42763157894737,4 8 9 10 11,-1
525,w0,100,2635,4,152,0,COMPLETED_WALLTIME_REACHED,23833,152,23985,21198,21350,140.46052631578948,5 6 7 12,-1
532,w0,100,2656,3,154,0,COMPLETED_WALLTIME_REACHED,23838,154,23992,21182,21336,138.54545454545453,13 14 15,-1
526,w0,100,2638,4,152,0,COMPLETED_WALLTIME_REACHED,23971,152,24123,21333,21485,141.34868421052633,0 1 2 3,-1
528,w0,100,2643,7,150,0,COMPLETED_WALLTIME_REACHED,23985,150,24135,21342,21492,143.28,4 5 6 7 8 9 10,-1
529,w0,100,2645,4,154,0,COMPLETED_WALLTIME_REACHED,23992,154,24146,21347,21501,139.61688311688312,11 12 13 14,-1
530,w0,100,2652,5,148,0,COMPLETED_WALLTIME_REACHED,24128,148,24276,21476,21624,146.1081081081081,0 1 2 3 15,-1
531,w0,100,2655,4,156,0,COMPLETED_WALLTIME_REACHED,24135,156,24291,21480,21636,138.69230769230768,4 5 6 7,-1
555,w0,100,2764,3,150,0,COMPLETED_WALLTIME_REACHED,24135,150,24285,21371,21521,143.47333333333333,8 9 10,-1
533,w0,100,2661,4,148,0,COMPLETED_WALLTIME_REACHED,24146,148,24294,21485,21633,146.1689189189189,11 12 13 14,-1
534,w0,100,2661,4,149,0,COMPLETED_WALLTIME_REACHED,24276,149,24425,21615,21764,146.06711409395973,0 1 2 3,-1
556,w0,100,2765,3,153,0,COMPLETED_WALLTIME_REACHED,24285,153,24438,21520,21673,141.65359477124184,8 9 10,-1
535,w0,100,2665,5,151,0,COMPLETED_WALLTIME_REACHED,24291,151,24442,21626,21777,144.2185430463576,4 5 6 7 15,-1
560,w0,100,2771,3,150,0,COMPLETED_WALLTIME_REACHED,24294,150,24444,21523,21673,144.48666666666668,11 12 13,-1
536,w0,100,2684,5,150,0,COMPLETED_WALLTIME_REACHED,24430,150,24580,21746,21896,145.97333333333333,0 1 2 3 14,-1
561,w0,100,2773,3,151,0,COMPLETED_WALLTIME_REACHED,24438,151,24589,21665,21816,144.47682119205297,8 9 10,-1
537,w0,100,2692,5,153,0,COMPLETED_WALLTIME_REACHED,24442,153,24595,21750,21903,143.15686274509804,4 5 6 7 15,-1
566,w0,100,2798,3,149,0,COMPLETED_WALLTIME_REACHED,24444,149,24593,21646,21795,146.2751677852349,11 12 13,-1
538,w0,100,2696,5,149,0,COMPLETED_WALLTIME_REACHED,24580,149,24729,21884,22033,147.8724832214765,0 1 2 3 14,-1
539,w0,100,2698,4,150,0,COMPLETED_WALLTIME_REACHED,24593,150,24743,21895,22045,146.96666666666667,8 9 10 11,-1
541,w0,100,2703,4,148,0,COMPLETED_WALLTIME_REACHED,24595,148,24743,21892,22040,148.9189189189189,4 5 6 7,-1
569,w0,100,2815,3,148,0,COMPLETED_WALLTIME_REACHED,24595,148,24743,21780,21928,148.16216216216216,12 13 15,-1
543,w0,100,2725,5,149,0,COMPLETED_WALLTIME_REACHED,24729,149,24878,22004,22153,148.6778523489933,0 1 2 3 14,-1
544,w0,100,2728,4,151,0,COMPLETED_WALLTIME_REACHED,24743,151,24894,22015,22166,146.79470198675497,4 5 6 7,-1
545,w0,100,2733,4,151,0,COMPLETED_WALLTIME_REACHED,24743,151,24894,22010,22161,146.76158940397352,8 9 10 11,-1
572,w0,100,2837,3,149,0,COMPLETED_WALLTIME_REACHED,24743,149,24892,21906,22055,148.0201342281879,12 13 15,-1
546,w0,100,2737,5,151,0,COMPLETED_WALLTIME_REACHED,24878,151,25029,22141,22292,147.6291390728477,0 1 2 3 14,-1
580,w0,100,2878,3,150,0,COMPLETED_WALLTIME_REACHED,24892,150,25042,22014,22164,147.76,12 13 15,-1
547,w0,100,2742,5,153,0,COMPLETED_WALLTIME_REACHED,24894,153,25047,22152,22305,145.7843137254902,4 5 6 7 8,-1
583,w0,100,2882,3,149,0,COMPLETED_WALLTIME_REACHED,24894,149,25043,22012,22161,148.73154362416108,9 10 11,-1
548,w0,100,2748,5,151,0,COMPLETED_WALLTIME_REACHED,25029,151,25180,22281,22432,148.5562913907285,0 1 2 3 14,-1
549,w0,100,2750,4,150,0,COMPLETED_WALLTIME_REACHED,25043,150,25193,22293,22443,149.62,9 10 11 12,-1
550,w0,100,2751,5,151,0,COMPLETED_WALLTIME_REACHED,25047,151,25198,22296,22447,148.65562913907286,4 5 6 7 8,-1
551,w0,100,2753,5,150,0,COMPLETED_WALLTIME_REACHED,25185,150,25335,22432,22582,150.54666666666665,0 1 2 3 13,-1
552,w0,100,2759,4,154,0,COMPLETED_WALLTIME_REACHED,25193,154,25347,22434,22588,146.67532467532467,9 10 11 12,-1
554,w0,100,2761,5,148,0,COMPLETED_WALLTIME_REACHED,25198,148,25346,22437,22585,152.60135135135135,4 5 6 7 8,-1
557,w0,100,2766,4,149,0,COMPLETED_WALLTIME_REACHED,25335,149,25484,22569,22718,152.46979865771812,0 1 2 3,-1
558,w0,100,2767,6,154,0,COMPLETED_WALLTIME_REACHED,25346,154,25500,22579,22733,147.61688311688312,4 5 6 7 8 13,-1
559,w0,100,2770,5,152,0,COMPLETED_WALLTIME_REACHED,25352,152,25504,22582,22734,149.56578947368422,9 10 11 12 14,-1
562,w0,100,2783,4,154,0,COMPLETED_WALLTIME_REACHED,25484,154,25638,22701,22855,148.4090909090909,0 1 2 3,-1
563,w0,100,2785,5,147,0,COMPLETED_WALLTIME_REACHED,25500,147,25647,22715,22862,155.52380952380952,4 5 6 7 8,-1
564,w0,100,2789,5,151,0,COMPLETED_WALLTIME_REACHED,25504,151,25655,22715,22866,151.43046357615893,9 10 11 12 13,-1
565,w0,100,2793,4,150,0,COMPLETED_WALLTIME_REACHED,25638,150,25788,22845,22995,153.3,0 1 2 3,-1
567,w0,100,2814,5,151,0,COMPLETED_WALLTIME_REACHED,25647,151,25798,22833,22984,152.21192052980132,4 5 6 7 8,-1
568,w0,100,2815,4,149,0,COMPLETED_WALLTIME_REACHED,25655,149,25804,22840,22989,154.28859060402684,9 10 11 12,-1
570,w0,100,2825,5,148,0,COMPLETED_WALLTIME_REACHED,25793,148,25941,22968,23116,156.1891891891892,0 1 2 3 13,-1
571,w0,100,2826,4,153,0,COMPLETED_WALLTIME_REACHED,25798,153,25951,22972,23125,151.1437908496732,4 5 6 7,-1
597,w0,100,2941,3,153,0,COMPLETED_WALLTIME_REACHED,25803,153,25956,22862,23015,150.4248366013072,8 14 15,-1
573,w0,100,2839,4,150,0,COMPLETED_WALLTIME_REACHED,25804,150,25954,22965,23115,154.1,9 10 11 12,-1
574,w0,100,2841,4,148,0,COMPLETED_WALLTIME_REACHED,25941,148,26089,23100,23248,157.0810810810811,0 1 2 3,-1
576,w0,100,2861,4,150,0,COMPLETED_WALLTIME_REACHED,25951,150,26101,23090,23240,154.93333333333334,4 5 6 7,-1
577,w0,100,2866,4,153,0,COMPLETED_WALLTIME_REACHED,25954,153,26107,23088,23241,151.90196078431373,9 10 11 12,-1
578,w0,100,2873,4,150,0,COMPLETED_WALLTIME_REACHED,25956,150,26106,23083,23233,154.88666666666666,8 13 14 15,-1
601,w0,100,2963,3,151,0,COMPLETED_WALLTIME_REACHED,26089,151,26240,23126,23277,154.1523178807947,0 1 2,-1
579,w0,100,2876,5,148,0,COMPLETED_WALLTIME_REACHED,26101,148,26249,23225,23373,157.92567567567568,3 4 5 6 7,-1
608,w0,100,2991,3,151,0,COMPLETED_WALLTIME_REACHED,26106,151,26257,23115,23266,154.0794701986755,8 13 14,-1
581,w0,100,2879,5,150,0,COMPLETED_WALLTIME_REACHED,26107,150,26257,23228,23378,155.85333333333332,9 10 11 12 15,-1
637,w0,100,3201,3,151,0,COMPLETED_WALLTIME_REACHED,26240,151,26391,23039,23190,153.57615894039736,0 1 2,-1
582,w0,100,2880,5,154,0,COMPLETED_WALLTIME_REACHED,26249,154,26403,23369,23523,152.74675324675326,3 4 5 6 7,-1
584,w0,100,2883,6,149,0,COMPLETED_WALLTIME_REACHED,26257,149,26406,23374,23523,157.8724832214765,8 9 10 11 12 13,-1
585,w0,100,2884,4,151,0,COMPLETED_WALLTIME_REACHED,26396,151,26547,23512,23663,156.7086092715232,0 1 2 14,-1
586,w0,100,2887,5,147,0,COMPLETED_WALLTIME_REACHED,26403,147,26550,23516,23663,160.97278911564626,3 4 5 6 7,-1
587,w0,100,2888,4,152,0,COMPLETED_WALLTIME_REACHED,26406,152,26558,23518,23670,155.72368421052633,8 9 10 11,-1
589,w0,100,2895,5,151,0,COMPLETED_WALLTIME_REACHED,26550,151,26701,23655,23806,157.65562913907286,3 4 5 6 7,-1
588,w0,100,2894,5,150,0,COMPLETED_WALLTIME_REACHED,26552,150,26702,23658,23808,158.72,0 1 2 12 13,-1
590,w0,100,2912,5,151,0,COMPLETED_WALLTIME_REACHED,26558,151,26709,23646,23797,157.59602649006624,8 9 10 11 14,-1
591,w0,100,2924,4,150,0,COMPLETED_WALLTIME_REACHED,26701,150,26851,23777,23927,159.51333333333332,3 4 5 6,-1
592,w0,100,2924,5,149,0,COMPLETED_WALLTIME_REACHED,26702,149,26851,23778,23927,160.58389261744966,0 1 2 7 12,-1
593,w0,100,2930,4,151,0,COMPLETED_WALLTIME_REACHED,26709,151,26860,23779,23930,158.47682119205297,8 9 10 11,-1
640,w0,100,3227,3,146,0,COMPLETED_WALLTIME_REACHED,26714,146,26860,23487,23633,161.86986301369862,13 14 15,-1
594,w0,100,2930,4,150,0,COMPLETED_WALLTIME_REACHED,26851,150,27001,23921,24071,160.47333333333333,0 1 2 3,-1
595,w0,100,2934,4,150,0,COMPLETED_WALLTIME_REACHED,26851,150,27001,23917,24067,160.44666666666666,4 5 6 7,-1
596,w0,100,2939,5,147,0,COMPLETED_WALLTIME_REACHED,26860,147,27007,23921,24068,163.7278911564626,8 9 10 11 12,-1
641,w0,100,3227,3,149,0,COMPLETED_WALLTIME_REACHED,26860,149,27009,23633,23782,159.61073825503357,13 14 15,-1
598,w0,100,2943,5,147,0,COMPLETED_WALLTIME_REACHED,27001,147,27148,24058,24205,164.65986394557822,0 1 2 3 4,-1
652,w0,100,3272,3,152,0,COMPLETED_WALLTIME_REACHED,27001,152,27153,23729,23881,157.11184210526315,5 6 7,-1
599,w0,100,2946,5,152,0,COMPLETED_WALLTIME_REACHED,27007,152,27159,24061,24213,159.29605263157896,8 9 10 11 12,-1
669,w0,100,3368,3,149,0,COMPLETED_WALLTIME_REACHED,27009,149,27158,23641,23790,159.66442953020135,13 14 15,-1
600,w0,100,2947,4,153,0,COMPLETED_WALLTIME_REACHED,27148,153,27301,24201,24354,159.1764705882353,0 1 2 3,-1
602,w0,100,2967,6,152,0,COMPLETED_WALLTIME_REACHED,27158,152,27310,24191,24343,160.15131578947367,4 5 6 7 13 14,-1
603,w0,100,2975,4,150,0,COMPLETED_WALLTIME_REACHED,27159,150,27309,24184,24334,162.22666666666666,8 9 10 11,-1
604,w0,100,2980,5,152,0,COMPLETED_WALLTIME_REACHED,27306,152,27458,24326,24478,161.03947368421052,0 1 2 3 12,-1
605,w0,100,2981,4,147,0,COMPLETED_WALLTIME_REACHED,27309,147,27456,24328,24475,166.49659863945578,8 9 10 11,-1
606,w0,100,2988,4,153,0,COMPLETED_WALLTIME_REACHED,27310,153,27463,24322,24475,159.96732026143792,4 5 6 7,-1
672,w0,100,3380,3,148,0,COMPLETED_WALLTIME_REACHED,27315,148,27463,23935,24083,162.72297297297297,13 14 15,-1
607,w0,100,2991,4,149,0,COMPLETED_WALLTIME_REACHED,27456,149,27605,24465,24614,165.19463087248323,8 9 10 11,-1
609,w0,100,2991,5,149,0,COMPLETED_WALLTIME_REACHED,27458,149,27607,24467,24616,165.20805369127515,0 1 2 3 12,-1
610,w0,100,2994,4,150,0,COMPLETED_WALLTIME_REACHED,27463,150,27613,24469,24619,164.12666666666667,4 5 6 7,-1
611,w0,100,3008,6,149,0,COMPLETED_WALLTIME_REACHED,27610,149,27759,24602,24751,166.11409395973155,8 9 10 11 13 14,-1
612,w0,100,3016,6,153,0,COMPLETED_WALLTIME_REACHED,27612,153,27765,24596,24749,161.75816993464053,0 1 2 3 12 15,-1
613,w0,100,3024,4,151,0,COMPLETED_WALLTIME_REACHED,27613,151,27764,24589,24740,163.841059602649,4 5 6 7,-1
614,w0,100,3027,4,148,0,COMPLETED_WALLTIME_REACHED,27759,148,27907,24732,24880,168.1081081081081,8 9 10 11,-1
615,w0,100,3034,5,149,0,COMPLETED_WALLTIME_REACHED,27764,149,27913,24730,24879,166.9731543624161,4 5 6 7 13,-1
616,w0,100,3043,5,149,0,COMPLETED_WALLTIME_REACHED,27765,149,27914,24722,24871,166.91946308724832,0 1 2 3 12,-1
617,w0,100,3044,5,151,0,COMPLETED_WALLTIME_REACHED,27912,151,28063,24868,25019,165.6887417218543,8 9 10 11 14,-1
618,w0,100,3055,4,150,0,COMPLETED_WALLTIME_REACHED,27913,150,28063,24858,25008,166.72,4 5 6 7,-1
619,w0,100,3080,4,149,0,COMPLETED_WALLTIME_REACHED,27914,149,28063,24834,24983,167.6711409395973,0 1 2 3,-1
684,w0,100,3427,3,148,0,COMPLETED_WALLTIME_REACHED,27919,148,28067,24492,24640,166.48648648648648,12 13 15,-1
620,w0,100,3088,4,148,0,COMPLETED_WALLTIME_REACHED,28063,148,28211,24975,25123,169.75,0 1 2 3,-1
621,w0,100,3089,4,150,0,COMPLETED_WALLTIME_REACHED,28063,150,28213,24974,25124,167.49333333333334,4 5 6 7,-1
622,w0,100,3094,5,149,0,COMPLETED_WALLTIME_REACHED,28063,149,28212,24969,25118,168.5771812080537,8 9 10 11 14,-1
685,w0,100,3433,3,152,0,COMPLETED_WALLTIME_REACHED,28067,152,28219,24634,24786,163.06578947368422,12 13 15,-1
623,w0,100,3105,4,147,0,COMPLETED_WALLTIME_REACHED,28211,147,28358,25106,25253,171.7891156462585,0 1 2 3,-1
624,w0,100,3118,5,150,0,COMPLETED_WALLTIME_REACHED,28212,150,28362,25094,25244,168.29333333333332,8 9 10 11 14,-1
625,w0,100,3122,4,149,0,COMPLETED_WALLTIME_REACHED,28213,149,28362,25091,25240,169.39597315436242,4 5 6 7,-1
627,w0,100,3129,4,151,0,COMPLETED_WALLTIME_REACHED,28362,151,28513,25233,25384,168.10596026490066,4 5 6 7,-1
628,w0,100,3137,4,150,0,COMPLETED_WALLTIME_REACHED,28362,150,28512,25225,25375,169.16666666666666,8 9 10 11,-1
626,w0,100,3127,5,149,0,COMPLETED_WALLTIME_REACHED,28363,149,28512,25236,25385,170.36912751677852,0 1 2 3 12,-1
688,w0,100,3476,3,146,0,COMPLETED_WALLTIME_REACHED,28367,146,28513,24891,25037,171.486301369863,13 14 15,-1
629,w0,100,3138,4,153,0,COMPLETED_WALLTIME_REACHED,28512,153,28665,25374,25527,166.84313725490196,0 1 2 3,-1
630,w0,100,3147,4,155,0,COMPLETED_WALLTIME_REACHED,28512,155,28667,25365,25520,164.6451612903226,8 9 10 11,-1
631,w0,100,3149,5,150,0,COMPLETED_WALLTIME_REACHED,28513,150,28663,25364,25514,170.09333333333333,4 5 6 7 12,-1
689,w0,100,3479,3,148,0,COMPLETED_WALLTIME_REACHED,28513,148,28661,25034,25182,170.14864864864865,13 14 15,-1
702,w0,100,3529,3,153,0,COMPLETED_WALLTIME_REACHED,28661,153,28814,25132,25285,165.26143790849673,13 14 15,-1
632,w0,100,3157,4,150,0,COMPLETED_WALLTIME_REACHED,28663,150,28813,25506,25656,171.04,4 5 6 7,-1
706,w0,100,3550,3,146,0,COMPLETED_WALLTIME_REACHED,28665,146,28811,25115,25261,173.0205479452055,0 1 2,-1
633,w0,100,3159,6,148,0,COMPLETED_WALLTIME_REACHED,28667,148,28815,25508,25656,173.35135135135135,3 8 9 10 11 12,-1
707,w0,100,3551,3,153,0,COMPLETED_WALLTIME_REACHED,28811,153,28964,25260,25413,166.09803921568627,0 1 2,-1
634,w0,100,3188,4,151,0,COMPLETED_WALLTIME_REACHED,28813,151,28964,25625,25776,170.7019867549669,4 5 6 7,-1
713,w0,100,3569,3,150,0,COMPLETED_WALLTIME_REACHED,28814,150,28964,25245,25395,169.3,13 14 15,-1
635,w0,100,3193,5,149,0,COMPLETED_WALLTIME_REACHED,28815,149,28964,25622,25771,172.95973154362417,3 8 9 10 11,-1
636,w0,100,3194,6,148,0,COMPLETED_WALLTIME_REACHED,28964,148,29112,25770,25918,175.1216216216216,0 1 2 3 4 5,-1
638,w0,100,3202,4,155,0,COMPLETED_WALLTIME_REACHED,28964,155,29119,25762,25917,167.20645161290324,6 7 8 9,-1
639,w0,100,3216,6,151,0,COMPLETED_WALLTIME_REACHED,28969,151,29120,25753,25904,171.5496688741722,10 11 12 13 14 15,-1
642,w0,100,3230,4,149,0,COMPLETED_WALLTIME_REACHED,29112,149,29261,25882,26031,174.70469798657717,0 1 2 3,-1
643,w0,100,3241,5,150,0,COMPLETED_WALLTIME_REACHED,29119,150,29269,25878,26028,173.52,4 5 6 7 8,-1
644,w0,100,3243,5,152,0,COMPLETED_WALLTIME_REACHED,29120,152,29272,25877,26029,171.2434210526316,9 10 11 12 13,-1
645,w0,100,3249,4,151,0,COMPLETED_WALLTIME_REACHED,29261,151,29412,26012,26163,173.26490066225165,0 1 2 3,-1
647,w0,100,3250,4,154,0,COMPLETED_WALLTIME_REACHED,29272,154,29426,26022,26176,169.97402597402598,9 10 11 12,-1
646,w0,100,3249,7,151,0,COMPLETED_WALLTIME_REACHED,29274,151,29425,26025,26176,173.35099337748343,4 5 6 7 8 14 15,-1
648,w0,100,3257,5,149,0,COMPLETED_WALLTIME_REACHED,29417,149,29566,26160,26309,176.5704697986577,0 1 2 3 13,-1
649,w0,100,3258,4,149,0,COMPLETED_WALLTIME_REACHED,29425,149,29574,26167,26316,176.61744966442953,4 5 6 7,-1
750,w0,100,3715,3,149,0,COMPLETED_WALLTIME_REACHED,29425,149,29574,25710,25859,173.5503355704698,8 14 15,-1
650,w0,100,3259,4,151,0,COMPLETED_WALLTIME_REACHED,29426,151,29577,26167,26318,174.2913907284768,9 10 11 12,-1
653,w0,100,3274,4,149,0,COMPLETED_WALLTIME_REACHED,29566,149,29715,26292,26441,177.45637583892616,0 1 2 3,-1
651,w0,100,3261,6,147,0,COMPLETED_WALLTIME_REACHED,29574,147,29721,26313,26460,180.0,4 5 6 7 8 13,-1
654,w0,100,3281,5,150,0,COMPLETED_WALLTIME_REACHED,29577,150,29727,26296,26446,176.30666666666667,9 10 11 12 14,-1
656,w0,100,3288,4,152,0,COMPLETED_WALLTIME_REACHED,29715,152,29867,26427,26579,174.86184210526315,0 1 2 3,-1
655,w0,100,3282,6,153,0,COMPLETED_WALLTIME_REACHED,29721,153,29874,26439,26592,173.80392156862746,4 5 6 7 8 13,-1
759,w0,100,3777,3,149,0,COMPLETED_WALLTIME_REACHED,29727,149,29876,25950,26099,175.16107382550337,9 10 11,-1
657,w0,100,3291,7,151,0,COMPLETED_WALLTIME_REACHED,29872,151,30023,26581,26732,177.03311258278146,0 1 2 3 12 14 15,-1
658,w0,100,3293,5,147,0,COMPLETED_WALLTIME_REACHED,29874,147,30021,26581,26728,181.8231292517007,4 5 6 7 8,-1
690,w0,100,3481,4,145,0,COMPLETED_WALLTIME_REACHED,29876,145,30021,26395,26540,183.0344827586207,9 10 11 13,-1
659,w0,100,3300,6,148,0,COMPLETED_WALLTIME_REACHED,30021,148,30169,26721,26869,181.5472972972973,4 5 6 7 8 9,-1
771,w0,100,3837,3,152,0,COMPLETED_WALLTIME_REACHED,30021,152,30173,26184,26336,173.26315789473685,10 11 13,-1
660,w0,100,3301,6,152,0,COMPLETED_WALLTIME_REACHED,30023,152,30175,26722,26874,176.80263157894737,0 1 2 3 12 14,-1
661,w0,100,3317,5,147,0,COMPLETED_WALLTIME_REACHED,30169,147,30316,26852,26999,183.66666666666666,4 5 6 7 8,-1
662,w0,100,3323,4,150,0,COMPLETED_WALLTIME_REACHED,30173,150,30323,26850,27000,180.0,9 10 11 13,-1
663,w0,100,3324,4,152,0,COMPLETED_WALLTIME_REACHED,30175,152,30327,26851,27003,177.65131578947367,0 1 2 3,-1
775,w0,100,3866,3,151,0,COMPLETED_WALLTIME_REACHED,30180,151,30331,26314,26465,175.26490066225165,12 14 15,-1
664,w0,100,3334,5,148,0,COMPLETED_WALLTIME_REACHED,30316,148,30464,26982,27130,183.3108108108108,4 5 6 7 8,-1
801,w0,100,3980,3,149,0,COMPLETED_WALLTIME_REACHED,30323,149,30472,26343,26492,177.7986577181208,9 10 11,-1
666,w0,100,3352,5,154,0,COMPLETED_WALLTIME_REACHED,30327,154,30481,26975,27129,176.16233766233765,0 1 2 3 13,-1
802,w0,100,3983,3,154,0,COMPLETED_WALLTIME_REACHED,30331,154,30485,26348,26502,172.0909090909091,12 14 15,-1
667,w0,100,3356,5,147,0,COMPLETED_WALLTIME_REACHED,30464,147,30611,27108,27255,185.40816326530611,4 5 6 7 8,-1
817,w0,100,4057,3,150,0,COMPLETED_WALLTIME_REACHED,30472,150,30622,26415,26565,177.1,9 10 11,-1
670,w0,100,3374,4,151,0,COMPLETED_WALLTIME_REACHED,30481,151,30632,27107,27258,180.51655629139074,0 1 2 3,-1
827,w0,100,4087,3,151,0,COMPLETED_WALLTIME_REACHED,30485,151,30636,26398,26549,175.82119205298014,12 13 14,-1
671,w0,100,3375,6,149,0,COMPLETED_WALLTIME_REACHED,30616,149,30765,27241,27390,183.8255033557047,4 5 6 7 8 15,-1
844,w0,100,4180,3,151,0,COMPLETED_WALLTIME_REACHED,30622,151,30773,26442,26593,176.11258278145695,9 10 11,-1
673,w0,100,3380,4,150,0,COMPLETED_WALLTIME_REACHED,30632,150,30782,27252,27402,182.68,0 1 2 3,-1
848,w0,100,4211,3,152,0,COMPLETED_WALLTIME_REACHED,30636,152,30788,26425,26577,174.84868421052633,12 13 14,-1
674,w0,100,3381,4,153,0,COMPLETED_WALLTIME_REACHED,30765,153,30918,27384,27537,179.98039215686273,4 5 6 7,-1
675,w0,100,3384,4,149,0,COMPLETED_WALLTIME_REACHED,30773,149,30922,27389,27538,184.81879194630872,8 9 10 11,-1
676,w0,100,3394,4,149,0,COMPLETED_WALLTIME_REACHED,30782,149,30931,27388,27537,184.81208053691276,0 1 2 3,-1
677,w0,100,3397,4,149,0,COMPLETED_WALLTIME_REACHED,30788,149,30937,27391,27540,184.83221476510067,12 13 14 15,-1
850,w0,100,4223,3,150,0,COMPLETED_WALLTIME_REACHED,30918,150,31068,26695,26845,178.96666666666667,4 5 6,-1
678,w0,100,3402,5,151,0,COMPLETED_WALLTIME_REACHED,30922,151,31073,27520,27671,183.25165562913907,7 8 9 10 11,-1
679,w0,100,3405,4,150,0,COMPLETED_WALLTIME_REACHED,30931,150,31081,27526,27676,184.50666666666666,0 1 2 3,-1
680,w0,100,3406,6,148,0,COMPLETED_WALLTIME_REACHED,31073,148,31221,27667,27815,187.9391891891892,4 5 6 12 13 14,-1
681,w0,100,3412,5,153,0,COMPLETED_WALLTIME_REACHED,31073,153,31226,27661,27814,181.79084967320262,7 8 9 10 11,-1
682,w0,100,3414,4,149,0,COMPLETED_WALLTIME_REACHED,31081,149,31230,27667,27816,186.68456375838926,0 1 2 3,-1
683,w0,100,3423,5,150,0,COMPLETED_WALLTIME_REACHED,31221,150,31371,27798,27948,186.32,4 5 6 12 13,-1
686,w0,100,3446,5,152,0,COMPLETED_WALLTIME_REACHED,31226,152,31378,27780,27932,183.76315789473685,7 8 9 10 11,-1
687,w0,100,3463,6,152,0,COMPLETED_WALLTIME_REACHED,31235,152,31387,27772,27924,183.71052631578948,0 1 2 3 14 15,-1
691,w0,100,3481,4,146,0,COMPLETED_WALLTIME_REACHED,31371,146,31517,27890,28036,192.02739726027397,4 5 6 12,-1
692,w0,100,3483,4,151,0,COMPLETED_WALLTIME_REACHED,31378,151,31529,27895,28046,185.73509933774835,7 8 9 10,-1
693,w0,100,3487,5,149,0,COMPLETED_WALLTIME_REACHED,31387,149,31536,27900,28049,188.248322147651,0 1 2 3 11,-1
862,w0,100,4289,3,147,0,COMPLETED_WALLTIME_REACHED,31387,147,31534,27098,27245,185.34013605442178,13 14 15,-1
694,w0,100,3489,4,149,0,COMPLETED_WALLTIME_REACHED,31517,149,31666,28028,28177,189.10738255033556,4 5 6 12,-1
695,w0,100,3498,4,150,0,COMPLETED_WALLTIME_REACHED,31529,150,31679,28031,28181,187.87333333333333,7 8 9 10,-1
864,w0,100,4330,3,152,0,COMPLETED_WALLTIME_REACHED,31534,152,31686,27204,27356,179.97368421052633,13 14 15,-1
696,w0,100,3502,5,149,0,COMPLETED_WALLTIME_REACHED,31536,149,31685,28034,28183,189.1476510067114,0 1 2 3 11,-1
697,w0,100,3502,6,153,0,COMPLETED_WALLTIME_REACHED,31679,153,31832,28177,28330,185.16339869281046,4 5 6 7 8 9,-1
698,w0,100,3511,5,151,0,COMPLETED_WALLTIME_REACHED,31685,151,31836,28174,28325,187.58278145695365,0 1 2 3 10,-1
699,w0,100,3512,4,152,0,COMPLETED_WALLTIME_REACHED,31686,152,31838,28174,28326,186.35526315789474,11 12 13 14,-1
700,w0,100,3518,4,150,0,COMPLETED_WALLTIME_REACHED,31832,150,31982,28314,28464,189.76,4 5 6 7,-1
701,w0,100,3520,6,150,0,COMPLETED_WALLTIME_REACHED,31836,150,31986,28316,28466,189.77333333333334,0 1 2 3 8 9,-1
703,w0,100,3539,5,149,0,COMPLETED_WALLTIME_REACHED,31838,149,31987,28299,28448,190.9261744966443,10 11 12 13 14,-1
705,w0,100,3549,4,150,0,COMPLETED_WALLTIME_REACHED,31986,150,32136,28437,28587,190.58,0 1 2 3,-1
704,w0,100,3547,5,149,0,COMPLETED_WALLTIME_REACHED,31987,149,32136,28440,28589,191.8724832214765,4 5 6 7 15,-1
708,w0,100,3554,4,152,0,COMPLETED_WALLTIME_REACHED,31987,152,32139,28433,28585,188.05921052631578,8 9 10 11,-1
865,w0,100,4339,3,150,0,COMPLETED_WALLTIME_REACHED,31987,150,32137,27648,27798,185.32,12 13 14,-1
709,w0,100,3557,4,150,0,COMPLETED_WALLTIME_REACHED,32136,150,32286,28579,28729,191.52666666666667,0 1 2 3,-1
710,w0,100,3557,4,152,0,COMPLETED_WALLTIME_REACHED,32136,152,32288,28579,28731,189.01973684210526,4 5 6 7,-1
711,w0,100,3559,4,149,0,COMPLETED_WALLTIME_REACHED,32137,149,32286,28578,28727,192.7986577181208,12 13 14 15,-1
712,w0,100,3569,4,152,0,COMPLETED_WALLTIME_REACHED,32139,152,32291,28570,28722,188.96052631578948,8 9 10 11,-1
714,w0,100,3572,5,147,0,COMPLETED_WALLTIME_REACHED,32286,147,32433,28714,28861,196.33333333333334,0 1 2 3 12,-1
867,w0,100,4350,3,148,0,COMPLETED_WALLTIME_REACHED,32286,148,32434,27936,28084,189.75675675675674,13 14 15,-1
715,w0,100,3572,4,152,0,COMPLETED_WALLTIME_REACHED,32288,152,32440,28716,28868,189.92105263157896,4 5 6 7,-1
716,w0,100,3582,4,148,0,COMPLETED_WALLTIME_REACHED,32291,148,32439,28709,28857,194.97972972972974,8 9 10 11,-1
717,w0,100,3589,6,150,0,COMPLETED_WALLTIME_REACHED,32434,150,32584,28845,28995,193.3,0 1 2 3 12 13,-1
719,w0,100,3608,4,150,0,COMPLETED_WALLTIME_REACHED,32439,150,32589,28831,28981,193.20666666666668,8 9 10 11,-1
720,w0,100,3620,6,149,0,COMPLETED_WALLTIME_REACHED,32440,149,32589,28820,28969,194.4228187919463,4 5 6 7 14 15,-1
721,w0,100,3621,5,145,0,COMPLETED_WALLTIME_REACHED,32584,145,32729,28963,29108,200.7448275862069,0 1 2 3 12,-1
722,w0,100,3628,6,152,0,COMPLETED_WALLTIME_REACHED,32589,152,32741,28961,29113,191.5328947368421,4 5 6 7 8 9,-1
723,w0,100,3629,5,151,0,COMPLETED_WALLTIME_REACHED,32589,151,32740,28960,29111,192.78807947019868,10 11 13 14 15,-1
724,w0,100,3630,4,146,0,COMPLETED_WALLTIME_REACHED,32729,146,32875,29099,29245,200.3082191780822,0 1 2 3,-1
725,w0,100,3637,6,151,0,COMPLETED_WALLTIME_REACHED,32740,151,32891,29103,29254,193.73509933774835,10 11 12 13 14 15,-1
726,w0,100,3641,5,147,0,COMPLETED_WALLTIME_REACHED,32741,147,32888,29100,29247,198.9591836734694,4 5 6 7 8,-1
727,w0,100,3646,5,147,0,COMPLETED_WALLTIME_REACHED,32880,147,33027,29234,29381,199.87074829931973,0 1 2 3 9,-1
728,w0,100,3646,5,153,0,COMPLETED_WALLTIME_REACHED,32888,153,33041,29242,29395,192.12418300653596,4 5 6 7 8,-1
729,w0,100,3647,5,152,0,COMPLETED_WALLTIME_REACHED,32891,152,33043,29244,29396,193.39473684210526,10 11 12 13 14,-1
730,w0,100,3649,4,149,0,COMPLETED_WALLTIME_REACHED,33027,149,33176,29378,29527,198.16778523489933,0 1 2 3,-1
731,w0,100,3655,4,151,0,COMPLETED_WALLTIME_REACHED,33041,151,33192,29386,29537,195.60927152317882,4 5 6 7,-1
732,w0,100,3658,5,151,0,COMPLETED_WALLTIME_REACHED,33043,151,33194,29385,29536,195.60264900662253,10 11 12 13 14,-1
875,w0,100,4410,3,148,0,COMPLETED_WALLTIME_REACHED,33046,148,33194,28636,28784,194.48648648648648,8 9 15,-1
733,w0,100,3658,4,148,0,COMPLETED_WALLTIME_REACHED,33176,148,33324,29518,29666,200.44594594594594,0 1 2 3,-1
735,w0,100,3669,4,151,0,COMPLETED_WALLTIME_REACHED,33192,151,33343,29523,29674,196.51655629139074,4 5 6 7,-1
734,w0,100,3665,5,153,0,COMPLETED_WALLTIME_REACHED,33194,153,33347,29529,29682,194.0,8 9 10 11 12,-1
876,w0,100,4415,3,151,0,COMPLETED_WALLTIME_REACHED,33194,151,33345,28779,28930,191.58940397350995,13 14 15,-1
736,w0,100,3670,4,147,0,COMPLETED_WALLTIME_REACHED,33324,147,33471,29654,29801,202.7278911564626,0 1 2 3,-1
737,w0,100,3672,4,153,0,COMPLETED_WALLTIME_REACHED,33343,153,33496,29671,29824,194.9281045751634,4 5 6 7,-1
885,w0,100,4449,3,149,0,COMPLETED_WALLTIME_REACHED,33345,149,33494,28896,29045,194.93288590604027,13 14 15,-1
738,w0,100,3673,4,149,0,COMPLETED_WALLTIME_REACHED,33347,149,33496,29674,29823,200.15436241610738,8 9 10 11,-1
739,w0,100,3679,4,149,0,COMPLETED_WALLTIME_REACHED,33471,149,33620,29792,29941,200.94630872483222,0 1 2 3,-1
740,w0,100,3681,5,150,0,COMPLETED_WALLTIME_REACHED,33496,150,33646,29815,29965,199.76666666666668,4 5 6 7 8,-1
742,w0,100,3697,4,152,0,COMPLETED_WALLTIME_REACHED,33499,152,33651,29802,29954,197.06578947368422,12 13 14 15,-1
741,w0,100,3687,5,151,0,COMPLETED_WALLTIME_REACHED,33625,151,33776,29938,30089,199.26490066225165,0 1 2 3 9,-1
743,w0,100,3697,4,150,0,COMPLETED_WALLTIME_REACHED,33646,150,33796,29949,30099,200.66,4 5 6 7,-1
889,w0,100,4468,3,151,0,COMPLETED_WALLTIME_REACHED,33651,151,33802,29183,29334,194.26490066225165,8 10 11,-1
744,w0,100,3697,4,152,0,COMPLETED_WALLTIME_REACHED,33651,152,33803,29954,30106,198.06578947368422,12 13 14 15,-1
745,w0,100,3699,4,153,0,COMPLETED_WALLTIME_REACHED,33776,153,33929,30077,30230,197.58169934640523,0 1 2 3,-1
746,w0,100,3701,4,148,0,COMPLETED_WALLTIME_REACHED,33796,148,33944,30095,30243,204.34459459459458,4 5 6 7,-1
747,w0,100,3710,4,150,0,COMPLETED_WALLTIME_REACHED,33802,150,33952,30092,30242,201.61333333333334,8 9 10 11,-1
748,w0,100,3711,6,153,0,COMPLETED_WALLTIME_REACHED,33934,153,34087,30223,30376,198.5359477124183,0 1 2 3 12 13,-1
749,w0,100,3714,4,148,0,COMPLETED_WALLTIME_REACHED,33944,148,34092,30230,30378,205.25675675675674,4 5 6 7,-1
751,w0,100,3717,4,152,0,COMPLETED_WALLTIME_REACHED,33952,152,34104,30235,30387,199.91447368421052,8 9 10 11,-1
752,w0,100,3719,4,150,0,COMPLETED_WALLTIME_REACHED,34087,150,34237,30368,30518,203.45333333333335,0 1 2 3,-1
891,w0,100,4478,3,152,0,COMPLETED_WALLTIME_REACHED,34092,152,34244,29614,29766,195.82894736842104,12 13 14,-1
753,w0,100,3733,5,151,0,COMPLETED_WALLTIME_REACHED,34097,151,34248,30364,30515,202.08609271523179,4 5 6 7 15,-1
754,w0,100,3740,4,150,0,COMPLETED_WALLTIME_REACHED,34104,150,34254,30364,30514,203.42666666666668,8 9 10 11,-1
755,w0,100,3768,5,149,0,COMPLETED_WALLTIME_REACHED,34244,149,34393,30476,30625,205.53691275167785,0 1 2 3 12,-1
756,w0,100,3768,5,149,0,COMPLETED_WALLTIME_REACHED,34248,149,34397,30480,30629,205.56375838926175,4 5 6 7 13,-1
757,w0,100,3772,6,149,0,COMPLETED_WALLTIME_REACHED,34254,149,34403,30482,30631,205.5771812080537,8 9 10 11 14 15,-1
758,w0,100,3774,5,147,0,COMPLETED_WALLTIME_REACHED,34393,147,34540,30619,30766,209.2925170068027,0 1 2 3 12,-1
761,w0,100,3791,5,150,0,COMPLETED_WALLTIME_REACHED,34397,150,34547,30606,30756,205.04,4 5 6 7 13,-1
762,w0,100,3797,5,150,0,COMPLETED_WALLTIME_REACHED,34403,150,34553,30606,30756,205.04,8 9 10 11 14,-1
763,w0,100,3799,4,151,0,COMPLETED_WALLTIME_REACHED,34540,151,34691,30741,30892,204.58278145695365,0 1 2 3,-1
764,w0,100,3803,5,152,0,COMPLETED_WALLTIME_REACHED,34547,152,34699,30744,30896,203.26315789473685,4 5 6 7 12,-1
765,w0,100,3806,6,147,0,COMPLETED_WALLTIME_REACHED,34553,147,34700,30747,30894,210.16326530612244,8 9 10 11 13 14,-1
766,w0,100,3807,4,148,0,COMPLETED_WALLTIME_REACHED,34691,148,34839,30884,31032,209.67567567567568,0 1 2 3,-1
767,w0,100,3813,5,152,0,COMPLETED_WALLTIME_REACHED,34699,152,34851,30886,31038,204.19736842105263,4 5 6 7 12,-1
769,w0,100,3826,6,154,0,COMPLETED_WALLTIME_REACHED,34700,154,34854,30874,31028,201.4805194805195,8 9 10 11 13 14,-1
770,w0,100,3836,5,151,0,COMPLETED_WALLTIME_REACHED,34844,151,34995,31008,31159,206.35099337748343,0 1 2 3 15,-1
772,w0,100,3844,5,148,0,COMPLETED_WALLTIME_REACHED,34851,148,34999,31007,31155,210.50675675675674,4 5 6 7 12,-1
773,w0,100,3847,4,150,0,COMPLETED_WALLTIME_REACHED,34854,150,35004,31007,31157,207.71333333333334,8 9 10 11,-1
774,w0,100,3850,4,144,0,COMPLETED_WALLTIME_REACHED,34995,144,35139,31145,31289,217.28472222222223,0 1 2 3,-1
776,w0,100,3869,4,150,0,COMPLETED_WALLTIME_REACHED,34999,150,35149,31130,31280,208.53333333333333,4 5 6 7,-1
896,w0,100,4516,3,149,0,COMPLETED_WALLTIME_REACHED,35000,149,35149,30484,30633,205.59060402684563,13 14 15,-1
777,w0,100,3869,4,149,0,COMPLETED_WALLTIME_REACHED,35004,149,35153,31135,31284,209.95973154362417,8 9 10 11,-1
778,w0,100,3870,5,151,0,COMPLETED_WALLTIME_REACHED,35144,151,35295,31274,31425,208.11258278145695,0 1 2 3 12,-1
779,w0,100,3873,4,152,0,COMPLETED_WALLTIME_REACHED,35149,152,35301,31276,31428,206.76315789473685,4 5 6 7,-1
899,w0,100,4523,3,150,0,COMPLETED_WALLTIME_REACHED,35149,150,35299,30626,30776,205.17333333333335,13 14 15,-1
780,w0,100,3878,4,152,0,COMPLETED_WALLTIME_REACHED,35153,152,35305,31275,31427,206.7565789473684,8 9 10 11,-1
781,w0,100,3883,5,152,0,COMPLETED_WALLTIME_REACHED,35295,152,35447,31412,31564,207.6578947368421,0 1 2 3 12,-1
782,w0,100,3895,5,150,0,COMPLETED_WALLTIME_REACHED,35301,150,35451,31406,31556,210.37333333333333,4 5 6 7 13,-1
783,w0,100,3896,6,149,0,COMPLETED_WALLTIME_REACHED,35305,149,35454,31409,31558,211.7986577181208,8 9 10 11 14 15,-1
784,w0,100,3902,4,149,0,COMPLETED_WALLTIME_REACHED,35447,149,35596,31545,31694,212.71140939597316,0 1 2 3,-1
785,w0,100,3908,5,147,0,COMPLETED_WALLTIME_REACHED,35451,147,35598,31543,31690,215.57823129251702,4 5 6 7 12,-1
786,w0,100,3918,4,152,0,COMPLETED_WALLTIME_REACHED,35454,152,35606,31536,31688,208.47368421052633,8 9 10 11,-1
900,w0,100,4524,3,146,0,COMPLETED_WALLTIME_REACHED,35454,146,35600,30930,31076,212.84931506849315,13 14 15,-1
787,w0,100,3919,4,146,0,COMPLETED_WALLTIME_REACHED,35596,146,35742,31677,31823,217.96575342465752,0 1 2 3,-1
788,w0,100,3920,5,150,0,COMPLETED_WALLTIME_REACHED,35598,150,35748,31678,31828,212.18666666666667,4 5 6 7 12,-1
789,w0,100,3922,5,150,0,COMPLETED_WALLTIME_REACHED,35606,150,35756,31684,31834,212.22666666666666,8 9 10 11 13,-1
790,w0,100,3926,4,152,0,COMPLETED_WALLTIME_REACHED,35742,152,35894,31816,31968,210.31578947368422,0 1 2 3,-1
791,w0,100,3927,5,149,0,COMPLETED_WALLTIME_REACHED,35748,149,35897,31821,31970,214.56375838926175,4 5 6 7 12,-1
792,w0,100,3934,6,149,0,COMPLETED_WALLTIME_REACHED,35761,149,35910,31827,31976,214.60402684563758,8 9 10 11 13 14,-1
793,w0,100,3936,4,151,0,COMPLETED_WALLTIME_REACHED,35894,151,36045,31958,32109,212.64238410596028,0 1 2 3,-1
794,w0,100,3943,4,150,0,COMPLETED_WALLTIME_REACHED,35897,150,36047,31954,32104,214.02666666666667,4 5 6 7,-1
795,w0,100,3951,6,151,0,COMPLETED_WALLTIME_REACHED,35910,151,36061,31959,32110,212.64900662251657,8 9 10 11 12 13,-1
796,w0,100,3953,5,152,0,COMPLETED_WALLTIME_REACHED,36050,152,36202,32097,32249,212.16447368421052,0 1 2 3 14,-1
797,w0,100,3966,5,149,0,COMPLETED_WALLTIME_REACHED,36052,149,36201,32086,32235,216.34228187919464,4 5 6 7 15,-1
798,w0,100,3973,6,149,0,COMPLETED_WALLTIME_REACHED,36061,149,36210,32088,32237,216.35570469798657,8 9 10 11 12 13,-1
807,w0,100,4001,4,151,0,COMPLETED_WALLTIME_REACHED,36201,151,36352,32200,32351,214.24503311258277,4 5 6 7,-1
799,w0,100,3974,6,150,0,COMPLETED_WALLTIME_REACHED,36202,150,36352,32228,32378,215.85333333333332,0 1 2 3 14 15,-1
800,w0,100,3976,6,152,0,COMPLETED_WALLTIME_REACHED,36210,152,36362,32234,32386,213.06578947368422,8 9 10 11 12 13,-1
803,w0,100,3988,6,151,0,COMPLETED_WALLTIME_REACHED,36352,151,36503,32364,32515,215.33112582781456,0 1 2 3 4 5,-1
809,w0,100,4015,4,151,0,COMPLETED_WALLTIME_REACHED,36352,151,36503,32337,32488,215.1523178807947,6 7 14 15,-1
804,w0,100,3997,5,149,0,COMPLETED_WALLTIME_REACHED,36362,149,36511,32365,32514,218.21476510067114,8 9 10 11 12,-1
805,w0,100,3998,5,151,0,COMPLETED_WALLTIME_REACHED,36503,151,36654,32505,32656,216.26490066225165,0 1 2 3 4,-1
806,w0,100,3999,5,152,0,COMPLETED_WALLTIME_REACHED,36508,152,36660,32509,32661,214.875,5 6 7 13 14,-1
808,w0,100,4002,5,149,0,COMPLETED_WALLTIME_REACHED,36511,149,36660,32509,32658,219.18120805369128,8 9 10 11 12,-1
811,w0,100,4019,5,152,0,COMPLETED_WALLTIME_REACHED,36654,152,36806,32635,32787,215.70394736842104,0 1 2 3 4,-1
812,w0,100,4025,7,146,0,COMPLETED_WALLTIME_REACHED,36660,146,36806,32635,32781,224.52739726027397,5 6 7 8 9 10 11,-1
813,w0,100,4033,4,150,0,COMPLETED_WALLTIME_REACHED,36665,150,36815,32632,32782,218.54666666666665,12 13 14 15,-1
814,w0,100,4036,6,152,0,COMPLETED_WALLTIME_REACHED,36806,152,36958,32770,32922,216.5921052631579,0 1 2 3 4 5,-1
815,w0,100,4037,5,150,0,COMPLETED_WALLTIME_REACHED,36806,150,36956,32769,32919,219.46,6 7 8 9 10,-1
816,w0,100,4040,4,153,0,COMPLETED_WALLTIME_REACHED,36815,153,36968,32775,32928,215.2156862745098,11 12 13 14,-1
818,w0,100,4058,5,148,0,COMPLETED_WALLTIME_REACHED,36956,148,37104,32898,33046,223.28378378378378,6 7 8 9 10,-1
819,w0,100,4060,5,149,0,COMPLETED_WALLTIME_REACHED,36958,149,37107,32898,33047,221.79194630872485,0 1 2 3 4,-1
820,w0,100,4067,4,149,0,COMPLETED_WALLTIME_REACHED,36968,149,37117,32901,33050,221.81208053691276,5 11 12 13,-1
821,w0,100,4072,4,150,0,COMPLETED_WALLTIME_REACHED,37104,150,37254,33032,33182,221.21333333333334,6 7 8 9,-1
822,w0,100,4072,4,150,0,COMPLETED_WALLTIME_REACHED,37107,150,37257,33035,33185,221.23333333333332,0 1 2 3,-1
904,w0,100,4539,3,151,0,COMPLETED_WALLTIME_REACHED,37109,151,37260,32570,32721,216.6953642384106,10 14 15,-1
823,w0,100,4074,5,150,0,COMPLETED_WALLTIME_REACHED,37117,150,37267,33043,33193,221.28666666666666,4 5 11 12 13,-1
910,w0,100,4568,3,150,0,COMPLETED_WALLTIME_REACHED,37254,150,37404,32686,32836,218.90666666666667,6 7 8,-1
824,w0,100,4075,5,150,0,COMPLETED_WALLTIME_REACHED,37257,150,37407,33182,33332,222.21333333333334,0 1 2 3 9,-1
912,w0,100,4572,3,151,0,COMPLETED_WALLTIME_REACHED,37260,151,37411,32688,32839,217.47682119205297,10 14 15,-1
826,w0,100,4082,4,151,0,COMPLETED_WALLTIME_REACHED,37267,151,37418,33185,33336,220.7682119205298,4 5 11 12,-1
829,w0,100,4091,4,154,0,COMPLETED_WALLTIME_REACHED,37407,154,37561,33316,33470,217.33766233766235,0 1 2 3,-1
828,w0,100,4090,4,148,0,COMPLETED_WALLTIME_REACHED,37409,148,37557,33319,33467,226.1283783783784,6 7 8 13,-1
830,w0,100,4096,4,149,0,COMPLETED_WALLTIME_REACHED,37411,149,37560,33315,33464,224.59060402684563,9 10 14 15,-1
920,w0,100,4614,3,149,0,COMPLETED_WALLTIME_REACHED,37418,149,37567,32804,32953,221.16107382550337,4 5 11,-1
940,w0,100,4734,3,151,0,COMPLETED_WALLTIME_REACHED,37560,151,37711,32826,32977,218.39072847682118,9 10 14,-1
832,w0,100,4100,5,149,0,COMPLETED_WALLTIME_REACHED,37561,149,37710,33461,33610,225.5704697986577,0 1 2 3 15,-1
831,w0,100,4096,5,151,0,COMPLETED_WALLTIME_REACHED,37562,151,37713,33466,33617,222.6291390728477,6 7 8 12 13,-1
943,w0,100,4751,3,150,0,COMPLETED_WALLTIME_REACHED,37567,150,37717,32816,32966,219.77333333333334,4 5 11,-1
833,w0,100,4103,5,149,0,COMPLETED_WALLTIME_REACHED,37710,149,37859,33607,33756,226.5503355704698,0 1 2 3 15,-1
980,w0,100,4890,3,151,0,COMPLETED_WALLTIME_REACHED,37711,151,37862,32821,32972,218.35761589403972,9 10 14,-1
834,w0,100,4106,5,151,0,COMPLETED_WALLTIME_REACHED,37713,151,37864,33607,33758,223.56291390728478,6 7 8 12 13,-1
982,w0,100,4894,3,154,0,COMPLETED_WALLTIME_REACHED,37717,154,37871,32823,32977,214.13636363636363,4 5 11,-1
835,w0,100,4107,5,149,0,COMPLETED_WALLTIME_REACHED,37859,149,38008,33752,33901,227.5234899328859,0 1 2 3 15,-1
836,w0,100,4108,6,148,0,COMPLETED_WALLTIME_REACHED,37864,148,38012,33756,33904,229.0810810810811,6 7 8 9 10 12,-1
837,w0,100,4114,4,151,0,COMPLETED_WALLTIME_REACHED,37871,151,38022,33757,33908,224.5562913907285,4 5 11 13,-1
839,w0,100,4121,6,148,0,COMPLETED_WALLTIME_REACHED,38012,148,38160,33891,34039,229.99324324324326,6 7 8 9 10 12,-1
838,w0,100,4118,5,146,0,COMPLETED_WALLTIME_REACHED,38013,146,38159,33895,34041,233.15753424657535,0 1 2 3 14,-1
840,w0,100,4143,4,152,0,COMPLETED_WALLTIME_REACHED,38022,152,38174,33879,34031,223.88815789473685,4 5 11 13,-1
841,w0,100,4150,4,151,0,COMPLETED_WALLTIME_REACHED,38159,151,38310,34009,34160,226.2251655629139,0 1 2 3,-1
842,w0,100,4165,5,154,0,COMPLETED_WALLTIME_REACHED,38160,154,38314,33995,34149,221.74675324675326,6 7 8 9 10,-1
990,w0,100,4941,3,146,0,COMPLETED_WALLTIME_REACHED,38165,146,38311,33224,33370,228.56164383561645,12 14 15,-1
843,w0,100,4172,4,149,0,COMPLETED_WALLTIME_REACHED,38174,149,38323,34002,34151,229.2013422818792,4 5 11 13,-1
845,w0,100,4187,4,150,0,COMPLETED_WALLTIME_REACHED,38310,150,38460,34123,34273,228.48666666666668,0 1 2 3,-1
846,w0,100,4199,6,153,0,COMPLETED_WALLTIME_REACHED,38314,153,38467,34115,34268,223.9738562091503,6 7 8 9 10 12,-1
847,w0,100,4204,6,151,0,COMPLETED_WALLTIME_REACHED,38323,151,38474,34119,34270,226.95364238410596,4 5 11 13 14 15,-1
854,w0,100,4247,4,149,0,COMPLETED_WALLTIME_REACHED,38460,149,38609,34213,34362,230.61744966442953,0 1 2 3,-1
849,w0,100,4219,5,151,0,COMPLETED_WALLTIME_REACHED,38467,151,38618,34248,34399,227.80794701986756,6 7 8 9 10,-1
1000,w0,100,5022,3,150,0,COMPLETED_WALLTIME_REACHED,38474,150,38624,33452,33602,224.01333333333332,4 5 11,-1
851,w0,100,4224,8,148,0,COMPLETED_WALLTIME_REACHED,38614,148,38762,34390,34538,233.36486486486487,0 1 2 3 12 13 14 15,-1
852,w0,100,4244,5,147,0,COMPLETED_WALLTIME_REACHED,38618,147,38765,34374,34521,234.83673469387756,6 7 8 9 10,-1
856,w0,100,4254,6,153,0,COMPLETED_WALLTIME_REACHED,38765,153,38918,34511,34664,226.56209150326796,6 7 8 9 10 15,-1
853,w0,100,4246,6,147,0,COMPLETED_WALLTIME_REACHED,38767,147,38914,34521,34668,235.83673469387756,0 1 2 3 4 5,-1
855,w0,100,4252,4,151,0,COMPLETED_WALLTIME_REACHED,38767,151,38918,34515,34666,229.57615894039736,11 12 13 14,-1
857,w0,100,4258,6,151,0,COMPLETED_WALLTIME_REACHED,38914,151,39065,34656,34807,230.50993377483445,0 1 2 3 4 5,-1
858,w0,100,4266,4,149,0,COMPLETED_WALLTIME_REACHED,38918,149,39067,34652,34801,233.56375838926175,6 7 8 9,-1
859,w0,100,4271,5,148,0,COMPLETED_WALLTIME_REACHED,38918,148,39066,34647,34795,235.10135135135135,10 11 12 13 14,-1
860,w0,100,4278,5,149,0,COMPLETED_WALLTIME_REACHED,39065,149,39214,34787,34936,234.46979865771812,0 1 2 3 4,-1
861,w0,100,4286,5,148,0,COMPLETED_WALLTIME_REACHED,39066,148,39214,34780,34928,236.0,5 10 11 12 13,-1
863,w0,100,4301,4,148,0,COMPLETED_WALLTIME_REACHED,39067,148,39215,34766,34914,235.90540540540542,6 7 8 9,-1
866,w0,100,4346,5,151,0,COMPLETED_WALLTIME_REACHED,39214,151,39365,34868,35019,231.91390728476821,0 1 2 3 4,-1
868,w0,100,4360,6,151,0,COMPLETED_WALLTIME_REACHED,39219,151,39370,34859,35010,231.8543046357616,5 10 11 12 13 14,-1
869,w0,100,4366,5,147,0,COMPLETED_WALLTIME_REACHED,39220,147,39367,34854,35001,238.10204081632654,6 7 8 9 15,-1
871,w0,100,4374,4,150,0,COMPLETED_WALLTIME_REACHED,39365,150,39515,34991,35141,234.27333333333334,0 1 2 3,-1
870,w0,100,4370,6,150,0,COMPLETED_WALLTIME_REACHED,39367,150,39517,34997,35147,234.31333333333333,4 6 7 8 9 15,-1
872,w0,100,4387,5,148,0,COMPLETED_WALLTIME_REACHED,39370,148,39518,34983,35131,237.3716216216216,5 10 11 12 13,-1
874,w0,100,4406,4,149,0,COMPLETED_WALLTIME_REACHED,39515,149,39664,35109,35258,236.63087248322148,0 1 2 3,-1
878,w0,100,4420,4,150,0,COMPLETED_WALLTIME_REACHED,39518,150,39668,35098,35248,234.98666666666668,5 10 11 12,-1
877,w0,100,4417,6,148,0,COMPLETED_WALLTIME_REACHED,39522,148,39670,35105,35253,238.19594594594594,4 6 7 8 9 14,-1
879,w0,100,4420,4,149,0,COMPLETED_WALLTIME_REACHED,39664,149,39813,35244,35393,237.53691275167785,0 1 2 3,-1
880,w0,100,4424,4,151,0,COMPLETED_WALLTIME_REACHED,39668,151,39819,35244,35395,234.40397350993376,5 10 11 12,-1
881,w0,100,4430,4,148,0,COMPLETED_WALLTIME_REACHED,39670,148,39818,35240,35388,239.1081081081081,4 6 7 8,-1
882,w0,100,4435,6,151,0,COMPLETED_WALLTIME_REACHED,39818,151,39969,35383,35534,235.32450331125827,0 1 2 3 9 13,-1
883,w0,100,4446,4,149,0,COMPLETED_WALLTIME_REACHED,39818,149,39967,35372,35521,238.39597315436242,4 6 7 8,-1
886,w0,100,4461,5,147,0,COMPLETED_WALLTIME_REACHED,39824,147,39971,35363,35510,241.56462585034015,5 10 11 12 14,-1
888,w0,100,4467,5,149,0,COMPLETED_WALLTIME_REACHED,39969,149,40118,35502,35651,239.26845637583892,0 1 2 3 9,-1
890,w0,100,4472,5,152,0,COMPLETED_WALLTIME_REACHED,39971,152,40123,35499,35651,234.54605263157896,5 10 11 12 13,-1
887,w0,100,4465,5,152,0,COMPLETED_WALLTIME_REACHED,39972,152,40124,35507,35659,234.59868421052633,4 6 7 8 15,-1
892,w0,100,4485,5,151,0,COMPLETED_WALLTIME_REACHED,40118,151,40269,35633,35784,236.98013245033113,0 1 2 3 9,-1
894,w0,100,4498,4,148,0,COMPLETED_WALLTIME_REACHED,40124,148,40272,35626,35774,241.71621621621622,4 6 7 8,-1
893,w0,100,4497,6,149,0,COMPLETED_WALLTIME_REACHED,40128,149,40277,35631,35780,240.13422818791946,5 10 11 12 13 14,-1
895,w0,100,4513,4,152,0,COMPLETED_WALLTIME_REACHED,40269,152,40421,35756,35908,236.23684210526315,0 1 2 3,-1
897,w0,100,4517,5,147,0,COMPLETED_WALLTIME_REACHED,40272,147,40419,35755,35902,244.2312925170068,4 6 7 8 9,-1
898,w0,100,4517,7,150,0,COMPLETED_WALLTIME_REACHED,40282,150,40432,35765,35915,239.43333333333334,5 10 11 12 13 14 15,-1
901,w0,100,4527,5,151,0,COMPLETED_WALLTIME_REACHED,40419,151,40570,35892,36043,238.6953642384106,4 6 7 8 9,-1
908,w0,100,4553,4,149,0,COMPLETED_WALLTIME_REACHED,40421,149,40570,35868,36017,241.7248322147651,0 1 2 3,-1
902,w0,100,4530,5,149,0,COMPLETED_WALLTIME_REACHED,40432,149,40581,35902,36051,241.95302013422818,5 10 11 12 13,-1
903,w0,100,4533,5,154,0,COMPLETED_WALLTIME_REACHED,40570,154,40724,36037,36191,235.0064935064935,0 1 2 3 4,-1
905,w0,100,4547,5,151,0,COMPLETED_WALLTIME_REACHED,40575,151,40726,36028,36179,239.59602649006624,6 7 8 9 14,-1
906,w0,100,4551,6,148,0,COMPLETED_WALLTIME_REACHED,40586,148,40734,36035,36183,244.47972972972974,5 10 11 12 13 15,-1
907,w0,100,4552,5,153,0,COMPLETED_WALLTIME_REACHED,40724,153,40877,36172,36325,237.41830065359477,0 1 2 3 4,-1
909,w0,100,4558,5,147,0,COMPLETED_WALLTIME_REACHED,40726,147,40873,36168,36315,247.0408163265306,6 7 8 9 14,-1
911,w0,100,4569,4,148,0,COMPLETED_WALLTIME_REACHED,40734,148,40882,36165,36313,245.3581081081081,5 10 11 12,-1
913,w0,100,4573,4,154,0,COMPLETED_WALLTIME_REACHED,40873,154,41027,36300,36454,236.71428571428572,6 7 8 9,-1
914,w0,100,4579,4,152,0,COMPLETED_WALLTIME_REACHED,40877,152,41029,36298,36450,239.80263157894737,0 1 2 3,-1
915,w0,100,4588,6,152,0,COMPLETED_WALLTIME_REACHED,40887,152,41039,36299,36451,239.80921052631578,4 5 10 11 12 13,-1
916,w0,100,4589,5,151,0,COMPLETED_WALLTIME_REACHED,41032,151,41183,36443,36594,242.34437086092714,6 7 8 9 14,-1
917,w0,100,4591,5,148,0,COMPLETED_WALLTIME_REACHED,41034,148,41182,36443,36591,247.23648648648648,0 1 2 3 15,-1
918,w0,100,4593,5,149,0,COMPLETED_WALLTIME_REACHED,41039,149,41188,36446,36595,245.60402684563758,4 5 10 11 12,-1
924,w0,100,4655,4,149,0,COMPLETED_WALLTIME_REACHED,41183,149,41332,36528,36677,246.15436241610738,6 7 8 9,-1
919,w0,100,4594,6,151,0,COMPLETED_WALLTIME_REACHED,41187,151,41338,36593,36744,243.33774834437085,0 1 2 3 13 15,-1
921,w0,100,4624,6,151,0,COMPLETED_WALLTIME_REACHED,41188,151,41339,36564,36715,243.1456953642384,4 5 10 11 12 14,-1
926,w0,100,4660,4,151,0,COMPLETED_WALLTIME_REACHED,41332,151,41483,36672,36823,243.86092715231788,6 7 8 9,-1
922,w0,100,4629,6,149,0,COMPLETED_WALLTIME_REACHED,41338,149,41487,36709,36858,247.36912751677852,0 1 2 3 13 15,-1
923,w0,100,4634,5,149,0,COMPLETED_WALLTIME_REACHED,41339,149,41488,36705,36854,247.34228187919464,4 5 10 11 12,-1
927,w0,100,4660,5,150,0,COMPLETED_WALLTIME_REACHED,41487,150,41637,36827,36977,246.51333333333332,0 1 2 3 13,-1
925,w0,100,4659,5,152,0,COMPLETED_WALLTIME_REACHED,41488,152,41640,36829,36981,243.29605263157896,6 7 8 9 14,-1
928,w0,100,4669,5,151,0,COMPLETED_WALLTIME_REACHED,41488,151,41639,36819,36970,244.83443708609272,4 5 10 11 12,-1
929,w0,100,4677,4,150,0,COMPLETED_WALLTIME_REACHED,41637,150,41787,36960,37110,247.4,0 1 2 3,-1
930,w0,100,4683,5,149,0,COMPLETED_WALLTIME_REACHED,41639,149,41788,36956,37105,249.0268456375839,4 5 10 11 12,-1
931,w0,100,4683,4,150,0,COMPLETED_WALLTIME_REACHED,41640,150,41790,36957,37107,247.38,6 7 8 9,-1
932,w0,100,4683,4,154,0,COMPLETED_WALLTIME_REACHED,41787,154,41941,37104,37258,241.93506493506493,0 1 2 3,-1
933,w0,100,4689,5,148,0,COMPLETED_WALLTIME_REACHED,41788,148,41936,37099,37247,251.6689189189189,4 5 10 11 12,-1
934,w0,100,4690,4,150,0,COMPLETED_WALLTIME_REACHED,41790,150,41940,37100,37250,248.33333333333334,6 7 8 9,-1
935,w0,100,4701,4,147,0,COMPLETED_WALLTIME_REACHED,41936,147,42083,37235,37382,254.29931972789115,4 5 10 11,-1
936,w0,100,4703,5,148,0,COMPLETED_WALLTIME_REACHED,41940,148,42088,37237,37385,252.60135135135135,6 7 8 9 12,-1
937,w0,100,4710,4,152,0,COMPLETED_WALLTIME_REACHED,41941,152,42093,37231,37383,245.94078947368422,0 1 2 3,-1
938,w0,100,4713,4,152,0,COMPLETED_WALLTIME_REACHED,42083,152,42235,37370,37522,246.85526315789474,4 5 10 11,-1
939,w0,100,4718,5,151,0,COMPLETED_WALLTIME_REACHED,42088,151,42239,37370,37521,248.48344370860926,6 7 8 9 12,-1
941,w0,100,4742,5,150,0,COMPLETED_WALLTIME_REACHED,42098,150,42248,37356,37506,250.04,0 1 2 3 13,-1
944,w0,100,4753,5,150,0,COMPLETED_WALLTIME_REACHED,42239,150,42389,37486,37636,250.90666666666667,6 7 8 9 12,-1
942,w0,100,4745,6,147,0,COMPLETED_WALLTIME_REACHED,42240,147,42387,37495,37642,256.06802721088434,4 5 10 11 14 15,-1
945,w0,100,4762,5,152,0,COMPLETED_WALLTIME_REACHED,42248,152,42400,37486,37638,247.6184210526316,0 1 2 3 13,-1
946,w0,100,4765,4,150,0,COMPLETED_WALLTIME_REACHED,42387,150,42537,37622,37772,251.81333333333333,4 5 10 11,-1
947,w0,100,4773,5,151,0,COMPLETED_WALLTIME_REACHED,42389,151,42540,37616,37767,250.11258278145695,6 7 8 9 12,-1
948,w0,100,4776,5,152,0,COMPLETED_WALLTIME_REACHED,42400,152,42552,37624,37776,248.52631578947367,0 1 2 3 13,-1
950,w0,100,4781,4,151,0,COMPLETED_WALLTIME_REACHED,42540,151,42691,37759,37910,251.05960264900662,6 7 8 9,-1
949,w0,100,4777,5,152,0,COMPLETED_WALLTIME_REACHED,42542,152,42694,37765,37917,249.45394736842104,4 5 10 11 14,-1
951,w0,100,4782,6,149,0,COMPLETED_WALLTIME_REACHED,42552,149,42701,37770,37919,254.48993288590603,0 1 2 3 12 13,-1
952,w0,100,4792,4,150,0,COMPLETED_WALLTIME_REACHED,42691,150,42841,37899,38049,253.66,6 7 8 9,-1
954,w0,100,4801,4,153,0,COMPLETED_WALLTIME_REACHED,42694,153,42847,37893,38046,248.66666666666666,4 5 10 11,-1
953,w0,100,4797,7,151,0,COMPLETED_WALLTIME_REACHED,42701,151,42852,37904,38055,252.01986754966887,0 1 2 3 12 13 14,-1
955,w0,100,4801,4,147,0,COMPLETED_WALLTIME_REACHED,42841,147,42988,38040,38187,259.7755102040816,6 7 8 9,-1
957,w0,100,4802,5,148,0,COMPLETED_WALLTIME_REACHED,42852,148,43000,38050,38198,258.0945945945946,4 5 10 11 15,-1
956,w0,100,4802,6,146,0,COMPLETED_WALLTIME_REACHED,42852,146,42998,38050,38196,261.6164383561644,0 1 2 3 12 13,-1
958,w0,100,4812,5,150,0,COMPLETED_WALLTIME_REACHED,42993,150,43143,38181,38331,255.54,6 7 8 9 14,-1
959,w0,100,4813,4,147,0,COMPLETED_WALLTIME_REACHED,42998,147,43145,38185,38332,260.76190476190476,0 1 2 3,-1
960,w0,100,4825,4,148,0,COMPLETED_WALLTIME_REACHED,43000,148,43148,38175,38323,258.93918918918916,4 5 10 11,-1
961,w0,100,4826,5,152,0,COMPLETED_WALLTIME_REACHED,43148,152,43300,38322,38474,253.1184210526316,6 7 8 9 12,-1
963,w0,100,4833,5,150,0,COMPLETED_WALLTIME_REACHED,43148,150,43298,38315,38465,256.43333333333334,4 5 10 11 14,-1
962,w0,100,4827,5,150,0,COMPLETED_WALLTIME_REACHED,43150,150,43300,38323,38473,256.4866666666667,0 1 2 3 13,-1
964,w0,100,4833,5,148,0,COMPLETED_WALLTIME_REACHED,43298,148,43446,38465,38613,260.89864864864865,4 5 10 11 14,-1
965,w0,100,4836,5,145,0,COMPLETED_WALLTIME_REACHED,43300,145,43445,38464,38609,266.2689655172414,0 1 2 3 6,-1
966,w0,100,4848,5,151,0,COMPLETED_WALLTIME_REACHED,43300,151,43451,38452,38603,255.64900662251657,7 8 9 12 13,-1
967,w0,100,4851,5,150,0,COMPLETED_WALLTIME_REACHED,43445,150,43595,38594,38744,258.29333333333335,0 1 2 3 6,-1
968,w0,100,4851,5,147,0,COMPLETED_WALLTIME_REACHED,43446,147,43593,38595,38742,263.55102040816325,4 5 10 11 14,-1
969,w0,100,4852,5,150,0,COMPLETED_WALLTIME_REACHED,43451,150,43601,38599,38749,258.32666666666665,7 8 9 12 13,-1
970,w0,100,4854,4,149,0,COMPLETED_WALLTIME_REACHED,43593,149,43742,38739,38888,260.99328859060404,4 5 10 11,-1
971,w0,100,4856,4,150,0,COMPLETED_WALLTIME_REACHED,43595,150,43745,38739,38889,259.26,0 1 2 3,-1
972,w0,100,4859,5,148,0,COMPLETED_WALLTIME_REACHED,43601,148,43749,38742,38890,262.77027027027026,6 7 8 9 12,-1
973,w0,100,4865,5,150,0,COMPLETED_WALLTIME_REACHED,43747,150,43897,38882,39032,260.2133333333333,4 5 10 11 13,-1
975,w0,100,4873,5,147,0,COMPLETED_WALLTIME_REACHED,43749,147,43896,38876,39023,265.4625850340136,6 7 8 9 12,-1
974,w0,100,4872,6,146,0,COMPLETED_WALLTIME_REACHED,43750,146,43896,38878,39024,267.28767123287673,0 1 2 3 14 15,-1
976,w0,100,4874,7,150,0,COMPLETED_WALLTIME_REACHED,43896,150,44046,39022,39172,261.14666666666665,0 1 2 3 6 7 8,-1
977,w0,100,4885,4,144,0,COMPLETED_WALLTIME_REACHED,43896,144,44040,39011,39155,271.90972222222223,9 12 14 15,-1
978,w0,100,4887,5,148,0,COMPLETED_WALLTIME_REACHED,43897,148,44045,39010,39158,264.5810810810811,4 5 10 11 13,-1
981,w0,100,4893,4,148,0,COMPLETED_WALLTIME_REACHED,44040,148,44188,39147,39295,265.5067567567568,9 12 14 15,-1
979,w0,100,4889,5,150,0,COMPLETED_WALLTIME_REACHED,44045,150,44195,39156,39306,262.04,4 5 10 11 13,-1
983,w0,100,4904,5,150,0,COMPLETED_WALLTIME_REACHED,44046,150,44196,39142,39292,261.94666666666666,0 1 2 3 6,-1
984,w0,100,4912,5,149,0,COMPLETED_WALLTIME_REACHED,44193,149,44342,39281,39430,264.6308724832215,7 8 9 12 14,-1
985,w0,100,4920,5,152,0,COMPLETED_WALLTIME_REACHED,44195,152,44347,39275,39427,259.3881578947368,4 5 10 11 13,-1
986,w0,100,4923,6,148,0,COMPLETED_WALLTIME_REACHED,44196,148,44344,39273,39421,266.3581081081081,0 1 2 3 6 15,-1
987,w0,100,4923,5,152,0,COMPLETED_WALLTIME_REACHED,44342,152,44494,39419,39571,260.3355263157895,7 8 9 12 14,-1
988,w0,100,4927,4,149,0,COMPLETED_WALLTIME_REACHED,44344,149,44493,39417,39566,265.5436241610738,0 1 2 3,-1
991,w0,100,4953,5,150,0,COMPLETED_WALLTIME_REACHED,44347,150,44497,39394,39544,263.62666666666667,4 5 6 10 11,-1
997,w0,100,5004,5,150,0,COMPLETED_WALLTIME_REACHED,44497,150,44647,39493,39643,264.2866666666667,4 5 6 10 11,-1
993,w0,100,4985,5,149,0,COMPLETED_WALLTIME_REACHED,44498,149,44647,39513,39662,266.18791946308727,0 1 2 3 13,-1
994,w0,100,4996,6,152,0,COMPLETED_WALLTIME_REACHED,44499,152,44651,39503,39655,260.8881578947368,7 8 9 12 14 15,-1
995,w0,100,4996,6,152,0,COMPLETED_WALLTIME_REACHED,44647,152,44799,39651,39803,261.8618421052632,0 1 2 3 4 5,-1
998,w0,100,5013,5,154,0,COMPLETED_WALLTIME_REACHED,44651,154,44805,39638,39792,258.38961038961037,6 7 8 9 10,-1
999,w0,100,5021,5,151,0,COMPLETED_WALLTIME_REACHED,44651,151,44802,39630,39781,263.4503311258278,11 12 13 14 15,-1
