job_id,workload_name,profile,submission_time,requested_number_of_resources,requested_time,success,final_state,starting_time,execution_time,finish_time,waiting_time,turnaround_time,stretch,allocated_resources,consumed_energy
1,w0,100,12,4,151,0,COMPLETED_WALLTIME_REACHED,12,151,163,0,151,1.0,0 1 2 3,-1
2,w0,100,13,7,149,0,COMPLETED_WALLTIME_REACHED,13,149,162,0,149,1.0,4 5 6 7 8 9 10,-1
3,w0,100,16,3,151,0,COMPLETED_WALLTIME_REACHED,16,151,167,0,151,1.0,11 12 13,-1
4,w0,100,21,6,151,0,COMPLETED_WALLTIME_REACHED,162,151,313,141,292,1.9337748344370862,4 5 6 7 8 9,-1
5,w0,100,28,5,146,0,COMPLETED_WALLTIME_REACHED,163,146,309,135,281,1.9246575342465753,0 1 2 3 10,-1
8,w0,100,55,3,150,0,COMPLETED_WALLTIME_REACHED,167,150,317,112,262,1.7466666666666666,11 12 13,-1
7,w0,100,46,4,149,0,COMPLETED_WALLTIME_REACHED,313,149,462,267,416,2.791946308724832,4 5 6 7,-1
6,w0,100,42,7,151,0,COMPLETED_WALLTIME_REACHED,314,151,465,272,423,2.801324503311258,0 1 2 3 10 14 15,-1
9,w0,100,56,4,151,0,COMPLETED_WALLTIME_REACHED,317,151,468,261,412,2.728476821192053,8 9 11 12,-1
11,w0,100,64,4,146,0,COMPLETED_WALLTIME_REACHED,465,146,611,401,547,3.7465753424657535,0 1 2 3,-1
13,w0,100,71,3,149,0,COMPLETED_WALLTIME_REACHED,465,149,614,394,543,3.6442953020134228,10 14 15,-1
10,w0,100,57,5,150,0,COMPLETED_WALLTIME_REACHED,467,150,617,410,560,3.7333333333333334,4 5 6 7 13,-1
12,w0,100,65,4,156,0,COMPLETED_WALLTIME_REACHED,468,156,624,403,559,3.5833333333333335,8 9 11 12,-1
14,w0,100,80,4,147,0,COMPLETED_WALLTIME_REACHED,611,147,758,531,678,4.612244897959184,0 1 2 3,-1
21,w0,100,114,3,154,0,COMPLETED_WALLTIME_REACHED,614,154,768,500,654,4.246753246753247,10 14 15,-1
15,w0,100,84,4,148,0,COMPLETED_WALLTIME_REACHED,617,148,765,533,681,4.601351351351352,4 5 6 7,-1
16,w0,100,90,4,148,0,COMPLETED_WALLTIME_REACHED,624,148,772,534,682,4.608108108108108,8 9 11 12,-1
17,w0,100,100,4,151,0,COMPLETED_WALLTIME_REACHED,758,151,909,658,809,5.357615894039735,0 1 2 3,-1
90,w0,100,490,2,153,0,COMPLETED_WALLTIME_REACHED,768,153,921,278,431,2.816993464052288,10 14,-1
18,w0,100,102,5,152,0,COMPLETED_WALLTIME_REACHED,770,152,922,668,820,5.394736842105263,4 5 6 7 13,-1
19,w0,100,102,5,151,0,COMPLETED_WALLTIME_REACHED,772,151,923,670,821,5.437086092715232,8 9 11 12 15,-1
20,w0,100,107,4,151,0,COMPLETED_WALLTIME_REACHED,909,151,1060,802,953,6.311258278145695,0 1 2 3,-1
125,w0,100,647,2,149,0,COMPLETED_WALLTIME_REACHED,921,149,1070,274,423,2.838926174496644,10 14,-1
22,w0,100,117,4,151,0,COMPLETED_WALLTIME_REACHED,922,151,1073,805,956,6.33112582781457,4 5 6 7,-1
23,w0,100,118,4,148,0,COMPLETED_WALLTIME_REACHED,923,148,1071,805,953,6.4391891891891895,8 9 11 12,-1
24,w0,100,127,5,150,0,COMPLETED_WALLTIME_REACHED,1065,150,1215,938,1088,7.253333333333333,0 1 2 3 13,-1
27,w0,100,168,3,151,0,COMPLETED_WALLTIME_REACHED,1071,151,1222,903,1054,6.9801324503311255,8 9 11,-1
26,w0,100,155,5,150,0,COMPLETED_WALLTIME_REACHED,1073,150,1223,918,1068,7.12,4 5 6 7 12,-1
25,w0,100,152,3,145,0,COMPLETED_WALLTIME_REACHED,1075,145,1220,923,1068,7.36551724137931,10 14 15,-1
28,w0,100,176,4,148,0,COMPLETED_WALLTIME_REACHED,1215,148,1363,1039,1187,8.02027027027027,0 1 2 3,-1
221,w0,100,1078,2,153,0,COMPLETED_WALLTIME_REACHED,1220,153,1373,142,295,1.9281045751633987,10 13,-1
29,w0,100,190,5,149,0,COMPLETED_WALLTIME_REACHED,1222,149,1371,1032,1181,7.926174496644295,8 9 11 14 15,-1
30,w0,100,195,4,149,0,COMPLETED_WALLTIME_REACHED,1223,149,1372,1028,1177,7.899328859060403,4 5 6 7,-1
31,w0,100,206,3,147,0,COMPLETED_WALLTIME_REACHED,1363,147,1510,1157,1304,8.870748299319727,0 1 2,-1
250,w0,100,1269,2,145,0,COMPLETED_WALLTIME_REACHED,1368,145,1513,99,244,1.6827586206896552,3 12,-1
32,w0,100,209,5,147,0,COMPLETED_WALLTIME_REACHED,1371,147,1518,1162,1309,8.904761904761905,8 9 11 14 15,-1
33,w0,100,218,4,151,0,COMPLETED_WALLTIME_REACHED,1372,151,1523,1154,1305,8.642384105960264,4 5 6 7,-1
34,w0,100,245,4,148,0,COMPLETED_WALLTIME_REACHED,1515,148,1663,1270,1418,9.58108108108108,0 1 2 10,-1
53,w0,100,341,3,149,0,COMPLETED_WALLTIME_REACHED,1518,149,1667,1177,1326,8.899328859060402,3 12 13,-1
35,w0,100,247,4,149,0,COMPLETED_WALLTIME_REACHED,1518,149,1667,1271,1420,9.53020134228188,8 9 11 14,-1
36,w0,100,251,5,150,0,COMPLETED_WALLTIME_REACHED,1523,150,1673,1272,1422,9.48,4 5 6 7 15,-1
44,w0,100,292,4,149,0,COMPLETED_WALLTIME_REACHED,1663,149,1812,1371,1520,10.201342281879194,0 1 2 10,-1
37,w0,100,257,5,152,0,COMPLETED_WALLTIME_REACHED,1667,152,1819,1410,1562,10.276315789473685,3 8 9 11 12,-1
275,w0,100,1364,2,152,0,COMPLETED_WALLTIME_REACHED,1667,152,1819,303,455,2.9934210526315788,13 14,-1
38,w0,100,261,5,150,0,COMPLETED_WALLTIME_REACHED,1673,150,1823,1412,1562,10.413333333333334,4 5 6 7 15,-1
47,w0,100,306,4,150,0,COMPLETED_WALLTIME_REACHED,1812,150,1962,1506,1656,11.04,0 1 2 10,-1
39,w0,100,262,5,148,0,COMPLETED_WALLTIME_REACHED,1819,148,1967,1557,1705,11.52027027027027,3 8 9 11 12,-1
40,w0,100,266,7,150,0,COMPLETED_WALLTIME_REACHED,1823,150,1973,1557,1707,11.38,4 5 6 7 13 14 15,-1
48,w0,100,308,4,152,0,COMPLETED_WALLTIME_REACHED,1962,152,2114,1654,1806,11.881578947368421,0 1 2 10,-1
41,w0,100,272,5,147,0,COMPLETED_WALLTIME_REACHED,1967,147,2114,1695,1842,12.53061224489796,3 8 9 11 12,-1
42,w0,100,284,5,151,0,COMPLETED_WALLTIME_REACHED,1973,151,2124,1689,1840,12.185430463576159,4 5 6 7 13,-1
290,w0,100,1477,2,151,0,COMPLETED_WALLTIME_REACHED,1973,151,2124,496,647,4.28476821192053,14 15,-1
43,w0,100,287,6,153,0,COMPLETED_WALLTIME_REACHED,2114,153,2267,1827,1980,12.941176470588236,0 1 2 3 8 9,-1
55,w0,100,348,3,153,0,COMPLETED_WALLTIME_REACHED,2114,153,2267,1766,1919,12.542483660130719,10 11 12,-1
45,w0,100,292,5,147,0,COMPLETED_WALLTIME_REACHED,2124,147,2271,1832,1979,13.462585034013605,4 5 6 7 13,-1
305,w0,100,1544,2,149,0,COMPLETED_WALLTIME_REACHED,2124,149,2273,580,729,4.89261744966443,14 15,-1
46,w0,100,306,5,152,0,COMPLETED_WALLTIME_REACHED,2267,152,2419,1961,2113,13.901315789473685,0 1 2 3 8,-1
51,w0,100,328,4,152,0,COMPLETED_WALLTIME_REACHED,2267,152,2419,1939,2091,13.756578947368421,9 10 11 12,-1
49,w0,100,311,5,150,0,COMPLETED_WALLTIME_REACHED,2271,150,2421,1960,2110,14.066666666666666,4 5 6 7 13,-1
314,w0,100,1590,2,150,0,COMPLETED_WALLTIME_REACHED,2273,150,2423,683,833,5.553333333333334,14 15,-1
50,w0,100,316,6,149,0,COMPLETED_WALLTIME_REACHED,2419,149,2568,2103,2252,15.114093959731544,0 1 2 3 8 9,-1
59,w0,100,360,3,153,0,COMPLETED_WALLTIME_REACHED,2419,153,2572,2059,2212,14.457516339869281,10 11 12,-1
52,w0,100,334,5,146,0,COMPLETED_WALLTIME_REACHED,2421,146,2567,2087,2233,15.294520547945206,4 5 6 7 13,-1
323,w0,100,1639,2,147,0,COMPLETED_WALLTIME_REACHED,2423,147,2570,784,931,6.333333333333333,14 15,-1
54,w0,100,342,4,149,0,COMPLETED_WALLTIME_REACHED,2567,149,2716,2225,2374,15.93288590604027,4 5 6 7,-1
395,w0,100,2027,1,152,0,COMPLETED_WALLTIME_REACHED,2567,152,2719,540,692,4.552631578947368,13,-1
56,w0,100,351,6,150,0,COMPLETED_WALLTIME_REACHED,2568,150,2718,2217,2367,15.78,0 1 2 3 8 9,-1
57,w0,100,356,4,151,0,COMPLETED_WALLTIME_REACHED,2572,151,2723,2216,2367,15.675496688741722,10 11 12 14,-1
58,w0,100,359,6,150,0,COMPLETED_WALLTIME_REACHED,2718,150,2868,2359,2509,16.726666666666667,0 1 2 3 8 9,-1
60,w0,100,366,5,152,0,COMPLETED_WALLTIME_REACHED,2721,152,2873,2355,2507,16.49342105263158,4 5 6 7 15,-1
61,w0,100,366,4,148,0,COMPLETED_WALLTIME_REACHED,2723,148,2871,2357,2505,16.925675675675677,10 11 12 13,-1
63,w0,100,376,4,149,0,COMPLETED_WALLTIME_REACHED,2871,149,3020,2495,2644,17.74496644295302,10 11 12 13,-1
62,w0,100,375,7,150,0,COMPLETED_WALLTIME_REACHED,2873,150,3023,2498,2648,17.653333333333332,0 1 2 3 8 9 14,-1
65,w0,100,383,3,146,0,COMPLETED_WALLTIME_REACHED,2873,146,3019,2490,2636,18.054794520547944,4 5 6,-1
327,w0,100,1660,2,149,0,COMPLETED_WALLTIME_REACHED,2873,149,3022,1213,1362,9.140939597315436,7 15,-1
64,w0,100,381,6,151,0,COMPLETED_WALLTIME_REACHED,3020,151,3171,2639,2790,18.47682119205298,4 5 6 10 11 12,-1
69,w0,100,399,3,154,0,COMPLETED_WALLTIME_REACHED,3022,154,3176,2623,2777,18.032467532467532,7 13 15,-1
66,w0,100,384,4,147,0,COMPLETED_WALLTIME_REACHED,3023,147,3170,2639,2786,18.952380952380953,0 1 2 3,-1
203,w0,100,1025,3,147,0,COMPLETED_WALLTIME_REACHED,3023,147,3170,1998,2145,14.591836734693878,8 9 14,-1
67,w0,100,386,5,154,0,COMPLETED_WALLTIME_REACHED,3170,154,3324,2784,2938,19.07792207792208,0 1 2 3 8,-1
392,w0,100,2018,2,152,0,COMPLETED_WALLTIME_REACHED,3170,152,3322,1152,1304,8.578947368421053,9 14,-1
68,w0,100,388,4,151,0,COMPLETED_WALLTIME_REACHED,3171,151,3322,2783,2934,19.43046357615894,4 5 6 10,-1
70,w0,100,408,5,151,0,COMPLETED_WALLTIME_REACHED,3176,151,3327,2768,2919,19.33112582781457,7 11 12 13 15,-1
71,w0,100,411,4,154,0,COMPLETED_WALLTIME_REACHED,3322,154,3476,2911,3065,19.9025974025974,4 5 6 9,-1
420,w0,100,2178,2,151,0,COMPLETED_WALLTIME_REACHED,3322,151,3473,1144,1295,8.57615894039735,10 14,-1
72,w0,100,414,4,149,0,COMPLETED_WALLTIME_REACHED,3324,149,3473,2910,3059,20.530201342281877,0 1 2 3,-1
73,w0,100,419,5,150,0,COMPLETED_WALLTIME_REACHED,3327,150,3477,2908,3058,20.386666666666667,7 8 11 12 13,-1
74,w0,100,423,4,152,0,COMPLETED_WALLTIME_REACHED,3473,152,3625,3050,3202,21.06578947368421,0 1 2 3,-1
77,w0,100,437,4,152,0,COMPLETED_WALLTIME_REACHED,3476,152,3628,3039,3191,20.99342105263158,4 5 6 9,-1
76,w0,100,434,5,152,0,COMPLETED_WALLTIME_REACHED,3477,152,3629,3043,3195,21.019736842105264,7 8 11 12 13,-1
75,w0,100,428,3,148,0,COMPLETED_WALLTIME_REACHED,3478,148,3626,3050,3198,21.60810810810811,10 14 15,-1
464,w0,100,2410,2,151,0,COMPLETED_WALLTIME_REACHED,3625,151,3776,1215,1366,9.04635761589404,0 1,-1
78,w0,100,442,5,150,0,COMPLETED_WALLTIME_REACHED,3626,150,3776,3184,3334,22.226666666666667,2 3 10 14 15,-1
82,w0,100,468,3,151,0,COMPLETED_WALLTIME_REACHED,3628,151,3779,3160,3311,21.927152317880793,4 5 6,-1
79,w0,100,449,6,150,0,COMPLETED_WALLTIME_REACHED,3629,150,3779,3180,3330,22.2,7 8 9 11 12 13,-1
80,w0,100,459,6,151,0,COMPLETED_WALLTIME_REACHED,3776,151,3927,3317,3468,22.966887417218544,0 1 2 3 10 14,-1
81,w0,100,462,5,151,0,COMPLETED_WALLTIME_REACHED,3779,151,3930,3317,3468,22.966887417218544,4 5 6 7 8,-1
83,w0,100,471,4,147,0,COMPLETED_WALLTIME_REACHED,3779,147,3926,3308,3455,23.503401360544217,9 11 12 13,-1
86,w0,100,481,4,148,0,COMPLETED_WALLTIME_REACHED,3926,148,4074,3445,3593,24.277027027027028,9 11 12 13,-1
85,w0,100,479,5,147,0,COMPLETED_WALLTIME_REACHED,3930,147,4077,3451,3598,24.476190476190474,4 5 6 7 8,-1
84,w0,100,477,7,155,0,COMPLETED_WALLTIME_REACHED,3932,155,4087,3455,3610,23.29032258064516,0 1 2 3 10 14 15,-1
87,w0,100,483,4,150,0,COMPLETED_WALLTIME_REACHED,4074,150,4224,3591,3741,24.94,9 11 12 13,-1
88,w0,100,488,5,151,0,COMPLETED_WALLTIME_REACHED,4077,151,4228,3589,3740,24.7682119205298,4 5 6 7 8,-1
89,w0,100,489,3,154,0,COMPLETED_WALLTIME_REACHED,4087,154,4241,3598,3752,24.363636363636363,0 1 2,-1
91,w0,100,494,4,149,0,COMPLETED_WALLTIME_REACHED,4087,149,4236,3593,3742,25.114093959731544,3 10 14 15,-1
92,w0,100,494,4,151,0,COMPLETED_WALLTIME_REACHED,4224,151,4375,3730,3881,25.70198675496689,9 11 12 13,-1
93,w0,100,498,5,152,0,COMPLETED_WALLTIME_REACHED,4228,152,4380,3730,3882,25.539473684210527,4 5 6 7 8,-1
494,w0,100,2584,2,151,0,COMPLETED_WALLTIME_REACHED,4236,151,4387,1652,1803,11.940397350993377,3 10,-1
94,w0,100,508,5,150,0,COMPLETED_WALLTIME_REACHED,4241,150,4391,3733,3883,25.886666666666667,0 1 2 14 15,-1
97,w0,100,520,4,146,0,COMPLETED_WALLTIME_REACHED,4375,146,4521,3855,4001,27.404109589041095,9 11 12 13,-1
95,w0,100,509,5,149,0,COMPLETED_WALLTIME_REACHED,4380,149,4529,3871,4020,26.97986577181208,4 5 6 7 8,-1
96,w0,100,512,7,150,0,COMPLETED_WALLTIME_REACHED,4391,150,4541,3879,4029,26.86,0 1 2 3 10 14 15,-1
100,w0,100,526,3,150,0,COMPLETED_WALLTIME_REACHED,4521,150,4671,3995,4145,27.633333333333333,9 11 12,-1
98,w0,100,521,5,152,0,COMPLETED_WALLTIME_REACHED,4529,152,4681,4008,4160,27.36842105263158,4 5 6 7 8,-1
99,w0,100,521,6,148,0,COMPLETED_WALLTIME_REACHED,4541,148,4689,4020,4168,28.16216216216216,0 1 2 3 10 13,-1
101,w0,100,531,5,151,0,COMPLETED_WALLTIME_REACHED,4676,151,4827,4145,4296,28.450331125827816,9 11 12 14 15,-1
102,w0,100,533,5,150,0,COMPLETED_WALLTIME_REACHED,4681,150,4831,4148,4298,28.653333333333332,4 5 6 7 8,-1
103,w0,100,534,3,151,0,COMPLETED_WALLTIME_REACHED,4689,151,4840,4155,4306,28.516556291390728,0 1 2,-1
105,w0,100,540,3,150,0,COMPLETED_WALLTIME_REACHED,4689,150,4839,4149,4299,28.66,3 10 13,-1
104,w0,100,535,4,152,0,COMPLETED_WALLTIME_REACHED,4827,152,4979,4292,4444,29.236842105263158,9 11 12 14,-1
106,w0,100,556,4,155,0,COMPLETED_WALLTIME_REACHED,4831,155,4986,4275,4430,28.580645161290324,4 5 6 7,-1
107,w0,100,564,5,149,0,COMPLETED_WALLTIME_REACHED,4839,149,4988,4275,4424,29.691275167785236,3 8 10 13 15,-1
532,w0,100,2789,2,150,0,COMPLETED_WALLTIME_REACHED,4840,150,4990,2051,2201,14.673333333333334,0 1,-1
108,w0,100,567,5,151,0,COMPLETED_WALLTIME_REACHED,4984,151,5135,4417,4568,30.251655629139073,2 9 11 12 14,-1
109,w0,100,569,3,151,0,COMPLETED_WALLTIME_REACHED,4986,151,5137,4417,4568,30.251655629139073,4 5 6,-1
110,w0,100,574,4,147,0,COMPLETED_WALLTIME_REACHED,4988,147,5135,4414,4561,31.027210884353742,3 7 8 10,-1
539,w0,100,2855,2,149,0,COMPLETED_WALLTIME_REACHED,4988,149,5137,2133,2282,15.315436241610739,13 15,-1
560,w0,100,2970,2,147,0,COMPLETED_WALLTIME_REACHED,4990,147,5137,2020,2167,14.741496598639456,0 1,-1
111,w0,100,575,5,149,0,COMPLETED_WALLTIME_REACHED,5135,149,5284,4560,4709,31.604026845637584,2 3 7 8 9,-1
116,w0,100,619,3,152,0,COMPLETED_WALLTIME_REACHED,5135,152,5287,4516,4668,30.710526315789473,10 11 12,-1
112,w0,100,578,5,149,0,COMPLETED_WALLTIME_REACHED,5137,149,5286,4559,4708,31.59731543624161,0 1 4 5 6,-1
133,w0,100,732,3,151,0,COMPLETED_WALLTIME_REACHED,5137,151,5288,4405,4556,30.172185430463575,13 14 15,-1
113,w0,100,599,5,150,0,COMPLETED_WALLTIME_REACHED,5284,150,5434,4685,4835,32.233333333333334,2 3 7 8 9,-1
114,w0,100,601,5,149,0,COMPLETED_WALLTIME_REACHED,5286,149,5435,4685,4834,32.442953020134226,0 1 4 5 6,-1
136,w0,100,736,3,149,0,COMPLETED_WALLTIME_REACHED,5287,149,5436,4551,4700,31.543624161073826,10 11 12,-1
373,w0,100,1915,3,146,0,COMPLETED_WALLTIME_REACHED,5288,146,5434,3373,3519,24.102739726027398,13 14 15,-1
115,w0,100,602,7,146,0,COMPLETED_WALLTIME_REACHED,5434,146,5580,4832,4978,34.0958904109589,2 3 7 8 9 13 14,-1
117,w0,100,619,5,146,0,COMPLETED_WALLTIME_REACHED,5435,146,5581,4816,4962,33.986301369863014,0 1 4 5 6,-1
118,w0,100,625,4,150,0,COMPLETED_WALLTIME_REACHED,5436,150,5586,4811,4961,33.07333333333333,10 11 12 15,-1
119,w0,100,636,4,151,0,COMPLETED_WALLTIME_REACHED,5580,151,5731,4944,5095,33.741721854304636,2 3 7 8,-1
140,w0,100,756,3,148,0,COMPLETED_WALLTIME_REACHED,5580,148,5728,4824,4972,33.5945945945946,9 13 14,-1
120,w0,100,640,4,147,0,COMPLETED_WALLTIME_REACHED,5581,147,5728,4941,5088,34.61224489795919,0 1 4 5,-1
121,w0,100,643,4,151,0,COMPLETED_WALLTIME_REACHED,5586,151,5737,4943,5094,33.735099337748345,6 10 11 12,-1
122,w0,100,643,5,149,0,COMPLETED_WALLTIME_REACHED,5728,149,5877,5085,5234,35.12751677852349,0 1 4 5 9,-1
123,w0,100,643,6,152,0,COMPLETED_WALLTIME_REACHED,5731,152,5883,5088,5240,34.473684210526315,2 3 7 8 13 14,-1
124,w0,100,645,4,150,0,COMPLETED_WALLTIME_REACHED,5737,150,5887,5092,5242,34.946666666666665,6 10 11 12,-1
126,w0,100,664,4,150,0,COMPLETED_WALLTIME_REACHED,5877,150,6027,5213,5363,35.75333333333333,0 1 4 5,-1
594,w0,100,3100,2,151,0,COMPLETED_WALLTIME_REACHED,5882,151,6033,2782,2933,19.423841059602648,9 15,-1
127,w0,100,671,4,150,0,COMPLETED_WALLTIME_REACHED,5883,150,6033,5212,5362,35.74666666666667,2 3 7 8,-1
128,w0,100,679,5,152,0,COMPLETED_WALLTIME_REACHED,5887,152,6039,5208,5360,35.26315789473684,6 10 11 12 13,-1
129,w0,100,687,5,151,0,COMPLETED_WALLTIME_REACHED,6032,151,6183,5345,5496,36.397350993377486,0 1 4 5 14,-1
130,w0,100,696,6,150,0,COMPLETED_WALLTIME_REACHED,6033,150,6183,5337,5487,36.58,2 3 7 8 9 15,-1
131,w0,100,706,5,148,0,COMPLETED_WALLTIME_REACHED,6039,148,6187,5333,5481,37.03378378378378,6 10 11 12 13,-1
132,w0,100,730,4,152,0,COMPLETED_WALLTIME_REACHED,6183,152,6335,5453,5605,36.875,0 1 2 3,-1
134,w0,100,733,5,151,0,COMPLETED_WALLTIME_REACHED,6183,151,6334,5450,5601,37.09271523178808,4 5 7 8 9,-1
751,w0,100,3851,2,153,0,COMPLETED_WALLTIME_REACHED,6183,153,6336,2332,2485,16.241830065359476,14 15,-1
135,w0,100,736,4,150,0,COMPLETED_WALLTIME_REACHED,6187,150,6337,5451,5601,37.34,6 10 11 12,-1
138,w0,100,742,5,151,0,COMPLETED_WALLTIME_REACHED,6336,151,6487,5594,5745,38.04635761589404,0 1 2 3 14,-1
139,w0,100,745,5,147,0,COMPLETED_WALLTIME_REACHED,6337,147,6484,5592,5739,39.04081632653061,6 10 11 12 15,-1
137,w0,100,740,6,150,0,COMPLETED_WALLTIME_REACHED,6339,150,6489,5599,5749,38.32666666666667,4 5 7 8 9 13,-1
141,w0,100,759,4,151,0,COMPLETED_WALLTIME_REACHED,6484,151,6635,5725,5876,38.913907284768214,6 10 11 12,-1
142,w0,100,760,5,151,0,COMPLETED_WALLTIME_REACHED,6487,151,6638,5727,5878,38.9271523178808,0 1 2 3 14,-1
143,w0,100,766,6,149,0,COMPLETED_WALLTIME_REACHED,6489,149,6638,5723,5872,39.40939597315436,4 5 7 8 9 13,-1
144,w0,100,768,6,147,0,COMPLETED_WALLTIME_REACHED,6638,147,6785,5870,6017,40.93197278911565,0 1 2 3 4 5,-1
146,w0,100,780,4,152,0,COMPLETED_WALLTIME_REACHED,6638,152,6790,5858,6010,39.53947368421053,7 8 9 13,-1
145,w0,100,770,5,149,0,COMPLETED_WALLTIME_REACHED,6640,149,6789,5870,6019,40.395973154362416,6 10 11 12 15,-1
147,w0,100,788,5,154,0,COMPLETED_WALLTIME_REACHED,6785,154,6939,5997,6151,39.94155844155844,0 1 2 3 4,-1
148,w0,100,789,3,150,0,COMPLETED_WALLTIME_REACHED,6789,150,6939,6000,6150,41.0,6 10 11,-1
845,w0,100,4289,2,150,0,COMPLETED_WALLTIME_REACHED,6789,150,6939,2500,2650,17.666666666666668,12 15,-1
833,w0,100,4227,2,150,0,COMPLETED_WALLTIME_REACHED,6790,150,6940,2563,2713,18.086666666666666,5 14,-1
149,w0,100,795,4,147,0,COMPLETED_WALLTIME_REACHED,6790,147,6937,5995,6142,41.78231292517007,7 8 9 13,-1
150,w0,100,800,3,152,0,COMPLETED_WALLTIME_REACHED,6937,152,7089,6137,6289,41.375,7 8 9,-1
151,w0,100,800,5,149,0,COMPLETED_WALLTIME_REACHED,6939,149,7088,6139,6288,42.20134228187919,0 1 2 3 4,-1
152,w0,100,804,4,152,0,COMPLETED_WALLTIME_REACHED,6939,152,7091,6135,6287,41.36184210526316,6 10 11 12,-1
153,w0,100,806,4,148,0,COMPLETED_WALLTIME_REACHED,6940,148,7088,6134,6282,42.445945945945944,5 13 14 15,-1
154,w0,100,808,5,152,0,COMPLETED_WALLTIME_REACHED,7088,152,7240,6280,6432,42.31578947368421,0 1 2 3 4,-1
155,w0,100,808,6,154,0,COMPLETED_WALLTIME_REACHED,7089,154,7243,6281,6435,41.785714285714285,5 7 8 9 13 14,-1
156,w0,100,816,4,153,0,COMPLETED_WALLTIME_REACHED,7091,153,7244,6275,6428,42.01307189542484,6 10 11 12,-1
157,w0,100,819,5,156,0,COMPLETED_WALLTIME_REACHED,7240,156,7396,6421,6577,42.16025641025641,0 1 2 3 4,-1
158,w0,100,828,3,148,0,COMPLETED_WALLTIME_REACHED,7243,148,7391,6415,6563,44.3445945945946,5 7 8,-1
198,w0,100,1003,4,146,0,COMPLETED_WALLTIME_REACHED,7244,146,7390,6241,6387,43.74657534246575,6 10 11 12,-1
159,w0,100,829,4,148,0,COMPLETED_WALLTIME_REACHED,7248,148,7396,6419,6567,44.37162162162162,9 13 14 15,-1
160,w0,100,836,6,153,0,COMPLETED_WALLTIME_REACHED,7391,153,7544,6555,6708,43.84313725490196,5 6 7 8 10 11,-1
161,w0,100,843,4,149,0,COMPLETED_WALLTIME_REACHED,7396,149,7545,6553,6702,44.97986577181208,0 1 2 3,-1
162,w0,100,845,4,152,0,COMPLETED_WALLTIME_REACHED,7396,152,7548,6551,6703,44.098684210526315,4 9 12 13,-1
857,w0,100,4355,2,146,0,COMPLETED_WALLTIME_REACHED,7396,146,7542,3041,3187,21.828767123287673,14 15,-1
870,w0,100,4402,2,151,0,COMPLETED_WALLTIME_REACHED,7542,151,7693,3140,3291,21.794701986754966,14 15,-1
163,w0,100,850,5,154,0,COMPLETED_WALLTIME_REACHED,7544,154,7698,6694,6848,44.467532467532465,5 6 7 8 10,-1
164,w0,100,856,3,151,0,COMPLETED_WALLTIME_REACHED,7545,151,7696,6689,6840,45.29801324503311,0 1 2,-1
872,w0,100,4409,2,151,0,COMPLETED_WALLTIME_REACHED,7545,151,7696,3136,3287,21.7682119205298,3 11,-1
165,w0,100,856,3,149,0,COMPLETED_WALLTIME_REACHED,7548,149,7697,6692,6841,45.91275167785235,4 9 12,-1
166,w0,100,862,4,154,0,COMPLETED_WALLTIME_REACHED,7696,154,7850,6834,6988,45.37662337662338,0 1 2 3,-1
171,w0,100,881,3,148,0,COMPLETED_WALLTIME_REACHED,7697,148,7845,6816,6964,47.054054054054056,4 9 11,-1
170,w0,100,880,3,151,0,COMPLETED_WALLTIME_REACHED,7698,151,7849,6818,6969,46.152317880794705,13 14 15,-1
167,w0,100,865,6,148,0,COMPLETED_WALLTIME_REACHED,7698,148,7846,6833,6981,47.16891891891892,5 6 7 8 10 12,-1
175,w0,100,904,3,149,0,COMPLETED_WALLTIME_REACHED,7845,149,7994,6941,7090,47.58389261744966,4 9 11,-1
168,w0,100,872,4,148,0,COMPLETED_WALLTIME_REACHED,7846,148,7994,6974,7122,48.12162162162162,5 6 7 8,-1
169,w0,100,877,4,151,0,COMPLETED_WALLTIME_REACHED,7849,151,8000,6972,7123,47.17218543046358,10 12 13 14,-1
172,w0,100,883,4,152,0,COMPLETED_WALLTIME_REACHED,7850,152,8002,6967,7119,46.83552631578947,0 1 2 3,-1
173,w0,100,887,5,147,0,COMPLETED_WALLTIME_REACHED,7994,147,8141,7107,7254,49.3469387755102,4 5 6 7 8,-1
907,w0,100,4597,2,148,0,COMPLETED_WALLTIME_REACHED,7994,148,8142,3397,3545,23.9527027027027,9 11,-1
176,w0,100,911,4,148,0,COMPLETED_WALLTIME_REACHED,8002,148,8150,7091,7239,48.91216216216216,0 1 2 3,-1
174,w0,100,902,5,149,0,COMPLETED_WALLTIME_REACHED,8005,149,8154,7103,7252,48.671140939597315,10 12 13 14 15,-1
177,w0,100,915,4,150,0,COMPLETED_WALLTIME_REACHED,8141,150,8291,7226,7376,49.17333333333333,4 5 6 7,-1
985,w0,100,4963,2,149,0,COMPLETED_WALLTIME_REACHED,8142,149,8291,3179,3328,22.335570469798657,8 9,-1
178,w0,100,915,5,146,0,COMPLETED_WALLTIME_REACHED,8150,146,8296,7235,7381,50.554794520547944,0 1 2 3 11,-1
179,w0,100,919,4,151,0,COMPLETED_WALLTIME_REACHED,8154,151,8305,7235,7386,48.913907284768214,10 12 13 14,-1
180,w0,100,919,5,151,0,COMPLETED_WALLTIME_REACHED,8291,151,8442,7372,7523,49.82119205298013,4 5 6 7 8,-1
181,w0,100,928,3,153,0,COMPLETED_WALLTIME_REACHED,8296,153,8449,7368,7521,49.15686274509804,0 1 2,-1
183,w0,100,930,3,150,0,COMPLETED_WALLTIME_REACHED,8296,150,8446,7366,7516,50.10666666666667,3 9 11,-1
182,w0,100,929,5,150,0,COMPLETED_WALLTIME_REACHED,8310,150,8460,7381,7531,50.20666666666666,10 12 13 14 15,-1
184,w0,100,931,4,148,0,COMPLETED_WALLTIME_REACHED,8442,148,8590,7511,7659,51.75,4 5 6 7,-1
185,w0,100,936,4,150,0,COMPLETED_WALLTIME_REACHED,8446,150,8596,7510,7660,51.06666666666667,3 8 9 11,-1
195,w0,100,992,3,152,0,COMPLETED_WALLTIME_REACHED,8449,152,8601,7457,7609,50.05921052631579,0 1 2,-1
186,w0,100,937,4,151,0,COMPLETED_WALLTIME_REACHED,8460,151,8611,7523,7674,50.82119205298013,10 12 13 14,-1
187,w0,100,945,4,149,0,COMPLETED_WALLTIME_REACHED,8590,149,8739,7645,7794,52.308724832214764,4 5 6 7,-1
188,w0,100,960,6,151,0,COMPLETED_WALLTIME_REACHED,8601,151,8752,7641,7792,51.602649006622514,0 1 2 3 8 9,-1
189,w0,100,962,5,149,0,COMPLETED_WALLTIME_REACHED,8611,149,8760,7649,7798,52.33557046979866,10 11 12 13 14,-1
190,w0,100,963,4,149,0,COMPLETED_WALLTIME_REACHED,8739,149,8888,7776,7925,53.18791946308725,4 5 6 7,-1
191,w0,100,968,5,151,0,COMPLETED_WALLTIME_REACHED,8752,151,8903,7784,7935,52.549668874172184,0 1 2 3 8,-1
192,w0,100,975,4,149,0,COMPLETED_WALLTIME_REACHED,8760,149,8909,7785,7934,53.24832214765101,9 10 11 12,-1
193,w0,100,976,5,147,0,COMPLETED_WALLTIME_REACHED,8893,147,9040,7917,8064,54.857142857142854,4 5 6 7 13,-1
194,w0,100,989,6,153,0,COMPLETED_WALLTIME_REACHED,8908,153,9061,7919,8072,52.75816993464052,0 1 2 3 8 14,-1
196,w0,100,1000,5,148,0,COMPLETED_WALLTIME_REACHED,8914,148,9062,7914,8062,54.472972972972975,9 10 11 12 15,-1
197,w0,100,1002,5,149,0,COMPLETED_WALLTIME_REACHED,9040,149,9189,8038,8187,54.946308724832214,4 5 6 7 13,-1
199,w0,100,1012,3,150,0,COMPLETED_WALLTIME_REACHED,9061,150,9211,8049,8199,54.66,0 1 2,-1
229,w0,100,1136,3,149,0,COMPLETED_WALLTIME_REACHED,9061,149,9210,7925,8074,54.18791946308725,3 8 14,-1
200,w0,100,1017,4,149,0,COMPLETED_WALLTIME_REACHED,9062,149,9211,8045,8194,54.993288590604024,9 10 11 12,-1
201,w0,100,1022,5,151,0,COMPLETED_WALLTIME_REACHED,9189,151,9340,8167,8318,55.086092715231786,4 5 6 7 13,-1
202,w0,100,1023,5,152,0,COMPLETED_WALLTIME_REACHED,9211,152,9363,8188,8340,54.86842105263158,0 1 2 9 10,-1
204,w0,100,1035,4,153,0,COMPLETED_WALLTIME_REACHED,9215,153,9368,8180,8333,54.4640522875817,3 8 14 15,-1
205,w0,100,1036,5,150,0,COMPLETED_WALLTIME_REACHED,9345,150,9495,8309,8459,56.39333333333333,4 5 6 7 11,-1
206,w0,100,1041,4,150,0,COMPLETED_WALLTIME_REACHED,9363,150,9513,8322,8472,56.48,0 1 2 9,-1
207,w0,100,1043,7,147,0,COMPLETED_WALLTIME_REACHED,9373,147,9520,8330,8477,57.666666666666664,3 8 10 12 13 14 15,-1
208,w0,100,1045,4,148,0,COMPLETED_WALLTIME_REACHED,9495,148,9643,8450,8598,58.0945945945946,4 5 6 7,-1
209,w0,100,1046,4,152,0,COMPLETED_WALLTIME_REACHED,9513,152,9665,8467,8619,56.703947368421055,0 1 2 9,-1
210,w0,100,1047,5,148,0,COMPLETED_WALLTIME_REACHED,9520,148,9668,8473,8621,58.25,3 8 10 11 12,-1
231,w0,100,1138,3,149,0,COMPLETED_WALLTIME_REACHED,9525,149,9674,8387,8536,57.288590604026844,13 14 15,-1
235,w0,100,1156,3,148,0,COMPLETED_WALLTIME_REACHED,9643,148,9791,8487,8635,58.3445945945946,4 5 6,-1
211,w0,100,1048,5,147,0,COMPLETED_WALLTIME_REACHED,9665,147,9812,8617,8764,59.61904761904762,0 1 2 7 9,-1
212,w0,100,1051,5,148,0,COMPLETED_WALLTIME_REACHED,9668,148,9816,8617,8765,59.222972972972975,3 8 10 11 12,-1
213,w0,100,1053,5,148,0,COMPLETED_WALLTIME_REACHED,9796,148,9944,8743,8891,60.07432432432432,4 5 6 13 14,-1
214,w0,100,1054,4,147,0,COMPLETED_WALLTIME_REACHED,9812,147,9959,8758,8905,60.57823129251701,0 1 2 7,-1
215,w0,100,1056,6,152,0,COMPLETED_WALLTIME_REACHED,9816,152,9968,8760,8912,58.63157894736842,3 8 9 10 11 12,-1
216,w0,100,1063,4,153,0,COMPLETED_WALLTIME_REACHED,9944,153,10097,8881,9034,59.04575163398693,4 5 6 13,-1
217,w0,100,1068,5,149,0,COMPLETED_WALLTIME_REACHED,9959,149,10108,8891,9040,60.671140939597315,0 1 2 7 14,-1
218,w0,100,1072,4,149,0,COMPLETED_WALLTIME_REACHED,9968,149,10117,8896,9045,60.70469798657718,3 8 9 10,-1
247,w0,100,1262,3,150,0,COMPLETED_WALLTIME_REACHED,9973,150,10123,8711,8861,59.07333333333333,11 12 15,-1
219,w0,100,1072,4,151,0,COMPLETED_WALLTIME_REACHED,10097,151,10248,9025,9176,60.7682119205298,4 5 6 13,-1
220,w0,100,1076,7,153,0,COMPLETED_WALLTIME_REACHED,10117,153,10270,9041,9194,60.091503267973856,0 1 2 3 7 8 9,-1
222,w0,100,1080,4,153,0,COMPLETED_WALLTIME_REACHED,10123,153,10276,9043,9196,60.10457516339869,10 11 12 14,-1
223,w0,100,1080,4,150,0,COMPLETED_WALLTIME_REACHED,10248,150,10398,9168,9318,62.12,4 5 6 13,-1
224,w0,100,1083,6,152,0,COMPLETED_WALLTIME_REACHED,10270,152,10422,9187,9339,61.44078947368421,0 1 2 3 7 8,-1
225,w0,100,1112,4,151,0,COMPLETED_WALLTIME_REACHED,10276,151,10427,9164,9315,61.688741721854306,9 10 11 12,-1
226,w0,100,1118,6,150,0,COMPLETED_WALLTIME_REACHED,10403,150,10553,9285,9435,62.9,4 5 6 13 14 15,-1
227,w0,100,1129,5,149,0,COMPLETED_WALLTIME_REACHED,10422,149,10571,9293,9442,63.369127516778526,0 1 2 3 7,-1
228,w0,100,1130,4,146,0,COMPLETED_WALLTIME_REACHED,10427,146,10573,9297,9443,64.67808219178082,8 9 10 11,-1
230,w0,100,1137,4,150,0,COMPLETED_WALLTIME_REACHED,10558,150,10708,9421,9571,63.806666666666665,4 5 6 12,-1
232,w0,100,1148,6,152,0,COMPLETED_WALLTIME_REACHED,10571,152,10723,9423,9575,62.99342105263158,0 1 2 3 7 13,-1
233,w0,100,1151,4,146,0,COMPLETED_WALLTIME_REACHED,10573,146,10719,9422,9568,65.53424657534246,8 9 10 11,-1
234,w0,100,1153,5,151,0,COMPLETED_WALLTIME_REACHED,10713,151,10864,9560,9711,64.3112582781457,4 5 6 12 14,-1
236,w0,100,1163,6,149,0,COMPLETED_WALLTIME_REACHED,10723,149,10872,9560,9709,65.16107382550335,0 1 2 3 7 13,-1
238,w0,100,1200,5,149,0,COMPLETED_WALLTIME_REACHED,10724,149,10873,9524,9673,64.91946308724832,8 9 10 11 15,-1
245,w0,100,1255,4,149,0,COMPLETED_WALLTIME_REACHED,10864,149,11013,9609,9758,65.48993288590604,4 5 6 12,-1
237,w0,100,1183,7,149,0,COMPLETED_WALLTIME_REACHED,10872,149,11021,9689,9838,66.02684563758389,0 1 2 3 7 13 14,-1
249,w0,100,1266,3,150,0,COMPLETED_WALLTIME_REACHED,10873,150,11023,9607,9757,65.04666666666667,8 9 10,-1
239,w0,100,1207,6,149,0,COMPLETED_WALLTIME_REACHED,11018,149,11167,9811,9960,66.84563758389261,4 5 6 11 12 15,-1
240,w0,100,1213,6,148,0,COMPLETED_WALLTIME_REACHED,11021,148,11169,9808,9956,67.27027027027027,0 1 2 3 7 13,-1
246,w0,100,1257,4,149,0,COMPLETED_WALLTIME_REACHED,11023,149,11172,9766,9915,66.54362416107382,8 9 10 14,-1
241,w0,100,1224,5,151,0,COMPLETED_WALLTIME_REACHED,11167,151,11318,9943,10094,66.8476821192053,4 5 6 11 12,-1
242,w0,100,1230,7,147,0,COMPLETED_WALLTIME_REACHED,11169,147,11316,9939,10086,68.61224489795919,0 1 2 3 7 13 15,-1
252,w0,100,1271,4,151,0,COMPLETED_WALLTIME_REACHED,11172,151,11323,9901,10052,66.56953642384106,8 9 10 14,-1
243,w0,100,1231,6,151,0,COMPLETED_WALLTIME_REACHED,11316,151,11467,10085,10236,67.78807947019868,0 1 2 3 7 13,-1
244,w0,100,1237,6,149,0,COMPLETED_WALLTIME_REACHED,11318,149,11467,10081,10230,68.65771812080537,4 5 6 11 12 15,-1
254,w0,100,1273,4,151,0,COMPLETED_WALLTIME_REACHED,11323,151,11474,10050,10201,67.55629139072848,8 9 10 14,-1
248,w0,100,1263,6,151,0,COMPLETED_WALLTIME_REACHED,11467,151,11618,10204,10355,68.57615894039735,0 1 2 3 4 5,-1
251,w0,100,1270,6,148,0,COMPLETED_WALLTIME_REACHED,11467,148,11615,10197,10345,69.89864864864865,6 7 11 12 13 15,-1
255,w0,100,1275,4,150,0,COMPLETED_WALLTIME_REACHED,11474,150,11624,10199,10349,68.99333333333334,8 9 10 14,-1
253,w0,100,1273,5,149,0,COMPLETED_WALLTIME_REACHED,11615,149,11764,10342,10491,70.40939597315436,6 7 11 12 13,-1
256,w0,100,1278,4,152,0,COMPLETED_WALLTIME_REACHED,11618,152,11770,10340,10492,69.02631578947368,0 1 2 3,-1
268,w0,100,1339,3,148,0,COMPLETED_WALLTIME_REACHED,11618,148,11766,10279,10427,70.45270270270271,4 5 15,-1
257,w0,100,1286,4,152,0,COMPLETED_WALLTIME_REACHED,11624,152,11776,10338,10490,69.01315789473684,8 9 10 14,-1
258,w0,100,1288,5,149,0,COMPLETED_WALLTIME_REACHED,11764,149,11913,10476,10625,71.30872483221476,6 7 11 12 13,-1
259,w0,100,1295,5,150,0,COMPLETED_WALLTIME_REACHED,11770,150,11920,10475,10625,70.83333333333333,0 1 2 3 4,-1
260,w0,100,1296,6,152,0,COMPLETED_WALLTIME_REACHED,11776,152,11928,10480,10632,69.94736842105263,5 8 9 10 14 15,-1
261,w0,100,1303,4,150,0,COMPLETED_WALLTIME_REACHED,11913,150,12063,10610,10760,71.73333333333333,6 7 11 12,-1
262,w0,100,1311,4,152,0,COMPLETED_WALLTIME_REACHED,11920,152,12072,10609,10761,70.79605263157895,0 1 2 3,-1
263,w0,100,1316,4,150,0,COMPLETED_WALLTIME_REACHED,11928,150,12078,10612,10762,71.74666666666667,4 5 8 9,-1
269,w0,100,1342,3,152,0,COMPLETED_WALLTIME_REACHED,11928,152,12080,10586,10738,70.64473684210526,10 13 14,-1
264,w0,100,1318,5,150,0,COMPLETED_WALLTIME_REACHED,12068,150,12218,10750,10900,72.66666666666667,6 7 11 12 15,-1
265,w0,100,1323,4,155,0,COMPLETED_WALLTIME_REACHED,12072,155,12227,10749,10904,70.34838709677419,0 1 2 3,-1
266,w0,100,1331,4,151,0,COMPLETED_WALLTIME_REACHED,12078,151,12229,10747,10898,72.17218543046357,4 5 8 9,-1
279,w0,100,1396,3,149,0,COMPLETED_WALLTIME_REACHED,12080,149,12229,10684,10833,72.70469798657719,10 13 14,-1
267,w0,100,1336,5,152,0,COMPLETED_WALLTIME_REACHED,12218,152,12370,10882,11034,72.59210526315789,6 7 11 12 15,-1
270,w0,100,1344,4,147,0,COMPLETED_WALLTIME_REACHED,12227,147,12374,10883,11030,75.03401360544218,0 1 2 3,-1
271,w0,100,1345,6,147,0,COMPLETED_WALLTIME_REACHED,12229,147,12376,10884,11031,75.04081632653062,4 5 8 9 10 13,-1
274,w0,100,1357,5,149,0,COMPLETED_WALLTIME_REACHED,12374,149,12523,11017,11166,74.93959731543625,0 1 2 3 15,-1
272,w0,100,1355,5,145,0,COMPLETED_WALLTIME_REACHED,12375,145,12520,11020,11165,77.0,6 7 11 12 14,-1
273,w0,100,1355,6,150,0,COMPLETED_WALLTIME_REACHED,12376,150,12526,11021,11171,74.47333333333333,4 5 8 9 10 13,-1
276,w0,100,1366,5,152,0,COMPLETED_WALLTIME_REACHED,12520,152,12672,11154,11306,74.38157894736842,6 7 11 12 14,-1
277,w0,100,1381,5,150,0,COMPLETED_WALLTIME_REACHED,12523,150,12673,11142,11292,75.28,0 1 2 3 15,-1
278,w0,100,1386,6,148,0,COMPLETED_WALLTIME_REACHED,12526,148,12674,11140,11288,76.27027027027027,4 5 8 9 10 13,-1
280,w0,100,1398,5,152,0,COMPLETED_WALLTIME_REACHED,12672,152,12824,11274,11426,75.17105263157895,6 7 11 12 14,-1
281,w0,100,1400,5,153,0,COMPLETED_WALLTIME_REACHED,12673,153,12826,11273,11426,74.6797385620915,0 1 2 3 15,-1
282,w0,100,1403,6,151,0,COMPLETED_WALLTIME_REACHED,12674,151,12825,11271,11422,75.64238410596026,4 5 8 9 10 13,-1
283,w0,100,1418,4,151,0,COMPLETED_WALLTIME_REACHED,12824,151,12975,11406,11557,76.5364238410596,6 7 11 12,-1
284,w0,100,1436,4,150,0,COMPLETED_WALLTIME_REACHED,12825,150,12975,11389,11539,76.92666666666666,4 5 8 9,-1
288,w0,100,1457,3,150,0,COMPLETED_WALLTIME_REACHED,12825,150,12975,11368,11518,76.78666666666666,10 13 14,-1
285,w0,100,1440,5,148,0,COMPLETED_WALLTIME_REACHED,12826,148,12974,11386,11534,77.93243243243244,0 1 2 3 15,-1
286,w0,100,1442,4,147,0,COMPLETED_WALLTIME_REACHED,12974,147,13121,11532,11679,79.44897959183673,0 1 2 3,-1
287,w0,100,1449,6,152,0,COMPLETED_WALLTIME_REACHED,12975,152,13127,11526,11678,76.82894736842105,4 5 6 7 8 9,-1
289,w0,100,1460,5,151,0,COMPLETED_WALLTIME_REACHED,12975,151,13126,11515,11666,77.25827814569537,10 11 12 13 14,-1
292,w0,100,1484,4,149,0,COMPLETED_WALLTIME_REACHED,13121,149,13270,11637,11786,79.1006711409396,0 1 2 3,-1
293,w0,100,1493,5,151,0,COMPLETED_WALLTIME_REACHED,13127,151,13278,11634,11785,78.04635761589404,4 5 6 7 8,-1
291,w0,100,1478,6,149,0,COMPLETED_WALLTIME_REACHED,13131,149,13280,11653,11802,79.20805369127517,10 11 12 13 14 15,-1
294,w0,100,1499,5,151,0,COMPLETED_WALLTIME_REACHED,13275,151,13426,11776,11927,78.98675496688742,0 1 2 3 9,-1
295,w0,100,1507,5,151,0,COMPLETED_WALLTIME_REACHED,13278,151,13429,11771,11922,78.95364238410596,4 5 6 7 8,-1
296,w0,100,1507,5,147,0,COMPLETED_WALLTIME_REACHED,13280,147,13427,11773,11920,81.08843537414965,10 11 12 13 14,-1
297,w0,100,1510,4,152,0,COMPLETED_WALLTIME_REACHED,13426,152,13578,11916,12068,79.39473684210526,0 1 2 3,-1
298,w0,100,1514,5,148,0,COMPLETED_WALLTIME_REACHED,13427,148,13575,11913,12061,81.49324324324324,9 10 11 12 13,-1
299,w0,100,1514,5,151,0,COMPLETED_WALLTIME_REACHED,13429,151,13580,11915,12066,79.90728476821192,4 5 6 7 8,-1
300,w0,100,1521,3,148,0,COMPLETED_WALLTIME_REACHED,13575,148,13723,12054,12202,82.44594594594595,9 10 11,-1
303,w0,100,1527,3,147,0,COMPLETED_WALLTIME_REACHED,13580,147,13727,12053,12200,82.99319727891157,12 13 14,-1
842,w0,100,4275,4,143,0,COMPLETED_WALLTIME_REACHED,13580,143,13723,9305,9448,66.06993006993007,4 5 6 7,-1
301,w0,100,1525,5,150,0,COMPLETED_WALLTIME_REACHED,13583,150,13733,12058,12208,81.38666666666667,0 1 2 3 15,-1
304,w0,100,1532,5,153,0,COMPLETED_WALLTIME_REACHED,13727,153,13880,12195,12348,80.70588235294117,10 11 12 13 14,-1
302,w0,100,1526,6,152,0,COMPLETED_WALLTIME_REACHED,13728,152,13880,12202,12354,81.27631578947368,4 5 6 7 8 9,-1
306,w0,100,1548,4,148,0,COMPLETED_WALLTIME_REACHED,13733,148,13881,12185,12333,83.33108108108108,0 1 2 3,-1
307,w0,100,1550,3,150,0,COMPLETED_WALLTIME_REACHED,13880,150,14030,12330,12480,83.2,4 5 6,-1
308,w0,100,1550,5,154,0,COMPLETED_WALLTIME_REACHED,13880,154,14034,12330,12484,81.06493506493507,7 8 9 10 11,-1
310,w0,100,1562,4,148,0,COMPLETED_WALLTIME_REACHED,13881,148,14029,12319,12467,84.23648648648648,0 1 2 3,-1
309,w0,100,1555,4,148,0,COMPLETED_WALLTIME_REACHED,13885,148,14033,12330,12478,84.3108108108108,12 13 14 15,-1
311,w0,100,1573,4,145,0,COMPLETED_WALLTIME_REACHED,14029,145,14174,12456,12601,86.90344827586208,0 1 2 3,-1
312,w0,100,1579,5,150,0,COMPLETED_WALLTIME_REACHED,14033,150,14183,12454,12604,84.02666666666667,4 5 6 12 13,-1
313,w0,100,1581,5,151,0,COMPLETED_WALLTIME_REACHED,14034,151,14185,12453,12604,83.47019867549669,7 8 9 10 11,-1
315,w0,100,1590,6,150,0,COMPLETED_WALLTIME_REACHED,14179,150,14329,12589,12739,84.92666666666666,0 1 2 3 14 15,-1
316,w0,100,1596,3,147,0,COMPLETED_WALLTIME_REACHED,14183,147,14330,12587,12734,86.62585034013605,4 5 6,-1
317,w0,100,1602,6,152,0,COMPLETED_WALLTIME_REACHED,14185,152,14337,12583,12735,83.78289473684211,7 8 9 10 11 12,-1
320,w0,100,1623,4,152,0,COMPLETED_WALLTIME_REACHED,14330,152,14482,12707,12859,84.59868421052632,4 5 6 15,-1
318,w0,100,1602,6,154,0,COMPLETED_WALLTIME_REACHED,14334,154,14488,12732,12886,83.67532467532467,0 1 2 3 13 14,-1
319,w0,100,1617,5,152,0,COMPLETED_WALLTIME_REACHED,14337,152,14489,12720,12872,84.6842105263158,7 8 9 10 11,-1
321,w0,100,1626,4,148,0,COMPLETED_WALLTIME_REACHED,14487,148,14635,12861,13009,87.89864864864865,4 5 6 12,-1
322,w0,100,1633,5,152,0,COMPLETED_WALLTIME_REACHED,14488,152,14640,12855,13007,85.57236842105263,0 1 2 3 13,-1
324,w0,100,1640,3,149,0,COMPLETED_WALLTIME_REACHED,14489,149,14638,12849,12998,87.23489932885906,7 8 9,-1
336,w0,100,1721,3,152,0,COMPLETED_WALLTIME_REACHED,14489,152,14641,12768,12920,85.0,10 11 14,-1
346,w0,100,1772,3,150,0,COMPLETED_WALLTIME_REACHED,14638,150,14788,12866,13016,86.77333333333333,7 8 9,-1
325,w0,100,1642,5,151,0,COMPLETED_WALLTIME_REACHED,14640,151,14791,12998,13149,87.0794701986755,4 5 6 12 15,-1
326,w0,100,1649,4,150,0,COMPLETED_WALLTIME_REACHED,14640,150,14790,12991,13141,87.60666666666667,0 1 2 3,-1
341,w0,100,1742,4,147,0,COMPLETED_WALLTIME_REACHED,14641,147,14788,12899,13046,88.74829931972789,10 11 13 14,-1
328,w0,100,1663,5,150,0,COMPLETED_WALLTIME_REACHED,14788,150,14938,13125,13275,88.5,7 8 9 10 11,-1
329,w0,100,1686,4,149,0,COMPLETED_WALLTIME_REACHED,14790,149,14939,13104,13253,88.94630872483222,0 1 2 3,-1
330,w0,100,1700,4,153,0,COMPLETED_WALLTIME_REACHED,14791,153,14944,13091,13244,86.56209150326798,4 5 6 12,-1
363,w0,100,1853,3,147,0,COMPLETED_WALLTIME_REACHED,14791,147,14938,12938,13085,89.01360544217687,13 14 15,-1
331,w0,100,1701,6,152,0,COMPLETED_WALLTIME_REACHED,14938,152,15090,13237,13389,88.08552631578948,7 8 9 10 11 13,-1
332,w0,100,1707,4,148,0,COMPLETED_WALLTIME_REACHED,14939,148,15087,13232,13380,90.4054054054054,0 1 2 3,-1
333,w0,100,1709,4,148,0,COMPLETED_WALLTIME_REACHED,14944,148,15092,13235,13383,90.42567567567568,4 5 6 12,-1
335,w0,100,1720,4,149,0,COMPLETED_WALLTIME_REACHED,15090,149,15239,13370,13519,90.73154362416108,7 8 9 10,-1
334,w0,100,1716,5,148,0,COMPLETED_WALLTIME_REACHED,15092,148,15240,13376,13524,91.37837837837837,0 1 2 3 14,-1
337,w0,100,1734,5,153,0,COMPLETED_WALLTIME_REACHED,15092,153,15245,13358,13511,88.30718954248366,4 5 6 11 12,-1
339,w0,100,1737,5,149,0,COMPLETED_WALLTIME_REACHED,15240,149,15389,13503,13652,91.6241610738255,0 1 2 3 14,-1
338,w0,100,1737,5,150,0,COMPLETED_WALLTIME_REACHED,15244,150,15394,13507,13657,91.04666666666667,7 8 9 10 13,-1
340,w0,100,1739,4,149,0,COMPLETED_WALLTIME_REACHED,15245,149,15394,13506,13655,91.64429530201342,4 5 6 11,-1
342,w0,100,1744,7,147,0,COMPLETED_WALLTIME_REACHED,15394,147,15541,13650,13797,93.85714285714286,0 1 2 3 12 14 15,-1
343,w0,100,1744,4,152,0,COMPLETED_WALLTIME_REACHED,15394,152,15546,13650,13802,90.80263157894737,4 5 6 7,-1
344,w0,100,1747,4,150,0,COMPLETED_WALLTIME_REACHED,15394,150,15544,13647,13797,91.98,8 9 10 11,-1
345,w0,100,1767,5,148,0,COMPLETED_WALLTIME_REACHED,15541,148,15689,13774,13922,94.06756756756756,0 1 2 3 12,-1
348,w0,100,1780,3,150,0,COMPLETED_WALLTIME_REACHED,15546,150,15696,13766,13916,92.77333333333333,4 5 6,-1
347,w0,100,1777,6,149,0,COMPLETED_WALLTIME_REACHED,15549,149,15698,13772,13921,93.42953020134229,8 9 10 11 13 14,-1
349,w0,100,1783,4,153,0,COMPLETED_WALLTIME_REACHED,15689,153,15842,13906,14059,91.88888888888889,0 1 2 3,-1
351,w0,100,1785,3,151,0,COMPLETED_WALLTIME_REACHED,15698,151,15849,13913,14064,93.13907284768212,8 9 10,-1
352,w0,100,1788,4,152,0,COMPLETED_WALLTIME_REACHED,15698,152,15850,13910,14062,92.51315789473684,11 12 13 14,-1
350,w0,100,1784,4,149,0,COMPLETED_WALLTIME_REACHED,15701,149,15850,13917,14066,94.40268456375838,4 5 6 7,-1
353,w0,100,1791,5,150,0,COMPLETED_WALLTIME_REACHED,15847,150,15997,14056,14206,94.70666666666666,0 1 2 3 15,-1
357,w0,100,1827,3,149,0,COMPLETED_WALLTIME_REACHED,15849,149,15998,14022,14171,95.10738255033557,8 9 10,-1
354,w0,100,1817,7,151,0,COMPLETED_WALLTIME_REACHED,15850,151,16001,14033,14184,93.93377483443709,4 5 6 7 11 12 13,-1
366,w0,100,1868,3,151,0,COMPLETED_WALLTIME_REACHED,15998,151,16149,14130,14281,94.57615894039735,8 9 10,-1
356,w0,100,1819,6,152,0,COMPLETED_WALLTIME_REACHED,16001,152,16153,14182,14334,94.30263157894737,4 5 6 7 11 12,-1
355,w0,100,1817,6,147,0,COMPLETED_WALLTIME_REACHED,16002,147,16149,14185,14332,97.49659863945578,0 1 2 3 14 15,-1
358,w0,100,1827,4,151,0,COMPLETED_WALLTIME_REACHED,16149,151,16300,14322,14473,95.8476821192053,0 1 2 3,-1
360,w0,100,1833,4,151,0,COMPLETED_WALLTIME_REACHED,16153,151,16304,14320,14471,95.83443708609272,4 5 6 7,-1
359,w0,100,1830,6,152,0,COMPLETED_WALLTIME_REACHED,16154,152,16306,14324,14476,95.23684210526316,8 9 10 13 14 15,-1
361,w0,100,1843,5,149,0,COMPLETED_WALLTIME_REACHED,16305,149,16454,14462,14611,98.06040268456375,0 1 2 3 11,-1
364,w0,100,1860,6,147,0,COMPLETED_WALLTIME_REACHED,16306,147,16453,14446,14593,99.27210884353741,8 9 10 13 14 15,-1
362,w0,100,1846,5,151,0,COMPLETED_WALLTIME_REACHED,16309,151,16460,14463,14614,96.78145695364239,4 5 6 7 12,-1
365,w0,100,1864,4,152,0,COMPLETED_WALLTIME_REACHED,16453,152,16605,14589,14741,96.98026315789474,8 9 10 13,-1
367,w0,100,1870,5,151,0,COMPLETED_WALLTIME_REACHED,16454,151,16605,14584,14735,97.58278145695364,0 1 2 3 11,-1
368,w0,100,1877,4,150,0,COMPLETED_WALLTIME_REACHED,16460,150,16610,14583,14733,98.22,4 5 6 7,-1
375,w0,100,1924,3,149,0,COMPLETED_WALLTIME_REACHED,16460,149,16609,14536,14685,98.55704697986577,12 14 15,-1
369,w0,100,1879,5,151,0,COMPLETED_WALLTIME_REACHED,16605,151,16756,14726,14877,98.52317880794702,0 1 2 3 8,-1
370,w0,100,1885,4,153,0,COMPLETED_WALLTIME_REACHED,16605,153,16758,14720,14873,97.20915032679738,9 10 11 13,-1
389,w0,100,1999,3,148,0,COMPLETED_WALLTIME_REACHED,16609,148,16757,14610,14758,99.71621621621621,12 14 15,-1
371,w0,100,1891,4,151,0,COMPLETED_WALLTIME_REACHED,16610,151,16761,14719,14870,98.47682119205298,4 5 6 7,-1
372,w0,100,1891,5,148,0,COMPLETED_WALLTIME_REACHED,16756,148,16904,14865,15013,101.4391891891892,0 1 2 3 8,-1
374,w0,100,1918,5,150,0,COMPLETED_WALLTIME_REACHED,16758,150,16908,14840,14990,99.93333333333334,9 10 11 12 13,-1
376,w0,100,1924,4,152,0,COMPLETED_WALLTIME_REACHED,16761,152,16913,14837,14989,98.61184210526316,4 5 6 7,-1
378,w0,100,1933,4,148,0,COMPLETED_WALLTIME_REACHED,16908,148,17056,14975,15123,102.18243243243244,9 10 11 12,-1
377,w0,100,1932,6,149,0,COMPLETED_WALLTIME_REACHED,16909,149,17058,14977,15126,101.51677852348993,0 1 2 3 8 14,-1
379,w0,100,1939,5,150,0,COMPLETED_WALLTIME_REACHED,16913,150,17063,14974,15124,100.82666666666667,4 5 6 7 13,-1
380,w0,100,1943,4,151,0,COMPLETED_WALLTIME_REACHED,17056,151,17207,15113,15264,101.08609271523179,9 10 11 12,-1
381,w0,100,1950,5,149,0,COMPLETED_WALLTIME_REACHED,17058,149,17207,15108,15257,102.39597315436242,0 1 2 3 8,-1
382,w0,100,1951,4,151,0,COMPLETED_WALLTIME_REACHED,17063,151,17214,15112,15263,101.0794701986755,4 5 6 7,-1
394,w0,100,2025,3,151,0,COMPLETED_WALLTIME_REACHED,17068,151,17219,15043,15194,100.62251655629139,13 14 15,-1
383,w0,100,1961,5,147,0,COMPLETED_WALLTIME_REACHED,17207,147,17354,15246,15393,104.71428571428571,0 1 2 3 8,-1
400,w0,100,2083,3,150,0,COMPLETED_WALLTIME_REACHED,17207,150,17357,15124,15274,101.82666666666667,9 10 11,-1
384,w0,100,1962,5,149,0,COMPLETED_WALLTIME_REACHED,17214,149,17363,15252,15401,103.36241610738254,4 5 6 7 12,-1
385,w0,100,1969,6,149,0,COMPLETED_WALLTIME_REACHED,17359,149,17508,15390,15539,104.28859060402685,0 1 2 3 8 13,-1
388,w0,100,1999,4,149,0,COMPLETED_WALLTIME_REACHED,17362,149,17511,15363,15512,104.10738255033557,9 10 11 14,-1
386,w0,100,1973,6,152,0,COMPLETED_WALLTIME_REACHED,17368,152,17520,15395,15547,102.28289473684211,4 5 6 7 12 15,-1
387,w0,100,1988,5,149,0,COMPLETED_WALLTIME_REACHED,17508,149,17657,15520,15669,105.16107382550335,0 1 2 3 8,-1
390,w0,100,2000,4,150,0,COMPLETED_WALLTIME_REACHED,17511,150,17661,15511,15661,104.40666666666667,9 10 11 13,-1
391,w0,100,2004,4,151,0,COMPLETED_WALLTIME_REACHED,17520,151,17671,15516,15667,103.75496688741723,4 5 6 7,-1
402,w0,100,2091,3,149,0,COMPLETED_WALLTIME_REACHED,17520,149,17669,15429,15578,104.5503355704698,12 14 15,-1
393,w0,100,2023,5,152,0,COMPLETED_WALLTIME_REACHED,17657,152,17809,15634,15786,103.85526315789474,0 1 2 3 8,-1
396,w0,100,2039,5,148,0,COMPLETED_WALLTIME_REACHED,17669,148,17817,15630,15778,106.60810810810811,9 10 11 12 13,-1
397,w0,100,2063,5,150,0,COMPLETED_WALLTIME_REACHED,17671,150,17821,15608,15758,105.05333333333333,4 5 6 7 14,-1
398,w0,100,2071,4,153,0,COMPLETED_WALLTIME_REACHED,17809,153,17962,15738,15891,103.86274509803921,0 1 2 3,-1
399,w0,100,2077,5,151,0,COMPLETED_WALLTIME_REACHED,17817,151,17968,15740,15891,105.23841059602648,8 9 10 11 12,-1
401,w0,100,2085,4,147,0,COMPLETED_WALLTIME_REACHED,17821,147,17968,15736,15883,108.04761904761905,4 5 6 7,-1
410,w0,100,2138,3,153,0,COMPLETED_WALLTIME_REACHED,17826,153,17979,15688,15841,103.5359477124183,13 14 15,-1
403,w0,100,2094,4,153,0,COMPLETED_WALLTIME_REACHED,17962,153,18115,15868,16021,104.7124183006536,0 1 2 3,-1
404,w0,100,2102,4,151,0,COMPLETED_WALLTIME_REACHED,17968,151,18119,15866,16017,106.0728476821192,4 5 6 7,-1
405,w0,100,2106,6,151,0,COMPLETED_WALLTIME_REACHED,17979,151,18130,15873,16024,106.11920529801324,8 9 10 11 12 13,-1
406,w0,100,2110,4,152,0,COMPLETED_WALLTIME_REACHED,18115,152,18267,16005,16157,106.29605263157895,0 1 2 3,-1
407,w0,100,2119,6,150,0,COMPLETED_WALLTIME_REACHED,18124,150,18274,16005,16155,107.7,4 5 6 7 14 15,-1
408,w0,100,2131,4,149,0,COMPLETED_WALLTIME_REACHED,18130,149,18279,15999,16148,108.3758389261745,8 9 10 11,-1
409,w0,100,2137,5,151,0,COMPLETED_WALLTIME_REACHED,18272,151,18423,16135,16286,107.8543046357616,0 1 2 3 12,-1
411,w0,100,2141,3,149,0,COMPLETED_WALLTIME_REACHED,18274,149,18423,16133,16282,109.2751677852349,4 5 6,-1
412,w0,100,2143,4,151,0,COMPLETED_WALLTIME_REACHED,18279,151,18430,16136,16287,107.86092715231788,7 13 14 15,-1
413,w0,100,2148,4,154,0,COMPLETED_WALLTIME_REACHED,18279,154,18433,16131,16285,105.74675324675324,8 9 10 11,-1
414,w0,100,2157,3,149,0,COMPLETED_WALLTIME_REACHED,18423,149,18572,16266,16415,110.16778523489933,0 1 2,-1
415,w0,100,2158,5,153,0,COMPLETED_WALLTIME_REACHED,18423,153,18576,16265,16418,107.30718954248366,3 4 5 6 12,-1
421,w0,100,2183,3,150,0,COMPLETED_WALLTIME_REACHED,18430,150,18580,16247,16397,109.31333333333333,7 13 14,-1
416,w0,100,2166,5,150,0,COMPLETED_WALLTIME_REACHED,18433,150,18583,16267,16417,109.44666666666667,8 9 10 11 15,-1
422,w0,100,2186,3,149,0,COMPLETED_WALLTIME_REACHED,18572,149,18721,16386,16535,110.97315436241611,0 1 2,-1
417,w0,100,2167,4,153,0,COMPLETED_WALLTIME_REACHED,18576,153,18729,16409,16562,108.2483660130719,3 4 5 6,-1
423,w0,100,2191,4,150,0,COMPLETED_WALLTIME_REACHED,18580,150,18730,16389,16539,110.26,7 12 13 14,-1
418,w0,100,2167,5,152,0,COMPLETED_WALLTIME_REACHED,18583,152,18735,16416,16568,109.0,8 9 10 11 15,-1
419,w0,100,2174,7,150,0,COMPLETED_WALLTIME_REACHED,18729,150,18879,16555,16705,111.36666666666666,0 1 2 3 4 5 6,-1
424,w0,100,2201,3,149,0,COMPLETED_WALLTIME_REACHED,18730,149,18879,16529,16678,111.93288590604027,7 12 13,-1
425,w0,100,2213,4,149,0,COMPLETED_WALLTIME_REACHED,18735,149,18884,16522,16671,111.88590604026845,8 9 10 11,-1
426,w0,100,2213,4,146,0,COMPLETED_WALLTIME_REACHED,18879,146,19025,16666,16812,115.15068493150685,0 1 2 3,-1
427,w0,100,2215,4,150,0,COMPLETED_WALLTIME_REACHED,18879,150,19029,16664,16814,112.09333333333333,4 5 6 7,-1
428,w0,100,2217,3,148,0,COMPLETED_WALLTIME_REACHED,18884,148,19032,16667,16815,113.61486486486487,12 13 14,-1
429,w0,100,2218,4,149,0,COMPLETED_WALLTIME_REACHED,18884,149,19033,16666,16815,112.85234899328859,8 9 10 11,-1
430,w0,100,2222,5,151,0,COMPLETED_WALLTIME_REACHED,19030,151,19181,16808,16959,112.3112582781457,0 1 2 3 15,-1
431,w0,100,2223,5,153,0,COMPLETED_WALLTIME_REACHED,19032,153,19185,16809,16962,110.86274509803921,4 5 6 7 12,-1
432,w0,100,2224,4,152,0,COMPLETED_WALLTIME_REACHED,19033,152,19185,16809,16961,111.58552631578948,8 9 10 11,-1
433,w0,100,2235,4,153,0,COMPLETED_WALLTIME_REACHED,19181,153,19334,16946,17099,111.75816993464052,0 1 2 3,-1
434,w0,100,2248,5,148,0,COMPLETED_WALLTIME_REACHED,19185,148,19333,16937,17085,115.4391891891892,4 5 6 7 8,-1
437,w0,100,2260,4,150,0,COMPLETED_WALLTIME_REACHED,19185,150,19335,16925,17075,113.83333333333333,9 10 11 12,-1
441,w0,100,2282,3,150,0,COMPLETED_WALLTIME_REACHED,19186,150,19336,16904,17054,113.69333333333333,13 14 15,-1
435,w0,100,2256,5,153,0,COMPLETED_WALLTIME_REACHED,19333,153,19486,17077,17230,112.61437908496733,4 5 6 7 8,-1
444,w0,100,2309,3,146,0,COMPLETED_WALLTIME_REACHED,19334,146,19480,17025,17171,117.60958904109589,0 1 2,-1
436,w0,100,2257,5,151,0,COMPLETED_WALLTIME_REACHED,19335,151,19486,17078,17229,114.09933774834437,3 9 10 11 12,-1
438,w0,100,2262,4,150,0,COMPLETED_WALLTIME_REACHED,19485,150,19635,17223,17373,115.82,0 1 2 13,-1
439,w0,100,2267,5,151,0,COMPLETED_WALLTIME_REACHED,19486,151,19637,17219,17370,115.03311258278146,3 4 5 6 7,-1
440,w0,100,2269,4,151,0,COMPLETED_WALLTIME_REACHED,19486,151,19637,17217,17368,115.01986754966887,8 9 10 11,-1
485,w0,100,2545,3,148,0,COMPLETED_WALLTIME_REACHED,19491,148,19639,16946,17094,115.5,12 14 15,-1
443,w0,100,2307,4,149,0,COMPLETED_WALLTIME_REACHED,19635,149,19784,17328,17477,117.29530201342281,0 1 2 13,-1
442,w0,100,2294,6,153,0,COMPLETED_WALLTIME_REACHED,19637,153,19790,17343,17496,114.3529411764706,3 4 5 6 7 8,-1
445,w0,100,2313,5,152,0,COMPLETED_WALLTIME_REACHED,19639,152,19791,17326,17478,114.98684210526316,9 10 11 12 14,-1
446,w0,100,2321,4,153,0,COMPLETED_WALLTIME_REACHED,19784,153,19937,17463,17616,115.13725490196079,0 1 2 13,-1
447,w0,100,2325,4,150,0,COMPLETED_WALLTIME_REACHED,19790,150,19940,17465,17615,117.43333333333334,3 4 5 6,-1
448,w0,100,2332,6,148,0,COMPLETED_WALLTIME_REACHED,19791,148,19939,17459,17607,118.96621621621621,7 8 9 10 11 12,-1
450,w0,100,2349,5,148,0,COMPLETED_WALLTIME_REACHED,19939,148,20087,17590,17738,119.85135135135135,7 8 9 10 11,-1
451,w0,100,2357,5,150,0,COMPLETED_WALLTIME_REACHED,19940,150,20090,17583,17733,118.22,3 4 5 6 12,-1
449,w0,100,2343,5,152,0,COMPLETED_WALLTIME_REACHED,19942,152,20094,17599,17751,116.78289473684211,0 1 2 13 14,-1
452,w0,100,2358,5,152,0,COMPLETED_WALLTIME_REACHED,20087,152,20239,17729,17881,117.63815789473684,7 8 9 10 11,-1
453,w0,100,2359,4,147,0,COMPLETED_WALLTIME_REACHED,20090,147,20237,17731,17878,121.61904761904762,3 4 5 6,-1
454,w0,100,2361,5,148,0,COMPLETED_WALLTIME_REACHED,20094,148,20242,17733,17881,120.81756756756756,0 1 2 12 13,-1
456,w0,100,2368,5,152,0,COMPLETED_WALLTIME_REACHED,20239,152,20391,17871,18023,118.57236842105263,7 8 9 10 11,-1
455,w0,100,2366,6,151,0,COMPLETED_WALLTIME_REACHED,20242,151,20393,17876,18027,119.3841059602649,3 4 5 6 14 15,-1
457,w0,100,2369,5,148,0,COMPLETED_WALLTIME_REACHED,20242,148,20390,17873,18021,121.76351351351352,0 1 2 12 13,-1
458,w0,100,2373,4,152,0,COMPLETED_WALLTIME_REACHED,20390,152,20542,18017,18169,119.53289473684211,0 1 2 12,-1
459,w0,100,2381,4,156,0,COMPLETED_WALLTIME_REACHED,20391,156,20547,18010,18166,116.44871794871794,7 8 9 10,-1
460,w0,100,2383,4,153,0,COMPLETED_WALLTIME_REACHED,20393,153,20546,18010,18163,118.7124183006536,3 4 5 6,-1
467,w0,100,2423,4,146,0,COMPLETED_WALLTIME_REACHED,20393,146,20539,17970,18116,124.08219178082192,11 13 14 15,-1
469,w0,100,2466,3,150,0,COMPLETED_WALLTIME_REACHED,20539,150,20689,18073,18223,121.48666666666666,11 13 14,-1
461,w0,100,2387,5,148,0,COMPLETED_WALLTIME_REACHED,20542,148,20690,18155,18303,123.66891891891892,0 1 2 12 15,-1
462,w0,100,2388,4,152,0,COMPLETED_WALLTIME_REACHED,20546,152,20698,18158,18310,120.46052631578948,3 4 5 6,-1
465,w0,100,2411,6,148,0,COMPLETED_WALLTIME_REACHED,20690,148,20838,18279,18427,124.50675675675676,0 1 2 12 13 14,-1
463,w0,100,2406,5,148,0,COMPLETED_WALLTIME_REACHED,20694,148,20842,18288,18436,124.56756756756756,7 8 9 10 11,-1
466,w0,100,2421,5,153,0,COMPLETED_WALLTIME_REACHED,20698,153,20851,18277,18430,120.45751633986929,3 4 5 6 15,-1
468,w0,100,2465,5,150,0,COMPLETED_WALLTIME_REACHED,20838,150,20988,18373,18523,123.48666666666666,0 1 2 12 13,-1
470,w0,100,2469,5,148,0,COMPLETED_WALLTIME_REACHED,20842,148,20990,18373,18521,125.14189189189189,7 8 9 10 11,-1
471,w0,100,2471,5,151,0,COMPLETED_WALLTIME_REACHED,20851,151,21002,18380,18531,122.72185430463576,3 4 5 6 14,-1
472,w0,100,2472,4,150,0,COMPLETED_WALLTIME_REACHED,20988,150,21138,18516,18666,124.44,0 1 2 12,-1
473,w0,100,2482,5,147,0,COMPLETED_WALLTIME_REACHED,20990,147,21137,18508,18655,126.9047619047619,7 8 9 10 11,-1
474,w0,100,2485,6,151,0,COMPLETED_WALLTIME_REACHED,21002,151,21153,18517,18668,123.62913907284768,3 4 5 6 13 14,-1
475,w0,100,2487,4,150,0,COMPLETED_WALLTIME_REACHED,21137,150,21287,18650,18800,125.33333333333333,7 8 9 10,-1
478,w0,100,2495,4,151,0,COMPLETED_WALLTIME_REACHED,21138,151,21289,18643,18794,124.4635761589404,0 1 2 11,-1
476,w0,100,2488,7,149,0,COMPLETED_WALLTIME_REACHED,21153,149,21302,18665,18814,126.26845637583892,3 4 5 6 12 13 14,-1
488,w0,100,2566,3,150,0,COMPLETED_WALLTIME_REACHED,21287,150,21437,18721,18871,125.80666666666667,7 8 9,-1
477,w0,100,2488,6,150,0,COMPLETED_WALLTIME_REACHED,21294,150,21444,18806,18956,126.37333333333333,0 1 2 10 11 15,-1
479,w0,100,2507,4,148,0,COMPLETED_WALLTIME_REACHED,21302,148,21450,18795,18943,127.99324324324324,3 4 5 6,-1
480,w0,100,2519,4,152,0,COMPLETED_WALLTIME_REACHED,21442,152,21594,18923,19075,125.49342105263158,7 8 9 12,-1
481,w0,100,2523,6,151,0,COMPLETED_WALLTIME_REACHED,21449,151,21600,18926,19077,126.33774834437087,0 1 2 10 11 13,-1
482,w0,100,2523,5,148,0,COMPLETED_WALLTIME_REACHED,21455,148,21603,18932,19080,128.9189189189189,3 4 5 6 14,-1
483,w0,100,2529,5,148,0,COMPLETED_WALLTIME_REACHED,21599,148,21747,19070,19218,129.85135135135135,7 8 9 12 15,-1
484,w0,100,2534,6,151,0,COMPLETED_WALLTIME_REACHED,21600,151,21751,19066,19217,127.26490066225166,0 1 2 10 11 13,-1
486,w0,100,2554,5,150,0,COMPLETED_WALLTIME_REACHED,21603,150,21753,19049,19199,127.99333333333334,3 4 5 6 14,-1
487,w0,100,2558,5,150,0,COMPLETED_WALLTIME_REACHED,21747,150,21897,19189,19339,128.92666666666668,7 8 9 12 15,-1
489,w0,100,2567,3,149,0,COMPLETED_WALLTIME_REACHED,21751,149,21900,19184,19333,129.751677852349,0 1 2,-1
498,w0,100,2600,3,152,0,COMPLETED_WALLTIME_REACHED,21751,152,21903,19151,19303,126.99342105263158,10 11 13,-1
490,w0,100,2569,4,148,0,COMPLETED_WALLTIME_REACHED,21753,148,21901,19184,19332,130.6216216216216,3 4 5 6,-1
501,w0,100,2628,3,152,0,COMPLETED_WALLTIME_REACHED,21900,152,22052,19272,19424,127.78947368421052,0 1 2,-1
492,w0,100,2581,5,151,0,COMPLETED_WALLTIME_REACHED,21901,151,22052,19320,19471,128.94701986754967,3 4 5 6 15,-1
491,w0,100,2577,5,148,0,COMPLETED_WALLTIME_REACHED,21902,148,22050,19325,19473,131.57432432432432,7 8 9 12 14,-1
510,w0,100,2655,3,149,0,COMPLETED_WALLTIME_REACHED,21903,149,22052,19248,19397,130.18120805369128,10 11 13,-1
493,w0,100,2581,5,150,0,COMPLETED_WALLTIME_REACHED,22050,150,22200,19469,19619,130.79333333333332,7 8 9 12 14,-1
495,w0,100,2584,5,149,0,COMPLETED_WALLTIME_REACHED,22052,149,22201,19468,19617,131.65771812080536,0 1 2 3 4,-1
496,w0,100,2593,5,152,0,COMPLETED_WALLTIME_REACHED,22052,152,22204,19459,19611,129.01973684210526,5 6 10 11 13,-1
503,w0,100,2631,4,151,0,COMPLETED_WALLTIME_REACHED,22201,151,22352,19570,19721,130.60264900662253,0 1 2 3,-1
499,w0,100,2612,6,150,0,COMPLETED_WALLTIME_REACHED,22204,150,22354,19592,19742,131.61333333333334,4 5 6 10 11 13,-1
497,w0,100,2596,6,150,0,COMPLETED_WALLTIME_REACHED,22205,150,22355,19609,19759,131.72666666666666,7 8 9 12 14 15,-1
504,w0,100,2631,4,151,0,COMPLETED_WALLTIME_REACHED,22352,151,22503,19721,19872,131.60264900662253,0 1 2 3,-1
500,w0,100,2617,6,150,0,COMPLETED_WALLTIME_REACHED,22354,150,22504,19737,19887,132.58,4 5 6 10 11 13,-1
502,w0,100,2629,5,151,0,COMPLETED_WALLTIME_REACHED,22355,151,22506,19726,19877,131.63576158940398,7 8 9 12 14,-1
506,w0,100,2636,5,147,0,COMPLETED_WALLTIME_REACHED,22504,147,22651,19868,20015,136.156462585034,4 5 6 10 11,-1
507,w0,100,2643,5,149,0,COMPLETED_WALLTIME_REACHED,22506,149,22655,19863,20012,134.30872483221478,7 8 9 12 13,-1
505,w0,100,2633,5,149,0,COMPLETED_WALLTIME_REACHED,22508,149,22657,19875,20024,134.38926174496643,0 1 2 3 15,-1
508,w0,100,2651,4,150,0,COMPLETED_WALLTIME_REACHED,22651,150,22801,20000,20150,134.33333333333334,4 5 6 10,-1
509,w0,100,2655,5,151,0,COMPLETED_WALLTIME_REACHED,22655,151,22806,20000,20151,133.4503311258278,7 8 9 11 12,-1
511,w0,100,2662,4,154,0,COMPLETED_WALLTIME_REACHED,22657,154,22811,19995,20149,130.83766233766235,0 1 2 3,-1
512,w0,100,2665,5,151,0,COMPLETED_WALLTIME_REACHED,22806,151,22957,20141,20292,134.3841059602649,4 5 6 10 13,-1
513,w0,100,2669,3,151,0,COMPLETED_WALLTIME_REACHED,22806,151,22957,20137,20288,134.35761589403972,7 8 9,-1
514,w0,100,2672,3,148,0,COMPLETED_WALLTIME_REACHED,22811,148,22959,20139,20287,137.07432432432432,11 12 14,-1
516,w0,100,2694,4,150,0,COMPLETED_WALLTIME_REACHED,22811,150,22961,20117,20267,135.11333333333334,0 1 2 3,-1
515,w0,100,2677,6,150,0,COMPLETED_WALLTIME_REACHED,22957,150,23107,20280,20430,136.2,4 5 6 7 8 9,-1
518,w0,100,2700,4,151,0,COMPLETED_WALLTIME_REACHED,22961,151,23112,20261,20412,135.17880794701986,0 1 2 3,-1
517,w0,100,2694,6,149,0,COMPLETED_WALLTIME_REACHED,22964,149,23113,20270,20419,137.04026845637583,10 11 12 13 14 15,-1
519,w0,100,2713,4,152,0,COMPLETED_WALLTIME_REACHED,23107,152,23259,20394,20546,135.17105263157896,4 5 6 7,-1
520,w0,100,2715,4,150,0,COMPLETED_WALLTIME_REACHED,23112,150,23262,20397,20547,136.98,0 1 2 3,-1
521,w0,100,2719,7,150,0,COMPLETED_WALLTIME_REACHED,23113,150,23263,20394,20544,136.96,8 9 10 11 12 13 14,-1
522,w0,100,2724,4,147,0,COMPLETED_WALLTIME_REACHED,23259,147,23406,20535,20682,140.69387755102042,4 5 6 7,-1
523,w0,100,2733,3,149,0,COMPLETED_WALLTIME_REACHED,23262,149,23411,20529,20678,138.7785234899329,0 1 2,-1
524,w0,100,2739,5,149,0,COMPLETED_WALLTIME_REACHED,23263,149,23412,20524,20673,138.74496644295303,3 8 9 10 11,-1
525,w0,100,2753,3,148,0,COMPLETED_WALLTIME_REACHED,23263,148,23411,20510,20658,139.5810810810811,12 13 14,-1
526,w0,100,2755,4,148,0,COMPLETED_WALLTIME_REACHED,23406,148,23554,20651,20799,140.53378378378378,4 5 6 7,-1
527,w0,100,2758,3,152,0,COMPLETED_WALLTIME_REACHED,23411,152,23563,20653,20805,136.875,0 1 2,-1
528,w0,100,2763,5,149,0,COMPLETED_WALLTIME_REACHED,23412,149,23561,20649,20798,139.58389261744966,3 8 9 10 11,-1
531,w0,100,2781,4,152,0,COMPLETED_WALLTIME_REACHED,23416,152,23568,20635,20787,136.7565789473684,12 13 14 15,-1
533,w0,100,2794,3,149,0,COMPLETED_WALLTIME_REACHED,23554,149,23703,20760,20909,140.3288590604027,4 5 6,-1
529,w0,100,2767,5,152,0,COMPLETED_WALLTIME_REACHED,23561,152,23713,20794,20946,137.80263157894737,3 7 8 9 10,-1
546,w0,100,2909,3,150,0,COMPLETED_WALLTIME_REACHED,23563,150,23713,20654,20804,138.69333333333333,0 1 2,-1
530,w0,100,2771,5,148,0,COMPLETED_WALLTIME_REACHED,23568,148,23716,20797,20945,141.52027027027026,11 12 13 14 15,-1
547,w0,100,2910,3,148,0,COMPLETED_WALLTIME_REACHED,23703,148,23851,20793,20941,141.49324324324326,4 5 6,-1
534,w0,100,2806,6,145,0,COMPLETED_WALLTIME_REACHED,23713,145,23858,20907,21052,145.18620689655174,0 1 2 3 7 8,-1
535,w0,100,2813,8,149,0,COMPLETED_WALLTIME_REACHED,23856,149,24005,21043,21192,142.2281879194631,4 5 6 9 10 11 12 13,-1
536,w0,100,2834,7,149,0,COMPLETED_WALLTIME_REACHED,23863,149,24012,21029,21178,142.13422818791946,0 1 2 3 7 8 14,-1
537,w0,100,2841,4,148,0,COMPLETED_WALLTIME_REACHED,24005,148,24153,21164,21312,144.0,4 5 6 9,-1
538,w0,100,2848,4,150,0,COMPLETED_WALLTIME_REACHED,24005,150,24155,21157,21307,142.04666666666665,10 11 12 13,-1
540,w0,100,2861,5,150,0,COMPLETED_WALLTIME_REACHED,24012,150,24162,21151,21301,142.00666666666666,0 1 2 3 7,-1
541,w0,100,2866,5,148,0,COMPLETED_WALLTIME_REACHED,24158,148,24306,21292,21440,144.86486486486487,4 5 6 8 9,-1
542,w0,100,2869,6,149,0,COMPLETED_WALLTIME_REACHED,24160,149,24309,21291,21440,143.89261744966444,10 11 12 13 14 15,-1
543,w0,100,2873,4,149,0,COMPLETED_WALLTIME_REACHED,24162,149,24311,21289,21438,143.8791946308725,0 1 2 3,-1
545,w0,100,2885,4,151,0,COMPLETED_WALLTIME_REACHED,24309,151,24460,21424,21575,142.88079470198676,8 9 10 11,-1
554,w0,100,2933,3,148,0,COMPLETED_WALLTIME_REACHED,24309,148,24457,21376,21524,145.43243243243242,12 13 14,-1
544,w0,100,2878,4,154,0,COMPLETED_WALLTIME_REACHED,24311,154,24465,21433,21587,140.17532467532467,4 5 6 7,-1
548,w0,100,2914,5,152,0,COMPLETED_WALLTIME_REACHED,24311,152,24463,21397,21549,141.76973684210526,0 1 2 3 15,-1
549,w0,100,2922,5,145,0,COMPLETED_WALLTIME_REACHED,24460,145,24605,21538,21683,149.53793103448277,8 9 10 11 12,-1
550,w0,100,2923,5,152,0,COMPLETED_WALLTIME_REACHED,24463,152,24615,21540,21692,142.71052631578948,0 1 2 3 13,-1
551,w0,100,2925,5,151,0,COMPLETED_WALLTIME_REACHED,24465,151,24616,21540,21691,143.64900662251657,4 5 6 7 14,-1
552,w0,100,2931,4,149,0,COMPLETED_WALLTIME_REACHED,24605,149,24754,21674,21823,146.46308724832215,8 9 10 11,-1
553,w0,100,2933,4,149,0,COMPLETED_WALLTIME_REACHED,24615,149,24764,21682,21831,146.51677852348993,0 1 2 3,-1
555,w0,100,2938,4,150,0,COMPLETED_WALLTIME_REACHED,24616,150,24766,21678,21828,145.52,4 5 6 7,-1
556,w0,100,2945,3,152,0,COMPLETED_WALLTIME_REACHED,24620,152,24772,21675,21827,143.59868421052633,12 13 15,-1
558,w0,100,2958,3,150,0,COMPLETED_WALLTIME_REACHED,24754,150,24904,21796,21946,146.30666666666667,8 9 10,-1
557,w0,100,2953,6,150,0,COMPLETED_WALLTIME_REACHED,24769,150,24919,21816,21966,146.44,0 1 2 3 11 14,-1
559,w0,100,2966,6,150,0,COMPLETED_WALLTIME_REACHED,24772,150,24922,21806,21956,146.37333333333333,4 5 6 7 12 13,-1
561,w0,100,2970,4,151,0,COMPLETED_WALLTIME_REACHED,24909,151,25060,21939,22090,146.2913907284768,8 9 10 15,-1
562,w0,100,2973,4,148,0,COMPLETED_WALLTIME_REACHED,24919,148,25067,21946,22094,149.28378378378378,0 1 2 3,-1
563,w0,100,2974,5,152,0,COMPLETED_WALLTIME_REACHED,24922,152,25074,21948,22100,145.39473684210526,4 5 6 7 11,-1
578,w0,100,3016,3,152,0,COMPLETED_WALLTIME_REACHED,24922,152,25074,21906,22058,145.1184210526316,12 13 14,-1
564,w0,100,2975,4,150,0,COMPLETED_WALLTIME_REACHED,25060,150,25210,22085,22235,148.23333333333332,8 9 10 15,-1
565,w0,100,2978,4,149,0,COMPLETED_WALLTIME_REACHED,25067,149,25216,22089,22238,149.248322147651,0 1 2 3,-1
566,w0,100,2984,5,150,0,COMPLETED_WALLTIME_REACHED,25074,150,25224,22090,22240,148.26666666666668,4 5 6 7 11,-1
567,w0,100,2991,5,151,0,COMPLETED_WALLTIME_REACHED,25215,151,25366,22224,22375,148.17880794701986,8 9 10 12 13,-1
568,w0,100,2992,5,151,0,COMPLETED_WALLTIME_REACHED,25221,151,25372,22229,22380,148.21192052980132,0 1 2 3 14,-1
569,w0,100,2993,6,148,0,COMPLETED_WALLTIME_REACHED,25224,148,25372,22231,22379,151.20945945945945,4 5 6 7 11 15,-1
570,w0,100,2995,5,147,0,COMPLETED_WALLTIME_REACHED,25366,147,25513,22371,22518,153.18367346938774,8 9 10 12 13,-1
571,w0,100,2998,5,151,0,COMPLETED_WALLTIME_REACHED,25372,151,25523,22374,22525,149.17218543046357,0 1 2 3 4,-1
572,w0,100,3009,5,154,0,COMPLETED_WALLTIME_REACHED,25372,154,25526,22363,22517,146.21428571428572,5 6 7 11 14,-1
573,w0,100,3009,4,155,0,COMPLETED_WALLTIME_REACHED,25513,155,25668,22504,22659,146.18709677419355,8 9 10 12,-1
574,w0,100,3009,4,152,0,COMPLETED_WALLTIME_REACHED,25523,152,25675,22514,22666,149.1184210526316,0 1 2 3,-1
575,w0,100,3011,5,149,0,COMPLETED_WALLTIME_REACHED,25526,149,25675,22515,22664,152.10738255033556,5 6 7 11 14,-1
583,w0,100,3028,3,150,0,COMPLETED_WALLTIME_REACHED,25528,150,25678,22500,22650,151.0,4 13 15,-1
576,w0,100,3013,4,150,0,COMPLETED_WALLTIME_REACHED,25668,150,25818,22655,22805,152.03333333333333,8 9 10 12,-1
577,w0,100,3015,5,150,0,COMPLETED_WALLTIME_REACHED,25675,150,25825,22660,22810,152.06666666666666,0 1 2 3 5,-1
579,w0,100,3019,7,150,0,COMPLETED_WALLTIME_REACHED,25678,150,25828,22659,22809,152.06,4 6 7 11 13 14 15,-1
596,w0,100,3120,3,148,0,COMPLETED_WALLTIME_REACHED,25818,148,25966,22698,22846,154.36486486486487,8 9 10,-1
580,w0,100,3020,6,155,0,COMPLETED_WALLTIME_REACHED,25825,155,25980,22805,22960,148.1290322580645,0 1 2 3 5 12,-1
581,w0,100,3023,5,152,0,COMPLETED_WALLTIME_REACHED,25828,152,25980,22805,22957,151.0328947368421,4 6 7 11 13,-1
582,w0,100,3023,5,150,0,COMPLETED_WALLTIME_REACHED,25971,150,26121,22948,23098,153.98666666666668,8 9 10 14 15,-1
584,w0,100,3040,6,150,0,COMPLETED_WALLTIME_REACHED,25980,150,26130,22940,23090,153.93333333333334,0 1 2 3 4 5,-1
585,w0,100,3041,4,154,0,COMPLETED_WALLTIME_REACHED,25980,154,26134,22939,23093,149.95454545454547,6 7 11 12,-1
586,w0,100,3044,4,152,0,COMPLETED_WALLTIME_REACHED,26126,152,26278,23082,23234,152.85526315789474,8 9 10 13,-1
587,w0,100,3053,6,153,0,COMPLETED_WALLTIME_REACHED,26130,153,26283,23077,23230,151.83006535947712,0 1 2 3 4 5,-1
588,w0,100,3055,5,151,0,COMPLETED_WALLTIME_REACHED,26134,151,26285,23079,23230,153.841059602649,6 7 11 12 14,-1
589,w0,100,3065,4,151,0,COMPLETED_WALLTIME_REACHED,26278,151,26429,23213,23364,154.72847682119206,8 9 10 13,-1
590,w0,100,3067,5,146,0,COMPLETED_WALLTIME_REACHED,26283,146,26429,23216,23362,160.013698630137,0 1 2 3 4,-1
591,w0,100,3067,5,149,0,COMPLETED_WALLTIME_REACHED,26285,149,26434,23218,23367,156.8255033557047,5 6 7 11 12,-1
592,w0,100,3086,5,152,0,COMPLETED_WALLTIME_REACHED,26429,152,26581,23343,23495,154.57236842105263,0 1 2 3 4,-1
593,w0,100,3099,6,149,0,COMPLETED_WALLTIME_REACHED,26434,149,26583,23335,23484,157.61073825503357,8 9 10 13 14 15,-1
597,w0,100,3134,3,147,0,COMPLETED_WALLTIME_REACHED,26434,147,26581,23300,23447,159.50340136054422,5 6 7,-1
595,w0,100,3114,6,152,0,COMPLETED_WALLTIME_REACHED,26581,152,26733,23467,23619,155.38815789473685,0 1 2 3 4 5,-1
598,w0,100,3145,5,148,0,COMPLETED_WALLTIME_REACHED,26583,148,26731,23438,23586,159.36486486486487,8 9 10 13 14,-1
604,w0,100,3204,4,149,0,COMPLETED_WALLTIME_REACHED,26586,149,26735,23382,23531,157.9261744966443,6 7 11 12,-1
599,w0,100,3162,5,149,0,COMPLETED_WALLTIME_REACHED,26731,149,26880,23569,23718,159.18120805369128,8 9 10 13 14,-1
600,w0,100,3163,5,152,0,COMPLETED_WALLTIME_REACHED,26733,152,26885,23570,23722,156.06578947368422,0 1 2 3 4,-1
601,w0,100,3188,5,150,0,COMPLETED_WALLTIME_REACHED,26735,150,26885,23547,23697,157.98,5 6 7 11 12,-1
602,w0,100,3200,5,149,0,COMPLETED_WALLTIME_REACHED,26880,149,27029,23680,23829,159.9261744966443,8 9 10 13 14,-1
603,w0,100,3203,6,152,0,COMPLETED_WALLTIME_REACHED,26885,152,27037,23682,23834,156.80263157894737,0 1 2 3 4 5,-1
605,w0,100,3204,4,149,0,COMPLETED_WALLTIME_REACHED,26885,149,27034,23681,23830,159.93288590604027,6 7 11 12,-1
606,w0,100,3207,4,146,0,COMPLETED_WALLTIME_REACHED,27029,146,27175,23822,23968,164.16438356164383,8 9 10 13,-1
607,w0,100,3217,4,151,0,COMPLETED_WALLTIME_REACHED,27034,151,27185,23817,23968,158.72847682119206,6 7 11 12,-1
608,w0,100,3223,5,150,0,COMPLETED_WALLTIME_REACHED,27037,150,27187,23814,23964,159.76,0 1 2 3 4,-1
609,w0,100,3224,5,146,0,COMPLETED_WALLTIME_REACHED,27180,146,27326,23956,24102,165.08219178082192,5 8 9 10 13,-1
610,w0,100,3225,4,148,0,COMPLETED_WALLTIME_REACHED,27185,148,27333,23960,24108,162.8918918918919,6 7 11 12,-1
611,w0,100,3229,5,148,0,COMPLETED_WALLTIME_REACHED,27187,148,27335,23958,24106,162.8783783783784,0 1 2 3 4,-1
612,w0,100,3234,4,151,0,COMPLETED_WALLTIME_REACHED,27326,151,27477,24092,24243,160.5496688741722,5 8 9 10,-1
613,w0,100,3252,3,149,0,COMPLETED_WALLTIME_REACHED,27331,149,27480,24079,24228,162.60402684563758,13 14 15,-1
614,w0,100,3255,3,153,0,COMPLETED_WALLTIME_REACHED,27333,153,27486,24078,24231,158.37254901960785,6 7 11,-1
615,w0,100,3258,4,152,0,COMPLETED_WALLTIME_REACHED,27335,152,27487,24077,24229,159.40131578947367,0 1 2 3,-1
616,w0,100,3265,5,150,0,COMPLETED_WALLTIME_REACHED,27482,150,27632,24217,24367,162.44666666666666,4 5 8 9 10,-1
618,w0,100,3269,3,148,0,COMPLETED_WALLTIME_REACHED,27487,148,27635,24218,24366,164.63513513513513,0 1 2,-1
617,w0,100,3266,7,151,0,COMPLETED_WALLTIME_REACHED,27491,151,27642,24225,24376,161.43046357615893,6 7 11 12 13 14 15,-1
619,w0,100,3276,7,151,0,COMPLETED_WALLTIME_REACHED,27640,151,27791,24364,24515,162.35099337748343,0 1 2 3 4 5 8,-1
620,w0,100,3284,6,152,0,COMPLETED_WALLTIME_REACHED,27642,152,27794,24358,24510,161.25,6 7 9 10 11 12,-1
627,w0,100,3340,3,148,0,COMPLETED_WALLTIME_REACHED,27642,148,27790,24302,24450,165.2027027027027,13 14 15,-1
630,w0,100,3348,3,151,0,COMPLETED_WALLTIME_REACHED,27790,151,27941,24442,24593,162.86754966887418,13 14 15,-1
621,w0,100,3295,6,148,0,COMPLETED_WALLTIME_REACHED,27791,148,27939,24496,24644,166.51351351351352,0 1 2 3 4 5,-1
622,w0,100,3295,6,151,0,COMPLETED_WALLTIME_REACHED,27794,151,27945,24499,24650,163.24503311258277,6 7 8 9 10 11,-1
623,w0,100,3308,4,149,0,COMPLETED_WALLTIME_REACHED,27939,149,28088,24631,24780,166.30872483221478,0 1 2 3,-1
625,w0,100,3333,4,151,0,COMPLETED_WALLTIME_REACHED,27945,151,28096,24612,24763,163.9933774834437,6 7 8 9,-1
631,w0,100,3350,3,147,0,COMPLETED_WALLTIME_REACHED,27945,147,28092,24595,24742,168.31292517006804,10 11 15,-1
624,w0,100,3328,5,153,0,COMPLETED_WALLTIME_REACHED,27946,153,28099,24618,24771,161.90196078431373,4 5 12 13 14,-1
626,w0,100,3334,4,148,0,COMPLETED_WALLTIME_REACHED,28088,148,28236,24754,24902,168.25675675675674,0 1 2 3,-1
628,w0,100,3344,5,151,0,COMPLETED_WALLTIME_REACHED,28096,151,28247,24752,24903,164.9205298013245,6 7 8 9 10,-1
629,w0,100,3346,5,149,0,COMPLETED_WALLTIME_REACHED,28099,149,28248,24753,24902,167.1275167785235,4 5 11 12 13,-1
632,w0,100,3357,5,149,0,COMPLETED_WALLTIME_REACHED,28241,149,28390,24884,25033,168.00671140939596,0 1 2 3 14,-1
633,w0,100,3358,5,152,0,COMPLETED_WALLTIME_REACHED,28247,152,28399,24889,25041,164.7434210526316,6 7 8 9 10,-1
634,w0,100,3358,4,146,0,COMPLETED_WALLTIME_REACHED,28248,146,28394,24890,25036,171.4794520547945,4 5 11 12,-1
635,w0,100,3366,3,148,0,COMPLETED_WALLTIME_REACHED,28390,148,28538,25024,25172,170.0810810810811,0 1 2,-1
638,w0,100,3376,3,153,0,COMPLETED_WALLTIME_REACHED,28394,153,28547,25018,25171,164.51633986928104,4 5 11,-1
636,w0,100,3369,4,150,0,COMPLETED_WALLTIME_REACHED,28395,150,28545,25026,25176,167.84,3 13 14 15,-1
637,w0,100,3372,5,149,0,COMPLETED_WALLTIME_REACHED,28399,149,28548,25027,25176,168.96644295302013,6 7 8 9 10,-1
639,w0,100,3376,4,150,0,COMPLETED_WALLTIME_REACHED,28543,150,28693,25167,25317,168.78,0 1 2 12,-1
640,w0,100,3380,3,150,0,COMPLETED_WALLTIME_REACHED,28545,150,28695,25165,25315,168.76666666666668,3 13 14,-1
642,w0,100,3403,3,146,0,COMPLETED_WALLTIME_REACHED,28547,146,28693,25144,25290,173.21917808219177,4 5 11,-1
641,w0,100,3387,5,148,0,COMPLETED_WALLTIME_REACHED,28548,148,28696,25161,25309,171.00675675675674,6 7 8 9 10,-1
643,w0,100,3406,3,149,0,COMPLETED_WALLTIME_REACHED,28693,149,28842,25287,25436,170.71140939597316,0 1 2,-1
644,w0,100,3408,3,153,0,COMPLETED_WALLTIME_REACHED,28693,153,28846,25285,25438,166.26143790849673,4 5 11,-1
646,w0,100,3417,4,152,0,COMPLETED_WALLTIME_REACHED,28695,152,28847,25278,25430,167.30263157894737,3 12 13 14,-1
645,w0,100,3410,6,151,0,COMPLETED_WALLTIME_REACHED,28701,151,28852,25291,25442,168.49006622516555,6 7 8 9 10 15,-1
647,w0,100,3421,5,147,0,COMPLETED_WALLTIME_REACHED,28846,147,28993,25425,25572,173.9591836734694,0 1 2 4 5,-1
648,w0,100,3422,5,148,0,COMPLETED_WALLTIME_REACHED,28847,148,28995,25425,25573,172.79054054054055,3 11 12 13 14,-1
649,w0,100,3422,4,148,0,COMPLETED_WALLTIME_REACHED,28852,148,29000,25430,25578,172.82432432432432,6 7 8 9,-1
650,w0,100,3422,4,147,0,COMPLETED_WALLTIME_REACHED,28993,147,29140,25571,25718,174.95238095238096,0 1 2 4,-1
651,w0,100,3425,5,149,0,COMPLETED_WALLTIME_REACHED,28995,149,29144,25570,25719,172.61073825503357,3 11 12 13 14,-1
652,w0,100,3426,3,149,0,COMPLETED_WALLTIME_REACHED,28998,149,29147,25572,25721,172.6241610738255,5 10 15,-1
659,w0,100,3453,3,150,0,COMPLETED_WALLTIME_REACHED,29000,150,29150,25547,25697,171.31333333333333,6 7 8,-1
653,w0,100,3433,5,151,0,COMPLETED_WALLTIME_REACHED,29145,151,29296,25712,25863,171.27814569536423,0 1 2 4 9,-1
654,w0,100,3434,6,148,0,COMPLETED_WALLTIME_REACHED,29147,148,29295,25713,25861,174.73648648648648,3 5 10 11 12 13,-1
655,w0,100,3440,4,149,0,COMPLETED_WALLTIME_REACHED,29150,149,29299,25710,25859,173.5503355704698,6 7 8 14,-1
656,w0,100,3447,4,148,0,COMPLETED_WALLTIME_REACHED,29295,148,29443,25848,25996,175.64864864864865,3 5 10 11,-1
657,w0,100,3448,5,152,0,COMPLETED_WALLTIME_REACHED,29296,152,29448,25848,26000,171.05263157894737,0 1 2 4 9,-1
658,w0,100,3451,4,152,0,COMPLETED_WALLTIME_REACHED,29299,152,29451,25848,26000,171.05263157894737,6 7 8 14,-1
662,w0,100,3463,3,148,0,COMPLETED_WALLTIME_REACHED,29300,148,29448,25837,25985,175.57432432432432,12 13 15,-1
661,w0,100,3462,4,147,0,COMPLETED_WALLTIME_REACHED,29443,147,29590,25981,26128,177.74149659863946,3 5 10 11,-1
660,w0,100,3457,6,150,0,COMPLETED_WALLTIME_REACHED,29448,150,29598,25991,26141,174.27333333333334,0 1 2 4 9 12,-1
663,w0,100,3467,3,149,0,COMPLETED_WALLTIME_REACHED,29451,149,29600,25984,26133,175.38926174496643,6 7 8,-1
664,w0,100,3480,5,149,0,COMPLETED_WALLTIME_REACHED,29595,149,29744,26115,26264,176.26845637583892,3 5 10 11 13,-1
665,w0,100,3482,4,149,0,COMPLETED_WALLTIME_REACHED,29598,149,29747,26116,26265,176.2751677852349,0 1 2 4,-1
666,w0,100,3488,5,150,0,COMPLETED_WALLTIME_REACHED,29600,150,29750,26112,26262,175.08,6 7 8 9 12,-1
667,w0,100,3489,4,149,0,COMPLETED_WALLTIME_REACHED,29744,149,29893,26255,26404,177.20805369127515,3 5 10 11,-1
668,w0,100,3490,4,151,0,COMPLETED_WALLTIME_REACHED,29747,151,29898,26257,26408,174.88741721854305,0 1 2 4,-1
691,w0,100,3600,3,152,0,COMPLETED_WALLTIME_REACHED,29749,152,29901,26149,26301,173.0328947368421,13 14 15,-1
706,w0,100,3669,3,152,0,COMPLETED_WALLTIME_REACHED,29750,152,29902,26081,26233,172.58552631578948,6 7 8,-1
669,w0,100,3496,6,151,0,COMPLETED_WALLTIME_REACHED,29898,151,30049,26402,26553,175.8476821192053,3 5 9 10 11 12,-1
670,w0,100,3499,4,151,0,COMPLETED_WALLTIME_REACHED,29898,151,30049,26399,26550,175.82781456953643,0 1 2 4,-1
671,w0,100,3500,6,151,0,COMPLETED_WALLTIME_REACHED,29902,151,30053,26402,26553,175.8476821192053,6 7 8 13 14 15,-1
672,w0,100,3500,5,150,0,COMPLETED_WALLTIME_REACHED,30049,150,30199,26549,26699,177.99333333333334,0 1 2 3 4,-1
673,w0,100,3507,5,155,0,COMPLETED_WALLTIME_REACHED,30049,155,30204,26542,26697,172.23870967741937,5 9 10 11 12,-1
674,w0,100,3509,6,154,0,COMPLETED_WALLTIME_REACHED,30053,154,30207,26544,26698,173.36363636363637,6 7 8 13 14 15,-1
675,w0,100,3512,5,152,0,COMPLETED_WALLTIME_REACHED,30199,152,30351,26687,26839,176.57236842105263,0 1 2 3 4,-1
676,w0,100,3516,5,150,0,COMPLETED_WALLTIME_REACHED,30204,150,30354,26688,26838,178.92,5 9 10 11 12,-1
677,w0,100,3523,6,149,0,COMPLETED_WALLTIME_REACHED,30207,149,30356,26684,26833,180.08724832214764,6 7 8 13 14 15,-1
678,w0,100,3525,4,152,0,COMPLETED_WALLTIME_REACHED,30351,152,30503,26826,26978,177.48684210526315,0 1 2 3,-1
679,w0,100,3529,5,149,0,COMPLETED_WALLTIME_REACHED,30354,149,30503,26825,26974,181.03355704697987,4 5 9 10 11,-1
680,w0,100,3530,4,151,0,COMPLETED_WALLTIME_REACHED,30356,151,30507,26826,26977,178.65562913907286,6 7 8 12,-1
710,w0,100,3684,3,148,0,COMPLETED_WALLTIME_REACHED,30356,148,30504,26672,26820,181.21621621621622,13 14 15,-1
681,w0,100,3534,4,150,0,COMPLETED_WALLTIME_REACHED,30503,150,30653,26969,27119,180.79333333333332,0 1 2 3,-1
682,w0,100,3534,4,149,0,COMPLETED_WALLTIME_REACHED,30503,149,30652,26969,27118,182.0,4 5 9 10,-1
724,w0,100,3718,3,150,0,COMPLETED_WALLTIME_REACHED,30504,150,30654,26786,26936,179.57333333333332,11 13 14,-1
683,w0,100,3549,5,150,0,COMPLETED_WALLTIME_REACHED,30507,150,30657,26958,27108,180.72,6 7 8 12 15,-1
684,w0,100,3549,4,146,0,COMPLETED_WALLTIME_REACHED,30652,146,30798,27103,27249,186.63698630136986,4 5 9 10,-1
685,w0,100,3552,4,149,0,COMPLETED_WALLTIME_REACHED,30653,149,30802,27101,27250,182.88590604026845,0 1 2 3,-1
730,w0,100,3747,3,148,0,COMPLETED_WALLTIME_REACHED,30654,148,30802,26907,27055,182.80405405405406,11 13 14,-1
686,w0,100,3553,5,148,0,COMPLETED_WALLTIME_REACHED,30657,148,30805,27104,27252,184.13513513513513,6 7 8 12 15,-1
688,w0,100,3559,4,153,0,COMPLETED_WALLTIME_REACHED,30798,153,30951,27239,27392,179.03267973856208,4 5 9 10,-1
687,w0,100,3554,5,151,0,COMPLETED_WALLTIME_REACHED,30802,151,30953,27248,27399,181.4503311258278,0 1 2 3 11,-1
689,w0,100,3581,5,151,0,COMPLETED_WALLTIME_REACHED,30805,151,30956,27224,27375,181.2913907284768,6 7 8 12 13,-1
692,w0,100,3603,4,150,0,COMPLETED_WALLTIME_REACHED,30951,150,31101,27348,27498,183.32,4 5 9 10,-1
693,w0,100,3608,4,148,0,COMPLETED_WALLTIME_REACHED,30956,148,31104,27348,27496,185.78378378378378,6 7 8 12,-1
690,w0,100,3595,7,150,0,COMPLETED_WALLTIME_REACHED,30958,150,31108,27363,27513,183.42,0 1 2 3 11 14 15,-1
696,w0,100,3615,4,148,0,COMPLETED_WALLTIME_REACHED,31104,148,31252,27489,27637,186.73648648648648,6 7 8 12,-1
694,w0,100,3610,5,149,0,COMPLETED_WALLTIME_REACHED,31106,149,31255,27496,27645,185.53691275167785,4 5 9 10 13,-1
695,w0,100,3612,5,148,0,COMPLETED_WALLTIME_REACHED,31108,148,31256,27496,27644,186.78378378378378,0 1 2 3 11,-1
697,w0,100,3620,4,151,0,COMPLETED_WALLTIME_REACHED,31252,151,31403,27632,27783,183.9933774834437,6 7 8 12,-1
698,w0,100,3620,4,153,0,COMPLETED_WALLTIME_REACHED,31255,153,31408,27635,27788,181.62091503267973,4 5 9 10,-1
699,w0,100,3630,5,151,0,COMPLETED_WALLTIME_REACHED,31256,151,31407,27626,27777,183.95364238410596,0 1 2 3 11,-1
742,w0,100,3819,3,147,0,COMPLETED_WALLTIME_REACHED,31260,147,31407,27441,27588,187.6734693877551,13 14 15,-1
700,w0,100,3637,4,151,0,COMPLETED_WALLTIME_REACHED,31403,151,31554,27766,27917,184.88079470198676,6 7 8 12,-1
701,w0,100,3639,5,154,0,COMPLETED_WALLTIME_REACHED,31407,154,31561,27768,27922,181.3116883116883,0 1 2 3 11,-1
747,w0,100,3830,3,148,0,COMPLETED_WALLTIME_REACHED,31407,148,31555,27577,27725,187.3310810810811,13 14 15,-1
702,w0,100,3639,4,152,0,COMPLETED_WALLTIME_REACHED,31408,152,31560,27769,27921,183.69078947368422,4 5 9 10,-1
703,w0,100,3645,6,145,0,COMPLETED_WALLTIME_REACHED,31555,145,31700,27910,28055,193.48275862068965,6 7 8 12 13 14,-1
704,w0,100,3647,5,148,0,COMPLETED_WALLTIME_REACHED,31560,148,31708,27913,28061,189.60135135135135,4 5 9 10 15,-1
705,w0,100,3654,5,151,0,COMPLETED_WALLTIME_REACHED,31561,151,31712,27907,28058,185.81456953642385,0 1 2 3 11,-1
707,w0,100,3670,4,151,0,COMPLETED_WALLTIME_REACHED,31700,151,31851,28030,28181,186.6291390728477,6 7 8 12,-1
708,w0,100,3675,4,146,0,COMPLETED_WALLTIME_REACHED,31708,146,31854,28033,28179,193.0068493150685,4 5 9 10,-1
709,w0,100,3681,6,148,0,COMPLETED_WALLTIME_REACHED,31712,148,31860,28031,28179,190.39864864864865,0 1 2 3 11 13,-1
719,w0,100,3705,4,150,0,COMPLETED_WALLTIME_REACHED,31854,150,32004,28149,28299,188.66,4 5 9 10,-1
711,w0,100,3686,6,149,0,COMPLETED_WALLTIME_REACHED,31856,149,32005,28170,28319,190.06040268456377,6 7 8 12 14 15,-1
712,w0,100,3689,5,150,0,COMPLETED_WALLTIME_REACHED,31860,150,32010,28171,28321,188.80666666666667,0 1 2 3 11,-1
713,w0,100,3691,6,151,0,COMPLETED_WALLTIME_REACHED,32005,151,32156,28314,28465,188.50993377483445,6 7 8 12 14 15,-1
714,w0,100,3695,5,151,0,COMPLETED_WALLTIME_REACHED,32009,151,32160,28314,28465,188.50993377483445,4 5 9 10 13,-1
715,w0,100,3701,5,149,0,COMPLETED_WALLTIME_REACHED,32010,149,32159,28309,28458,190.99328859060404,0 1 2 3 11,-1
716,w0,100,3702,6,151,0,COMPLETED_WALLTIME_REACHED,32156,151,32307,28454,28605,189.43708609271522,6 7 8 12 14 15,-1
717,w0,100,3703,5,149,0,COMPLETED_WALLTIME_REACHED,32159,149,32308,28456,28605,191.9798657718121,0 1 2 3 11,-1
718,w0,100,3705,5,149,0,COMPLETED_WALLTIME_REACHED,32160,149,32309,28455,28604,191.9731543624161,4 5 9 10 13,-1
720,w0,100,3708,4,151,0,COMPLETED_WALLTIME_REACHED,32307,151,32458,28599,28750,190.39735099337747,6 7 8 12,-1
721,w0,100,3708,5,154,0,COMPLETED_WALLTIME_REACHED,32308,154,32462,28600,28754,186.71428571428572,0 1 2 3 11,-1
722,w0,100,3714,4,150,0,COMPLETED_WALLTIME_REACHED,32309,150,32459,28595,28745,191.63333333333333,4 5 9 10,-1
769,w0,100,3933,3,149,0,COMPLETED_WALLTIME_REACHED,32309,149,32458,28376,28525,191.44295302013424,13 14 15,-1
723,w0,100,3714,7,153,0,COMPLETED_WALLTIME_REACHED,32458,153,32611,28744,28897,188.86928104575162,6 7 8 12 13 14 15,-1
725,w0,100,3732,4,149,0,COMPLETED_WALLTIME_REACHED,32459,149,32608,28727,28876,193.7986577181208,4 5 9 10,-1
726,w0,100,3735,4,151,0,COMPLETED_WALLTIME_REACHED,32462,151,32613,28727,28878,191.24503311258277,0 1 2 3,-1
728,w0,100,3746,6,151,0,COMPLETED_WALLTIME_REACHED,32611,151,32762,28865,29016,192.158940397351,6 7 8 12 13 14,-1
727,w0,100,3742,5,149,0,COMPLETED_WALLTIME_REACHED,32613,149,32762,28871,29020,194.76510067114094,4 5 9 10 11,-1
731,w0,100,3753,5,150,0,COMPLETED_WALLTIME_REACHED,32613,150,32763,28860,29010,193.4,0 1 2 3 15,-1
729,w0,100,3746,7,147,0,COMPLETED_WALLTIME_REACHED,32762,147,32909,29016,29163,198.3877551020408,4 5 6 7 8 9 10,-1
732,w0,100,3754,4,149,0,COMPLETED_WALLTIME_REACHED,32762,149,32911,29008,29157,195.68456375838926,11 12 13 14,-1
733,w0,100,3758,5,148,0,COMPLETED_WALLTIME_REACHED,32763,148,32911,29005,29153,196.97972972972974,0 1 2 3 15,-1
734,w0,100,3761,4,149,0,COMPLETED_WALLTIME_REACHED,32909,149,33058,29148,29297,196.6241610738255,4 5 6 7,-1
749,w0,100,3840,3,152,0,COMPLETED_WALLTIME_REACHED,32909,152,33061,29069,29221,192.2434210526316,8 9 10,-1
735,w0,100,3769,5,150,0,COMPLETED_WALLTIME_REACHED,32911,150,33061,29142,29292,195.28,0 1 2 3 11,-1
767,w0,100,3928,4,147,0,COMPLETED_WALLTIME_REACHED,32911,147,33058,28983,29130,198.16326530612244,12 13 14 15,-1
736,w0,100,3777,6,150,0,COMPLETED_WALLTIME_REACHED,33058,150,33208,29281,29431,196.20666666666668,4 5 6 7 12 13,-1
737,w0,100,3779,4,148,0,COMPLETED_WALLTIME_REACHED,33061,148,33209,29282,29430,198.85135135135135,0 1 2 3,-1
738,w0,100,3783,5,149,0,COMPLETED_WALLTIME_REACHED,33061,149,33210,29278,29427,197.49664429530202,8 9 10 11 14,-1
739,w0,100,3789,5,146,0,COMPLETED_WALLTIME_REACHED,33208,146,33354,29419,29565,202.5,4 5 6 7 12,-1
740,w0,100,3793,5,149,0,COMPLETED_WALLTIME_REACHED,33209,149,33358,29416,29565,198.4228187919463,0 1 2 3 13,-1
741,w0,100,3795,6,152,0,COMPLETED_WALLTIME_REACHED,33215,152,33367,29420,29572,194.55263157894737,8 9 10 11 14 15,-1
743,w0,100,3820,5,149,0,COMPLETED_WALLTIME_REACHED,33354,149,33503,29534,29683,199.21476510067114,4 5 6 7 12,-1
744,w0,100,3823,4,150,0,COMPLETED_WALLTIME_REACHED,33358,150,33508,29535,29685,197.9,0 1 2 3,-1
745,w0,100,3828,4,151,0,COMPLETED_WALLTIME_REACHED,33367,151,33518,29539,29690,196.6225165562914,8 9 10 11,-1
752,w0,100,3856,3,154,0,COMPLETED_WALLTIME_REACHED,33367,154,33521,29511,29665,192.62987012987014,13 14 15,-1
746,w0,100,3828,4,150,0,COMPLETED_WALLTIME_REACHED,33503,150,33653,29675,29825,198.83333333333334,4 5 6 7,-1
755,w0,100,3874,3,153,0,COMPLETED_WALLTIME_REACHED,33508,153,33661,29634,29787,194.68627450980392,0 1 2,-1
748,w0,100,3838,6,152,0,COMPLETED_WALLTIME_REACHED,33518,152,33670,29680,29832,196.26315789473685,3 8 9 10 11 12,-1
750,w0,100,3848,6,150,0,COMPLETED_WALLTIME_REACHED,33658,150,33808,29810,29960,199.73333333333332,4 5 6 7 13 14,-1
753,w0,100,3860,4,148,0,COMPLETED_WALLTIME_REACHED,33666,148,33814,29806,29954,202.3918918918919,0 1 2 15,-1
754,w0,100,3861,5,153,0,COMPLETED_WALLTIME_REACHED,33670,153,33823,29809,29962,195.83006535947712,3 8 9 10 11,-1
756,w0,100,3878,6,150,0,COMPLETED_WALLTIME_REACHED,33813,150,33963,29935,30085,200.56666666666666,4 5 6 7 12 13,-1
757,w0,100,3882,5,147,0,COMPLETED_WALLTIME_REACHED,33814,147,33961,29932,30079,204.61904761904762,0 1 2 14 15,-1
758,w0,100,3882,4,149,0,COMPLETED_WALLTIME_REACHED,33823,149,33972,29941,30090,201.94630872483222,3 8 9 10,-1
759,w0,100,3885,3,153,0,COMPLETED_WALLTIME_REACHED,33961,153,34114,30076,30229,197.5751633986928,0 1 2,-1
760,w0,100,3898,6,145,0,COMPLETED_WALLTIME_REACHED,33963,145,34108,30065,30210,208.3448275862069,4 5 6 7 12 13,-1
774,w0,100,3945,3,149,0,COMPLETED_WALLTIME_REACHED,33966,149,34115,30021,30170,202.48322147651007,11 14 15,-1
762,w0,100,3903,4,151,0,COMPLETED_WALLTIME_REACHED,33972,151,34123,30069,30220,200.13245033112582,3 8 9 10,-1
761,w0,100,3901,6,150,0,COMPLETED_WALLTIME_REACHED,34108,150,34258,30207,30357,202.38,4 5 6 7 12 13,-1
763,w0,100,3908,5,149,0,COMPLETED_WALLTIME_REACHED,34115,149,34264,30207,30356,203.73154362416108,0 1 2 11 14,-1
764,w0,100,3909,5,151,0,COMPLETED_WALLTIME_REACHED,34123,151,34274,30214,30365,201.09271523178808,3 8 9 10 15,-1
765,w0,100,3909,4,149,0,COMPLETED_WALLTIME_REACHED,34258,149,34407,30349,30498,204.68456375838926,4 5 6 7,-1
766,w0,100,3919,5,153,0,COMPLETED_WALLTIME_REACHED,34264,153,34417,30345,30498,199.33333333333334,0 1 2 11 12,-1
768,w0,100,3931,5,152,0,COMPLETED_WALLTIME_REACHED,34274,152,34426,30343,30495,200.625,3 8 9 10 13,-1
770,w0,100,3933,5,150,0,COMPLETED_WALLTIME_REACHED,34412,150,34562,30479,30629,204.19333333333333,4 5 6 7 14,-1
771,w0,100,3934,4,150,0,COMPLETED_WALLTIME_REACHED,34417,150,34567,30483,30633,204.22,0 1 2 11,-1
772,w0,100,3935,4,152,0,COMPLETED_WALLTIME_REACHED,34426,152,34578,30491,30643,201.59868421052633,3 8 9 10,-1
782,w0,100,3971,3,151,0,COMPLETED_WALLTIME_REACHED,34431,151,34582,30460,30611,202.72185430463577,12 13 15,-1
773,w0,100,3941,4,150,0,COMPLETED_WALLTIME_REACHED,34562,150,34712,30621,30771,205.14,4 5 6 7,-1
775,w0,100,3945,5,146,0,COMPLETED_WALLTIME_REACHED,34567,146,34713,30622,30768,210.73972602739727,0 1 2 11 14,-1
776,w0,100,3946,4,149,0,COMPLETED_WALLTIME_REACHED,34578,149,34727,30632,30781,206.58389261744966,3 8 9 10,-1
788,w0,100,4029,3,149,0,COMPLETED_WALLTIME_REACHED,34582,149,34731,30553,30702,206.05369127516778,12 13 15,-1
777,w0,100,3948,4,150,0,COMPLETED_WALLTIME_REACHED,34712,150,34862,30764,30914,206.09333333333333,4 5 6 7,-1
778,w0,100,3951,5,150,0,COMPLETED_WALLTIME_REACHED,34713,150,34863,30762,30912,206.08,0 1 2 11 14,-1
779,w0,100,3956,5,148,0,COMPLETED_WALLTIME_REACHED,34731,148,34879,30775,30923,208.9391891891892,3 8 9 10 12,-1
780,w0,100,3957,5,147,0,COMPLETED_WALLTIME_REACHED,34867,147,35014,30910,31057,211.2721088435374,4 5 6 7 13,-1
781,w0,100,3961,6,149,0,COMPLETED_WALLTIME_REACHED,34868,149,35017,30907,31056,208.4295302013423,0 1 2 11 14 15,-1
783,w0,100,3975,5,151,0,COMPLETED_WALLTIME_REACHED,34879,151,35030,30904,31055,205.66225165562915,3 8 9 10 12,-1
784,w0,100,3998,4,147,0,COMPLETED_WALLTIME_REACHED,35014,147,35161,31016,31163,211.99319727891157,4 5 6 7,-1
785,w0,100,4014,6,149,0,COMPLETED_WALLTIME_REACHED,35017,149,35166,31003,31152,209.0738255033557,0 1 2 11 13 14,-1
786,w0,100,4016,6,150,0,COMPLETED_WALLTIME_REACHED,35030,150,35180,31014,31164,207.76,3 8 9 10 12 15,-1
787,w0,100,4028,4,150,0,COMPLETED_WALLTIME_REACHED,35161,150,35311,31133,31283,208.55333333333334,4 5 6 7,-1
789,w0,100,4044,5,148,0,COMPLETED_WALLTIME_REACHED,35166,148,35314,31122,31270,211.28378378378378,0 1 2 11 13,-1
790,w0,100,4045,4,152,0,COMPLETED_WALLTIME_REACHED,35180,152,35332,31135,31287,205.83552631578948,3 8 9 10,-1
792,w0,100,4055,5,151,0,COMPLETED_WALLTIME_REACHED,35314,151,35465,31259,31410,208.01324503311258,0 1 2 11 13,-1
791,w0,100,4046,5,150,0,COMPLETED_WALLTIME_REACHED,35316,150,35466,31270,31420,209.46666666666667,4 5 6 7 12,-1
793,w0,100,4061,5,148,0,COMPLETED_WALLTIME_REACHED,35337,148,35485,31276,31424,212.32432432432432,3 8 9 10 14,-1
794,w0,100,4067,4,147,0,COMPLETED_WALLTIME_REACHED,35465,147,35612,31398,31545,214.59183673469389,0 1 2 11,-1
795,w0,100,4069,5,152,0,COMPLETED_WALLTIME_REACHED,35466,152,35618,31397,31549,207.55921052631578,4 5 6 7 12,-1
796,w0,100,4074,4,149,0,COMPLETED_WALLTIME_REACHED,35485,149,35634,31411,31560,211.81208053691276,3 8 9 10,-1
797,w0,100,4074,3,150,0,COMPLETED_WALLTIME_REACHED,35490,150,35640,31416,31566,210.44,13 14 15,-1
798,w0,100,4081,4,150,0,COMPLETED_WALLTIME_REACHED,35612,150,35762,31531,31681,211.20666666666668,0 1 2 11,-1
799,w0,100,4101,5,149,0,COMPLETED_WALLTIME_REACHED,35618,149,35767,31517,31666,212.5234899328859,4 5 6 7 12,-1
800,w0,100,4101,5,148,0,COMPLETED_WALLTIME_REACHED,35640,148,35788,31539,31687,214.10135135135135,3 8 9 10 13,-1
801,w0,100,4102,5,150,0,COMPLETED_WALLTIME_REACHED,35767,150,35917,31665,31815,212.1,0 1 2 11 14,-1
802,w0,100,4103,6,154,0,COMPLETED_WALLTIME_REACHED,35772,154,35926,31669,31823,206.64285714285714,4 5 6 7 12 15,-1
804,w0,100,4108,4,149,0,COMPLETED_WALLTIME_REACHED,35788,149,35937,31680,31829,213.61744966442953,3 8 9 10,-1
803,w0,100,4106,6,150,0,COMPLETED_WALLTIME_REACHED,35922,150,36072,31816,31966,213.10666666666665,0 1 2 11 13 14,-1
805,w0,100,4109,4,151,0,COMPLETED_WALLTIME_REACHED,35926,151,36077,31817,31968,211.7086092715232,4 5 6 7,-1
806,w0,100,4111,3,148,0,COMPLETED_WALLTIME_REACHED,35937,148,36085,31826,31974,216.04054054054055,3 8 9,-1
812,w0,100,4138,3,151,0,COMPLETED_WALLTIME_REACHED,35937,151,36088,31799,31950,211.58940397350995,10 12 15,-1
807,w0,100,4121,4,152,0,COMPLETED_WALLTIME_REACHED,36072,152,36224,31951,32103,211.20394736842104,0 1 2 11,-1
808,w0,100,4122,4,152,0,COMPLETED_WALLTIME_REACHED,36077,152,36229,31955,32107,211.23026315789474,4 5 6 7,-1
809,w0,100,4123,7,150,0,COMPLETED_WALLTIME_REACHED,36088,150,36238,31965,32115,214.1,3 8 9 10 12 13 14,-1
810,w0,100,4123,5,151,0,COMPLETED_WALLTIME_REACHED,36229,151,36380,32106,32257,213.6225165562914,0 1 2 11 15,-1
813,w0,100,4140,4,150,0,COMPLETED_WALLTIME_REACHED,36229,150,36379,32089,32239,214.92666666666668,4 5 6 7,-1
811,w0,100,4137,6,151,0,COMPLETED_WALLTIME_REACHED,36238,151,36389,32101,32252,213.58940397350995,3 8 9 10 12 13,-1
815,w0,100,4175,4,149,0,COMPLETED_WALLTIME_REACHED,36380,149,36529,32205,32354,217.14093959731542,0 1 2 11,-1
814,w0,100,4153,5,150,0,COMPLETED_WALLTIME_REACHED,36384,150,36534,32231,32381,215.87333333333333,4 5 6 7 14,-1
816,w0,100,4176,5,149,0,COMPLETED_WALLTIME_REACHED,36389,149,36538,32213,32362,217.19463087248323,3 8 9 10 12,-1
817,w0,100,4182,6,151,0,COMPLETED_WALLTIME_REACHED,36534,151,36685,32352,32503,215.25165562913907,0 1 2 11 13 15,-1
818,w0,100,4182,3,153,0,COMPLETED_WALLTIME_REACHED,36534,153,36687,32352,32505,212.45098039215685,4 5 6,-1
819,w0,100,4192,5,151,0,COMPLETED_WALLTIME_REACHED,36538,151,36689,32346,32497,215.21192052980132,3 7 8 9 10,-1
820,w0,100,4193,4,154,0,COMPLETED_WALLTIME_REACHED,36685,154,36839,32492,32646,211.98701298701297,0 1 2 11,-1
823,w0,100,4200,3,152,0,COMPLETED_WALLTIME_REACHED,36687,152,36839,32487,32639,214.73026315789474,4 5 6,-1
822,w0,100,4197,4,152,0,COMPLETED_WALLTIME_REACHED,36689,152,36841,32492,32644,214.76315789473685,3 7 8 9,-1
821,w0,100,4194,4,150,0,COMPLETED_WALLTIME_REACHED,36690,150,36840,32496,32646,217.64,12 13 14 15,-1
824,w0,100,4206,4,150,0,COMPLETED_WALLTIME_REACHED,36839,150,36989,32633,32783,218.55333333333334,0 1 2 4,-1
825,w0,100,4209,5,149,0,COMPLETED_WALLTIME_REACHED,36840,149,36989,32631,32780,220.0,11 12 13 14 15,-1
828,w0,100,4215,4,152,0,COMPLETED_WALLTIME_REACHED,36841,152,36993,32626,32778,215.64473684210526,3 7 8 9,-1
829,w0,100,4219,3,153,0,COMPLETED_WALLTIME_REACHED,36844,153,36997,32625,32778,214.23529411764707,5 6 10,-1
826,w0,100,4211,6,148,0,COMPLETED_WALLTIME_REACHED,36989,148,37137,32778,32926,222.47297297297297,0 1 2 4 11 12,-1
827,w0,100,4212,6,148,0,COMPLETED_WALLTIME_REACHED,36993,148,37141,32781,32929,222.49324324324326,3 7 8 9 13 14,-1
831,w0,100,4223,4,152,0,COMPLETED_WALLTIME_REACHED,36997,152,37149,32774,32926,216.6184210526316,5 6 10 15,-1
830,w0,100,4222,5,151,0,COMPLETED_WALLTIME_REACHED,37137,151,37288,32915,33066,218.98013245033113,0 1 2 4 11,-1
832,w0,100,4226,5,152,0,COMPLETED_WALLTIME_REACHED,37141,152,37293,32915,33067,217.54605263157896,3 7 8 9 12,-1
834,w0,100,4230,4,149,0,COMPLETED_WALLTIME_REACHED,37149,149,37298,32919,33068,221.93288590604027,5 6 10 13,-1
835,w0,100,4231,4,149,0,COMPLETED_WALLTIME_REACHED,37288,149,37437,33057,33206,222.85906040268458,0 1 2 4,-1
846,w0,100,4290,3,151,0,COMPLETED_WALLTIME_REACHED,37293,151,37444,33003,33154,219.56291390728478,11 14 15,-1
836,w0,100,4236,5,150,0,COMPLETED_WALLTIME_REACHED,37293,150,37443,33057,33207,221.38,3 7 8 9 12,-1
837,w0,100,4238,4,148,0,COMPLETED_WALLTIME_REACHED,37298,148,37446,33060,33208,224.3783783783784,5 6 10 13,-1
878,w0,100,4436,3,151,0,COMPLETED_WALLTIME_REACHED,37437,151,37588,33001,33152,219.5496688741722,0 1 2,-1
838,w0,100,4240,6,150,0,COMPLETED_WALLTIME_REACHED,37443,150,37593,33203,33353,222.35333333333332,3 4 7 8 9 12,-1
888,w0,100,4480,3,149,0,COMPLETED_WALLTIME_REACHED,37444,149,37593,32964,33113,222.23489932885906,11 14 15,-1
839,w0,100,4262,4,149,0,COMPLETED_WALLTIME_REACHED,37446,149,37595,33184,33333,223.71140939597316,5 6 10 13,-1
889,w0,100,4482,3,152,0,COMPLETED_WALLTIME_REACHED,37588,152,37740,33106,33258,218.80263157894737,0 1 2,-1
840,w0,100,4263,4,153,0,COMPLETED_WALLTIME_REACHED,37593,153,37746,33330,33483,218.84313725490196,3 4 7 8,-1
841,w0,100,4272,4,152,0,COMPLETED_WALLTIME_REACHED,37593,152,37745,33321,33473,220.2171052631579,9 11 12 14,-1
843,w0,100,4284,5,148,0,COMPLETED_WALLTIME_REACHED,37595,148,37743,33311,33459,226.07432432432432,5 6 10 13 15,-1
922,w0,100,4648,3,148,0,COMPLETED_WALLTIME_REACHED,37740,148,37888,33092,33240,224.59459459459458,0 1 2,-1
844,w0,100,4288,4,153,0,COMPLETED_WALLTIME_REACHED,37743,153,37896,33455,33608,219.66013071895424,5 6 10 13,-1
939,w0,100,4708,3,150,0,COMPLETED_WALLTIME_REACHED,37745,150,37895,33037,33187,221.24666666666667,9 11 12,-1
847,w0,100,4296,6,152,0,COMPLETED_WALLTIME_REACHED,37746,152,37898,33450,33602,221.06578947368422,3 4 7 8 14 15,-1
848,w0,100,4302,4,152,0,COMPLETED_WALLTIME_REACHED,37895,152,38047,33593,33745,222.0065789473684,0 1 2 9,-1
849,w0,100,4323,5,147,0,COMPLETED_WALLTIME_REACHED,37896,147,38043,33573,33720,229.3877551020408,5 6 10 11 12,-1
850,w0,100,4324,6,150,0,COMPLETED_WALLTIME_REACHED,37898,150,38048,33574,33724,224.82666666666665,3 4 7 8 13 14,-1
851,w0,100,4333,4,149,0,COMPLETED_WALLTIME_REACHED,38043,149,38192,33710,33859,227.24161073825502,5 6 10 11,-1
852,w0,100,4334,4,150,0,COMPLETED_WALLTIME_REACHED,38047,150,38197,33713,33863,225.75333333333333,0 1 2 9,-1
853,w0,100,4343,6,148,0,COMPLETED_WALLTIME_REACHED,38048,148,38196,33705,33853,228.73648648648648,3 4 7 8 12 13,-1
855,w0,100,4353,4,148,0,COMPLETED_WALLTIME_REACHED,38192,148,38340,33839,33987,229.6418918918919,5 6 10 11,-1
856,w0,100,4354,4,152,0,COMPLETED_WALLTIME_REACHED,38197,152,38349,33843,33995,223.65131578947367,0 1 2 9,-1
854,w0,100,4345,7,151,0,COMPLETED_WALLTIME_REACHED,38201,151,38352,33856,34007,225.21192052980132,3 4 7 8 12 13 14,-1
858,w0,100,4364,5,153,0,COMPLETED_WALLTIME_REACHED,38345,153,38498,33981,34134,223.09803921568627,5 6 10 11 15,-1
860,w0,100,4378,4,147,0,COMPLETED_WALLTIME_REACHED,38349,147,38496,33971,34118,232.0952380952381,0 1 2 9,-1
859,w0,100,4377,5,151,0,COMPLETED_WALLTIME_REACHED,38352,151,38503,33975,34126,226.0,3 4 7 8 12,-1
861,w0,100,4380,4,150,0,COMPLETED_WALLTIME_REACHED,38496,150,38646,34116,34266,228.44,0 1 2 9,-1
862,w0,100,4381,6,152,0,COMPLETED_WALLTIME_REACHED,38503,152,38655,34122,34274,225.48684210526315,5 6 10 11 13 14,-1
863,w0,100,4383,5,149,0,COMPLETED_WALLTIME_REACHED,38503,149,38652,34120,34269,229.99328859060404,3 4 7 8 12,-1
864,w0,100,4384,5,149,0,COMPLETED_WALLTIME_REACHED,38651,149,38800,34267,34416,230.9798657718121,0 1 2 9 15,-1
865,w0,100,4390,4,151,0,COMPLETED_WALLTIME_REACHED,38652,151,38803,34262,34413,227.90066225165563,3 4 7 8,-1
866,w0,100,4397,4,147,0,COMPLETED_WALLTIME_REACHED,38655,147,38802,34258,34405,234.04761904761904,5 6 10 11,-1
940,w0,100,4717,3,148,0,COMPLETED_WALLTIME_REACHED,38655,148,38803,33938,34086,230.3108108108108,12 13 14,-1
867,w0,100,4399,4,147,0,COMPLETED_WALLTIME_REACHED,38800,147,38947,34401,34548,235.0204081632653,0 1 2 9,-1
868,w0,100,4400,4,151,0,COMPLETED_WALLTIME_REACHED,38802,151,38953,34402,34553,228.82781456953643,5 6 10 11,-1
869,w0,100,4402,4,153,0,COMPLETED_WALLTIME_REACHED,38803,153,38956,34401,34554,225.84313725490196,3 4 7 8,-1
871,w0,100,4403,6,150,0,COMPLETED_WALLTIME_REACHED,38952,150,39102,34549,34699,231.32666666666665,0 1 2 9 12 13,-1
873,w0,100,4411,4,152,0,COMPLETED_WALLTIME_REACHED,38953,152,39105,34542,34694,228.25,5 6 10 11,-1
874,w0,100,4416,6,151,0,COMPLETED_WALLTIME_REACHED,38961,151,39112,34545,34696,229.7748344370861,3 4 7 8 14 15,-1
875,w0,100,4417,6,150,0,COMPLETED_WALLTIME_REACHED,39102,150,39252,34685,34835,232.23333333333332,0 1 2 9 12 13,-1
877,w0,100,4433,4,153,0,COMPLETED_WALLTIME_REACHED,39105,153,39258,34672,34825,227.6143790849673,5 6 10 11,-1
876,w0,100,4420,5,151,0,COMPLETED_WALLTIME_REACHED,39112,151,39263,34692,34843,230.74834437086093,3 4 7 8 14,-1
879,w0,100,4441,5,151,0,COMPLETED_WALLTIME_REACHED,39252,151,39403,34811,34962,231.53642384105962,0 1 2 9 12,-1
880,w0,100,4443,5,148,0,COMPLETED_WALLTIME_REACHED,39258,148,39406,34815,34963,236.23648648648648,5 6 10 11 13,-1
885,w0,100,4463,4,152,0,COMPLETED_WALLTIME_REACHED,39263,152,39415,34800,34952,229.94736842105263,3 4 7 8,-1
882,w0,100,4450,5,147,0,COMPLETED_WALLTIME_REACHED,39406,147,39553,34956,35103,238.79591836734693,5 6 10 11 13,-1
881,w0,100,4445,7,150,0,COMPLETED_WALLTIME_REACHED,39408,150,39558,34963,35113,234.08666666666667,0 1 2 9 12 14 15,-1
887,w0,100,4473,4,149,0,COMPLETED_WALLTIME_REACHED,39415,149,39564,34942,35091,235.51006711409397,3 4 7 8,-1
883,w0,100,4462,5,151,0,COMPLETED_WALLTIME_REACHED,39553,151,39704,35091,35242,233.39072847682118,5 6 10 11 13,-1
884,w0,100,4463,6,147,0,COMPLETED_WALLTIME_REACHED,39558,147,39705,35095,35242,239.74149659863946,0 1 2 9 12 14,-1
886,w0,100,4466,5,153,0,COMPLETED_WALLTIME_REACHED,39564,153,39717,35098,35251,230.3986928104575,3 4 7 8 15,-1
890,w0,100,4487,4,150,0,COMPLETED_WALLTIME_REACHED,39704,150,39854,35217,35367,235.78,5 6 10 11,-1
891,w0,100,4495,5,147,0,COMPLETED_WALLTIME_REACHED,39705,147,39852,35210,35357,240.52380952380952,0 1 2 9 12,-1
892,w0,100,4505,5,150,0,COMPLETED_WALLTIME_REACHED,39717,150,39867,35212,35362,235.74666666666667,3 4 7 8 13,-1
893,w0,100,4505,5,147,0,COMPLETED_WALLTIME_REACHED,39852,147,39999,35347,35494,241.45578231292518,0 1 2 9 12,-1
894,w0,100,4514,5,151,0,COMPLETED_WALLTIME_REACHED,39859,151,40010,35345,35496,235.0728476821192,5 6 10 11 14,-1
895,w0,100,4516,4,149,0,COMPLETED_WALLTIME_REACHED,39867,149,40016,35351,35500,238.25503355704697,3 4 7 8,-1
896,w0,100,4521,5,150,0,COMPLETED_WALLTIME_REACHED,39999,150,40149,35478,35628,237.52,0 1 2 9 12,-1
897,w0,100,4527,4,150,0,COMPLETED_WALLTIME_REACHED,40010,150,40160,35483,35633,237.55333333333334,5 6 10 11,-1
898,w0,100,4534,6,153,0,COMPLETED_WALLTIME_REACHED,40021,153,40174,35487,35640,232.94117647058823,3 4 7 8 13 14,-1
899,w0,100,4539,5,148,0,COMPLETED_WALLTIME_REACHED,40149,148,40297,35610,35758,241.6081081081081,0 1 2 9 12,-1
900,w0,100,4544,5,153,0,COMPLETED_WALLTIME_REACHED,40165,153,40318,35621,35774,233.81699346405227,5 6 10 11 15,-1
901,w0,100,4551,4,147,0,COMPLETED_WALLTIME_REACHED,40174,147,40321,35623,35770,243.33333333333334,3 4 7 8,-1
902,w0,100,4560,6,151,0,COMPLETED_WALLTIME_REACHED,40302,151,40453,35742,35893,237.7019867549669,0 1 2 9 12 13,-1
904,w0,100,4579,4,152,0,COMPLETED_WALLTIME_REACHED,40321,152,40473,35742,35894,236.14473684210526,3 4 7 8,-1
903,w0,100,4575,5,151,0,COMPLETED_WALLTIME_REACHED,40323,151,40474,35748,35899,237.74172185430464,5 6 10 11 14,-1
905,w0,100,4580,4,149,0,COMPLETED_WALLTIME_REACHED,40453,149,40602,35873,36022,241.75838926174498,0 1 2 9,-1
906,w0,100,4593,5,150,0,COMPLETED_WALLTIME_REACHED,40473,150,40623,35880,36030,240.2,3 4 7 8 12,-1
908,w0,100,4598,5,148,0,COMPLETED_WALLTIME_REACHED,40474,148,40622,35876,36024,243.40540540540542,5 6 10 11 13,-1
909,w0,100,4603,5,150,0,COMPLETED_WALLTIME_REACHED,40607,150,40757,36004,36154,241.02666666666667,0 1 2 9 14,-1
910,w0,100,4607,4,153,0,COMPLETED_WALLTIME_REACHED,40622,153,40775,36015,36168,236.3921568627451,5 6 10 11,-1
911,w0,100,4611,5,148,0,COMPLETED_WALLTIME_REACHED,40623,148,40771,36012,36160,244.32432432432432,3 4 7 8 12,-1
912,w0,100,4617,5,152,0,COMPLETED_WALLTIME_REACHED,40762,152,40914,36145,36297,238.79605263157896,0 1 2 9 13,-1
913,w0,100,4618,4,154,0,COMPLETED_WALLTIME_REACHED,40771,154,40925,36153,36307,235.75974025974025,3 4 7 8,-1
914,w0,100,4624,6,149,0,COMPLETED_WALLTIME_REACHED,40775,149,40924,36151,36300,243.6241610738255,5 6 10 11 12 14,-1
915,w0,100,4625,4,152,0,COMPLETED_WALLTIME_REACHED,40914,152,41066,36289,36441,239.7434210526316,0 1 2 9,-1
916,w0,100,4627,5,151,0,COMPLETED_WALLTIME_REACHED,40924,151,41075,36297,36448,241.3774834437086,5 6 10 11 12,-1
917,w0,100,4637,5,153,0,COMPLETED_WALLTIME_REACHED,40925,153,41078,36288,36441,238.1764705882353,3 4 7 8 13,-1
918,w0,100,4639,6,145,0,COMPLETED_WALLTIME_REACHED,41071,145,41216,36432,36577,252.2551724137931,0 1 2 9 14 15,-1
919,w0,100,4642,4,151,0,COMPLETED_WALLTIME_REACHED,41075,151,41226,36433,36584,242.27814569536423,5 6 10 11,-1
920,w0,100,4644,6,150,0,COMPLETED_WALLTIME_REACHED,41078,150,41228,36434,36584,243.89333333333335,3 4 7 8 12 13,-1
921,w0,100,4646,4,151,0,COMPLETED_WALLTIME_REACHED,41216,151,41367,36570,36721,243.18543046357615,0 1 2 9,-1
923,w0,100,4649,4,148,0,COMPLETED_WALLTIME_REACHED,41226,148,41374,36577,36725,248.1418918918919,5 6 10 11,-1
924,w0,100,4651,5,150,0,COMPLETED_WALLTIME_REACHED,41228,150,41378,36577,36727,244.84666666666666,3 4 7 8 12,-1
941,w0,100,4718,3,147,0,COMPLETED_WALLTIME_REACHED,41228,147,41375,36510,36657,249.3673469387755,13 14 15,-1
925,w0,100,4658,4,147,0,COMPLETED_WALLTIME_REACHED,41367,147,41514,36709,36856,250.72108843537416,0 1 2 9,-1
926,w0,100,4664,4,150,0,COMPLETED_WALLTIME_REACHED,41374,150,41524,36710,36860,245.73333333333332,5 6 10 11,-1
945,w0,100,4749,3,151,0,COMPLETED_WALLTIME_REACHED,41375,151,41526,36626,36777,243.5562913907285,13 14 15,-1
927,w0,100,4665,5,150,0,COMPLETED_WALLTIME_REACHED,41378,150,41528,36713,36863,245.75333333333333,3 4 7 8 12,-1
928,w0,100,4665,6,153,0,COMPLETED_WALLTIME_REACHED,41524,153,41677,36859,37012,241.90849673202615,0 1 2 5 6 9,-1
929,w0,100,4669,5,149,0,COMPLETED_WALLTIME_REACHED,41526,149,41675,36857,37006,248.36241610738256,10 11 13 14 15,-1
930,w0,100,4669,5,149,0,COMPLETED_WALLTIME_REACHED,41528,149,41677,36859,37008,248.3758389261745,3 4 7 8 12,-1
931,w0,100,4670,4,152,0,COMPLETED_WALLTIME_REACHED,41675,152,41827,37005,37157,244.45394736842104,10 11 13 14,-1
932,w0,100,4682,5,150,0,COMPLETED_WALLTIME_REACHED,41677,150,41827,36995,37145,247.63333333333333,0 1 2 3 4,-1
933,w0,100,4684,5,149,0,COMPLETED_WALLTIME_REACHED,41677,149,41826,36993,37142,249.2751677852349,5 6 7 8 9,-1
934,w0,100,4694,5,150,0,COMPLETED_WALLTIME_REACHED,41826,150,41976,37132,37282,248.54666666666665,5 6 7 8 9,-1
935,w0,100,4696,5,147,0,COMPLETED_WALLTIME_REACHED,41827,147,41974,37131,37278,253.59183673469389,0 1 2 3 4,-1
936,w0,100,4696,4,149,0,COMPLETED_WALLTIME_REACHED,41832,149,41981,37136,37285,250.23489932885906,10 11 12 13,-1
937,w0,100,4696,5,151,0,COMPLETED_WALLTIME_REACHED,41974,151,42125,37278,37429,247.87417218543047,0 1 2 3 4,-1
938,w0,100,4702,6,149,0,COMPLETED_WALLTIME_REACHED,41981,149,42130,37279,37428,251.19463087248323,5 6 7 8 9 14,-1
942,w0,100,4726,4,152,0,COMPLETED_WALLTIME_REACHED,41981,152,42133,37255,37407,246.09868421052633,10 11 12 13,-1
943,w0,100,4732,6,146,0,COMPLETED_WALLTIME_REACHED,42130,146,42276,37398,37544,257.1506849315069,0 1 2 3 4 15,-1
944,w0,100,4741,4,147,0,COMPLETED_WALLTIME_REACHED,42130,147,42277,37389,37536,255.3469387755102,5 6 7 8,-1
946,w0,100,4761,5,152,0,COMPLETED_WALLTIME_REACHED,42133,152,42285,37372,37524,246.8684210526316,9 10 11 12 13,-1
947,w0,100,4766,5,150,0,COMPLETED_WALLTIME_REACHED,42276,150,42426,37510,37660,251.06666666666666,0 1 2 3 4,-1
948,w0,100,4767,5,149,0,COMPLETED_WALLTIME_REACHED,42282,149,42431,37515,37664,252.7785234899329,5 6 7 8 14,-1
949,w0,100,4768,4,150,0,COMPLETED_WALLTIME_REACHED,42285,150,42435,37517,37667,251.11333333333334,9 10 11 12,-1
950,w0,100,4772,4,152,0,COMPLETED_WALLTIME_REACHED,42426,152,42578,37654,37806,248.72368421052633,0 1 2 3,-1
953,w0,100,4784,3,148,0,COMPLETED_WALLTIME_REACHED,42431,148,42579,37647,37795,255.3716216216216,4 13 15,-1
951,w0,100,4774,5,147,0,COMPLETED_WALLTIME_REACHED,42431,147,42578,37657,37804,257.1700680272109,5 6 7 8 14,-1
955,w0,100,4793,3,148,0,COMPLETED_WALLTIME_REACHED,42435,148,42583,37642,37790,255.33783783783784,9 10 11,-1
952,w0,100,4775,8,149,0,COMPLETED_WALLTIME_REACHED,42578,149,42727,37803,37952,254.71140939597316,0 1 2 3 5 6 7 8,-1
954,w0,100,4786,7,148,0,COMPLETED_WALLTIME_REACHED,42588,148,42736,37802,37950,256.4189189189189,4 9 10 11 12 13 14,-1
956,w0,100,4803,5,151,0,COMPLETED_WALLTIME_REACHED,42727,151,42878,37924,38075,252.1523178807947,0 1 2 3 5,-1
957,w0,100,4807,3,150,0,COMPLETED_WALLTIME_REACHED,42727,150,42877,37920,38070,253.8,6 7 8,-1
958,w0,100,4810,5,152,0,COMPLETED_WALLTIME_REACHED,42736,152,42888,37926,38078,250.51315789473685,4 9 10 11 12,-1
959,w0,100,4811,3,149,0,COMPLETED_WALLTIME_REACHED,42741,149,42890,37930,38079,255.56375838926175,13 14 15,-1
960,w0,100,4832,3,148,0,COMPLETED_WALLTIME_REACHED,42877,148,43025,38045,38193,258.06081081081084,6 7 8,-1
961,w0,100,4834,4,151,0,COMPLETED_WALLTIME_REACHED,42878,151,43029,38044,38195,252.94701986754967,0 1 2 3,-1
962,w0,100,4836,4,146,0,COMPLETED_WALLTIME_REACHED,42888,146,43034,38052,38198,261.63013698630135,4 5 9 10,-1
963,w0,100,4848,4,151,0,COMPLETED_WALLTIME_REACHED,42890,151,43041,38042,38193,252.9337748344371,11 12 13 14,-1
975,w0,100,4910,3,149,0,COMPLETED_WALLTIME_REACHED,43025,149,43174,38115,38264,256.80536912751677,6 7 8,-1
964,w0,100,4857,5,153,0,COMPLETED_WALLTIME_REACHED,43034,153,43187,38177,38330,250.52287581699346,0 1 2 3 15,-1
965,w0,100,4866,4,149,0,COMPLETED_WALLTIME_REACHED,43034,149,43183,38168,38317,257.16107382550337,4 5 9 10,-1
966,w0,100,4867,5,150,0,COMPLETED_WALLTIME_REACHED,43179,150,43329,38312,38462,256.41333333333336,6 7 8 11 12,-1
968,w0,100,4874,4,150,0,COMPLETED_WALLTIME_REACHED,43187,150,43337,38313,38463,256.42,0 1 2 3,-1
967,w0,100,4873,6,150,0,COMPLETED_WALLTIME_REACHED,43188,150,43338,38315,38465,256.43333333333334,4 5 9 10 13 14,-1
969,w0,100,4876,6,149,0,COMPLETED_WALLTIME_REACHED,43334,149,43483,38458,38607,259.10738255033556,6 7 8 11 12 15,-1
970,w0,100,4878,4,155,0,COMPLETED_WALLTIME_REACHED,43337,155,43492,38459,38614,249.1225806451613,0 1 2 3,-1
971,w0,100,4881,6,150,0,COMPLETED_WALLTIME_REACHED,43338,150,43488,38457,38607,257.38,4 5 9 10 13 14,-1
972,w0,100,4883,5,153,0,COMPLETED_WALLTIME_REACHED,43483,153,43636,38600,38753,253.28758169934642,6 7 8 11 12,-1
973,w0,100,4887,5,149,0,COMPLETED_WALLTIME_REACHED,43488,149,43637,38601,38750,260.06711409395973,4 5 9 10 13,-1
974,w0,100,4906,5,149,0,COMPLETED_WALLTIME_REACHED,43492,149,43641,38586,38735,259.96644295302013,0 1 2 3 14,-1
976,w0,100,4919,4,153,0,COMPLETED_WALLTIME_REACHED,43636,153,43789,38717,38870,254.05228758169935,6 7 8 11,-1
977,w0,100,4922,6,151,0,COMPLETED_WALLTIME_REACHED,43637,151,43788,38715,38866,257.3907284768212,4 5 9 10 12 13,-1
978,w0,100,4923,4,147,0,COMPLETED_WALLTIME_REACHED,43641,147,43788,38718,38865,264.38775510204084,0 1 2 3,-1
979,w0,100,4928,4,152,0,COMPLETED_WALLTIME_REACHED,43788,152,43940,38860,39012,256.6578947368421,0 1 2 3,-1
980,w0,100,4938,5,147,0,COMPLETED_WALLTIME_REACHED,43788,147,43935,38850,38997,265.2857142857143,4 5 9 10 12,-1
996,w0,100,5004,4,146,0,COMPLETED_WALLTIME_REACHED,43789,146,43935,38785,38931,266.6506849315069,6 7 8 11,-1
981,w0,100,4943,3,148,0,COMPLETED_WALLTIME_REACHED,43793,148,43941,38850,38998,263.5,13 14 15,-1
982,w0,100,4948,7,154,0,COMPLETED_WALLTIME_REACHED,43935,154,44089,38987,39141,254.16233766233765,4 5 6 7 8 9 10,-1
983,w0,100,4954,5,150,0,COMPLETED_WALLTIME_REACHED,43940,150,44090,38986,39136,260.9066666666667,0 1 2 3 11,-1
984,w0,100,4960,4,147,0,COMPLETED_WALLTIME_REACHED,43941,147,44088,38981,39128,266.17687074829934,12 13 14 15,-1
986,w0,100,4964,3,150,0,COMPLETED_WALLTIME_REACHED,44088,150,44238,39124,39274,261.82666666666665,12 13 14,-1
987,w0,100,4966,6,148,0,COMPLETED_WALLTIME_REACHED,44089,148,44237,39123,39271,265.3445945945946,4 5 6 7 8 9,-1
988,w0,100,4971,4,152,0,COMPLETED_WALLTIME_REACHED,44090,152,44242,39119,39271,258.3618421052632,0 1 2 3,-1
989,w0,100,4978,7,147,0,COMPLETED_WALLTIME_REACHED,44242,147,44389,39264,39411,268.1020408163265,4 5 6 7 8 9 10,-1
992,w0,100,4996,3,151,0,COMPLETED_WALLTIME_REACHED,44243,151,44394,39247,39398,260.9139072847682,11 12 13,-1
990,w0,100,4979,6,153,0,COMPLETED_WALLTIME_REACHED,44247,153,44400,39268,39421,257.65359477124184,0 1 2 3 14 15,-1
991,w0,100,4994,5,148,0,COMPLETED_WALLTIME_REACHED,44389,148,44537,39395,39543,267.18243243243245,4 5 6 7 8,-1
993,w0,100,4997,3,148,0,COMPLETED_WALLTIME_REACHED,44394,148,44542,39397,39545,267.19594594594594,9 10 11,-1
994,w0,100,5000,8,151,0,COMPLETED_WALLTIME_REACHED,44400,151,44551,39400,39551,261.92715231788077,0 1 2 3 12 13 14 15,-1
995,w0,100,5001,3,150,0,COMPLETED_WALLTIME_REACHED,44537,150,44687,39536,39686,264.5733333333333,4 5 6,-1
997,w0,100,5005,4,149,0,COMPLETED_WALLTIME_REACHED,44542,149,44691,39537,39686,266.3489932885906,7 8 9 10,-1
998,w0,100,5008,4,149,0,COMPLETED_WALLTIME_REACHED,44551,149,44700,39543,39692,266.38926174496646,0 1 2 3,-1
999,w0,100,5014,4,151,0,COMPLETED_WALLTIME_REACHED,44551,151,44702,39537,39688,262.8344370860927,11 12 13 14,-1
1000,w0,100,5024,4,149,0,COMPLETED_WALLTIME_REACHED,44692,149,44841,39668,39817,267.2281879194631,4 5 6 15,-1
