job_id,workload_name,profile,submission_time,requested_number_of_resources,requested_time,success,final_state,starting_time,execution_time,finish_time,waiting_time,turnaround_time,stretch,allocated_resources,consumed_energy
1,w0,100,2,6,151,0,COMPLETED_WALLTIME_REACHED,2,151,153,0,151,1.0,0 1 2 3 4 5,-1
2,w0,100,3,4,152,0,COMPLETED_WALLTIME_REACHED,3,152,155,0,152,1.0,6 7 8 9,-1
3,w0,100,11,4,149,0,COMPLETED_WALLTIME_REACHED,11,149,160,0,149,1.0,10 11 12 13,-1
4,w0,100,20,5,146,0,COMPLETED_WALLTIME_REACHED,153,146,299,133,279,1.9109589041095891,0 1 2 3 4,-1
5,w0,100,34,4,152,0,COMPLETED_WALLTIME_REACHED,155,152,307,121,273,1.7960526315789473,6 7 8 9,-1
21,w0,100,132,3,151,0,COMPLETED_WALLTIME_REACHED,158,151,309,26,177,1.1721854304635762,5 14 15,-1
23,w0,100,144,3,149,0,COMPLETED_WALLTIME_REACHED,160,149,309,16,165,1.1073825503355705,10 11 12,-1
6,w0,100,35,6,153,0,COMPLETED_WALLTIME_REACHED,304,153,457,269,422,2.758169934640523,0 1 2 3 4 13,-1
7,w0,100,36,4,149,0,COMPLETED_WALLTIME_REACHED,307,149,456,271,420,2.8187919463087248,6 7 8 9,-1
8,w0,100,38,4,151,0,COMPLETED_WALLTIME_REACHED,309,151,460,271,422,2.794701986754967,5 10 11 12,-1
43,w0,100,216,1,150,0,COMPLETED_WALLTIME_REACHED,309,150,459,93,243,1.62,14,-1
9,w0,100,49,4,147,0,COMPLETED_WALLTIME_REACHED,456,147,603,407,554,3.7687074829931975,6 7 8 9,-1
10,w0,100,57,5,149,0,COMPLETED_WALLTIME_REACHED,457,149,606,400,549,3.684563758389262,0 1 2 3 4,-1
11,w0,100,60,5,151,0,COMPLETED_WALLTIME_REACHED,460,151,611,400,551,3.6490066225165565,5 10 11 12 13,-1
13,w0,100,67,5,150,0,COMPLETED_WALLTIME_REACHED,606,150,756,539,689,4.593333333333334,0 1 2 3 4,-1
12,w0,100,66,6,150,0,COMPLETED_WALLTIME_REACHED,608,150,758,542,692,4.613333333333333,6 7 8 9 14 15,-1
14,w0,100,68,4,151,0,COMPLETED_WALLTIME_REACHED,611,151,762,543,694,4.596026490066225,5 10 11 12,-1
15,w0,100,118,4,152,0,COMPLETED_WALLTIME_REACHED,756,152,908,638,790,5.197368421052632,0 1 2 3,-1
16,w0,100,120,4,149,0,COMPLETED_WALLTIME_REACHED,758,149,907,638,787,5.281879194630872,6 7 8 9,-1
119,w0,100,561,2,148,0,COMPLETED_WALLTIME_REACHED,758,148,906,197,345,2.331081081081081,14 15,-1
118,w0,100,560,2,152,0,COMPLETED_WALLTIME_REACHED,761,152,913,201,353,2.3223684210526314,4 13,-1
17,w0,100,128,4,152,0,COMPLETED_WALLTIME_REACHED,762,152,914,634,786,5.171052631578948,5 10 11 12,-1
18,w0,100,130,6,150,0,COMPLETED_WALLTIME_REACHED,907,150,1057,777,927,6.18,6 7 8 9 14 15,-1
19,w0,100,131,5,150,0,COMPLETED_WALLTIME_REACHED,913,150,1063,782,932,6.213333333333333,0 1 2 3 4,-1
20,w0,100,131,4,151,0,COMPLETED_WALLTIME_REACHED,914,151,1065,783,934,6.185430463576159,5 10 11 12,-1
168,w0,100,810,2,152,0,COMPLETED_WALLTIME_REACHED,1057,152,1209,247,399,2.625,14 15,-1
22,w0,100,133,5,150,0,COMPLETED_WALLTIME_REACHED,1062,150,1212,929,1079,7.193333333333333,6 7 8 9 13,-1
24,w0,100,144,4,149,0,COMPLETED_WALLTIME_REACHED,1063,149,1212,919,1068,7.167785234899329,0 1 2 3,-1
25,w0,100,159,3,149,0,COMPLETED_WALLTIME_REACHED,1065,149,1214,906,1055,7.080536912751678,4 5 10,-1
170,w0,100,822,2,151,0,COMPLETED_WALLTIME_REACHED,1065,151,1216,243,394,2.609271523178808,11 12,-1
172,w0,100,827,2,151,0,COMPLETED_WALLTIME_REACHED,1209,151,1360,382,533,3.5298013245033113,14 15,-1
26,w0,100,166,5,151,0,COMPLETED_WALLTIME_REACHED,1212,151,1363,1046,1197,7.927152317880795,0 1 2 3 6,-1
27,w0,100,168,3,149,0,COMPLETED_WALLTIME_REACHED,1212,149,1361,1044,1193,8.006711409395972,7 8 9,-1
28,w0,100,169,5,150,0,COMPLETED_WALLTIME_REACHED,1216,150,1366,1047,1197,7.98,4 5 10 11 12,-1
29,w0,100,169,4,151,0,COMPLETED_WALLTIME_REACHED,1361,151,1512,1192,1343,8.894039735099337,7 8 9 15,-1
30,w0,100,173,3,151,0,COMPLETED_WALLTIME_REACHED,1363,151,1514,1190,1341,8.880794701986755,0 1 2,-1
264,w0,100,1323,2,150,0,COMPLETED_WALLTIME_REACHED,1363,150,1513,40,190,1.2666666666666666,3 6,-1
254,w0,100,1272,2,146,0,COMPLETED_WALLTIME_REACHED,1365,146,1511,93,239,1.6369863013698631,13 14,-1
31,w0,100,177,4,147,0,COMPLETED_WALLTIME_REACHED,1366,147,1513,1189,1336,9.08843537414966,4 5 10 11,-1
37,w0,100,193,4,151,0,COMPLETED_WALLTIME_REACHED,1512,151,1663,1319,1470,9.735099337748345,7 8 9 15,-1
33,w0,100,181,5,152,0,COMPLETED_WALLTIME_REACHED,1513,152,1665,1332,1484,9.763157894736842,3 4 5 6 10,-1
46,w0,100,227,4,148,0,COMPLETED_WALLTIME_REACHED,1514,148,1662,1287,1435,9.695945945945946,0 1 2 11,-1
32,w0,100,178,3,151,0,COMPLETED_WALLTIME_REACHED,1516,151,1667,1338,1489,9.860927152317881,12 13 14,-1
47,w0,100,233,3,149,0,COMPLETED_WALLTIME_REACHED,1662,149,1811,1429,1578,10.590604026845638,0 1 2,-1
34,w0,100,183,5,152,0,COMPLETED_WALLTIME_REACHED,1663,152,1815,1480,1632,10.736842105263158,7 8 9 11 15,-1
35,w0,100,184,5,153,0,COMPLETED_WALLTIME_REACHED,1665,153,1818,1481,1634,10.679738562091503,3 4 5 6 10,-1
38,w0,100,195,5,149,0,COMPLETED_WALLTIME_REACHED,1815,149,1964,1620,1769,11.87248322147651,7 8 9 11 15,-1
36,w0,100,186,6,145,0,COMPLETED_WALLTIME_REACHED,1816,145,1961,1630,1775,12.241379310344827,0 1 2 12 13 14,-1
39,w0,100,198,5,151,0,COMPLETED_WALLTIME_REACHED,1818,151,1969,1620,1771,11.728476821192054,3 4 5 6 10,-1
40,w0,100,198,4,151,0,COMPLETED_WALLTIME_REACHED,1961,151,2112,1763,1914,12.675496688741722,0 1 2 12,-1
41,w0,100,209,6,153,0,COMPLETED_WALLTIME_REACHED,1964,153,2117,1755,1908,12.470588235294118,7 8 9 11 13 14,-1
42,w0,100,209,5,148,0,COMPLETED_WALLTIME_REACHED,1969,148,2117,1760,1908,12.891891891891891,3 4 5 6 10,-1
44,w0,100,219,4,152,0,COMPLETED_WALLTIME_REACHED,2112,152,2264,1893,2045,13.453947368421053,0 1 2 12,-1
45,w0,100,222,4,152,0,COMPLETED_WALLTIME_REACHED,2117,152,2269,1895,2047,13.467105263157896,3 4 5 6,-1
48,w0,100,239,4,150,0,COMPLETED_WALLTIME_REACHED,2117,150,2267,1878,2028,13.52,7 8 9 10,-1
49,w0,100,242,4,151,0,COMPLETED_WALLTIME_REACHED,2122,151,2273,1880,2031,13.450331125827814,11 13 14 15,-1
53,w0,100,259,3,151,0,COMPLETED_WALLTIME_REACHED,2264,151,2415,2005,2156,14.278145695364238,0 1 2,-1
50,w0,100,244,5,152,0,COMPLETED_WALLTIME_REACHED,2267,152,2419,2023,2175,14.30921052631579,7 8 9 10 12,-1
51,w0,100,249,4,155,0,COMPLETED_WALLTIME_REACHED,2269,155,2424,2020,2175,14.03225806451613,3 4 5 6,-1
266,w0,100,1329,2,148,0,COMPLETED_WALLTIME_REACHED,2273,148,2421,944,1092,7.378378378378378,11 13,-1
54,w0,100,259,5,150,0,COMPLETED_WALLTIME_REACHED,2419,150,2569,2160,2310,15.4,7 8 9 10 12,-1
52,w0,100,259,5,149,0,COMPLETED_WALLTIME_REACHED,2420,149,2569,2161,2310,15.503355704697986,0 1 2 14 15,-1
55,w0,100,264,6,153,0,COMPLETED_WALLTIME_REACHED,2424,153,2577,2160,2313,15.117647058823529,3 4 5 6 11 13,-1
56,w0,100,275,4,148,0,COMPLETED_WALLTIME_REACHED,2569,148,2717,2294,2442,16.5,0 1 2 7,-1
57,w0,100,276,6,149,0,COMPLETED_WALLTIME_REACHED,2569,149,2718,2293,2442,16.389261744966444,8 9 10 12 14 15,-1
58,w0,100,277,4,147,0,COMPLETED_WALLTIME_REACHED,2577,147,2724,2300,2447,16.64625850340136,3 4 5 6,-1
470,w0,100,2305,1,151,0,COMPLETED_WALLTIME_REACHED,2577,151,2728,272,423,2.801324503311258,11,-1
60,w0,100,280,4,149,0,COMPLETED_WALLTIME_REACHED,2718,149,2867,2438,2587,17.36241610738255,8 9 10 12,-1
335,w0,100,1665,2,151,0,COMPLETED_WALLTIME_REACHED,2718,151,2869,1053,1204,7.973509933774834,14 15,-1
59,w0,100,279,5,148,0,COMPLETED_WALLTIME_REACHED,2722,148,2870,2443,2591,17.506756756756758,0 1 2 7 13,-1
61,w0,100,283,4,149,0,COMPLETED_WALLTIME_REACHED,2724,149,2873,2441,2590,17.38255033557047,3 4 5 6,-1
62,w0,100,288,3,151,0,COMPLETED_WALLTIME_REACHED,2867,151,3018,2579,2730,18.079470198675498,8 9 10,-1
63,w0,100,288,6,152,0,COMPLETED_WALLTIME_REACHED,2870,152,3022,2582,2734,17.986842105263158,0 1 2 7 13 14,-1
375,w0,100,1839,2,146,0,COMPLETED_WALLTIME_REACHED,2872,146,3018,1033,1179,8.075342465753424,11 12,-1
64,w0,100,288,5,149,0,COMPLETED_WALLTIME_REACHED,2873,149,3022,2585,2734,18.348993288590606,3 4 5 6 15,-1
65,w0,100,293,4,149,0,COMPLETED_WALLTIME_REACHED,3018,149,3167,2725,2874,19.288590604026847,8 9 10 11,-1
66,w0,100,294,3,151,0,COMPLETED_WALLTIME_REACHED,3022,151,3173,2728,2879,19.066225165562916,0 1 2,-1
67,w0,100,299,5,149,0,COMPLETED_WALLTIME_REACHED,3022,149,3171,2723,2872,19.2751677852349,3 4 5 6 7,-1
68,w0,100,301,4,147,0,COMPLETED_WALLTIME_REACHED,3022,147,3169,2721,2868,19.510204081632654,12 13 14 15,-1
69,w0,100,302,3,150,0,COMPLETED_WALLTIME_REACHED,3167,150,3317,2865,3015,20.1,8 9 10,-1
70,w0,100,307,5,147,0,COMPLETED_WALLTIME_REACHED,3169,147,3316,2862,3009,20.46938775510204,11 12 13 14 15,-1
394,w0,100,1961,2,153,0,COMPLETED_WALLTIME_REACHED,3171,153,3324,1210,1363,8.908496732026144,3 4,-1
71,w0,100,313,6,152,0,COMPLETED_WALLTIME_REACHED,3173,152,3325,2860,3012,19.81578947368421,0 1 2 5 6 7,-1
72,w0,100,333,4,151,0,COMPLETED_WALLTIME_REACHED,3316,151,3467,2983,3134,20.75496688741722,11 12 13 14,-1
73,w0,100,342,6,148,0,COMPLETED_WALLTIME_REACHED,3324,148,3472,2982,3130,21.14864864864865,3 4 8 9 10 15,-1
74,w0,100,349,3,152,0,COMPLETED_WALLTIME_REACHED,3325,152,3477,2976,3128,20.57894736842105,0 1 2,-1
534,w0,100,2552,2,149,0,COMPLETED_WALLTIME_REACHED,3325,149,3474,773,922,6.1879194630872485,5 6,-1
75,w0,100,362,5,152,0,COMPLETED_WALLTIME_REACHED,3472,152,3624,3110,3262,21.460526315789473,7 11 12 13 14,-1
76,w0,100,370,4,148,0,COMPLETED_WALLTIME_REACHED,3472,148,3620,3102,3250,21.95945945945946,3 4 8 9,-1
651,w0,100,3076,1,152,0,COMPLETED_WALLTIME_REACHED,3472,152,3624,396,548,3.6052631578947367,10,-1
77,w0,100,371,3,145,0,COMPLETED_WALLTIME_REACHED,3474,145,3619,3103,3248,22.4,5 6 15,-1
79,w0,100,389,4,148,0,COMPLETED_WALLTIME_REACHED,3620,148,3768,3231,3379,22.83108108108108,3 4 8 9,-1
78,w0,100,374,5,149,0,COMPLETED_WALLTIME_REACHED,3624,149,3773,3250,3399,22.812080536912752,0 1 2 5 6,-1
80,w0,100,397,5,149,0,COMPLETED_WALLTIME_REACHED,3624,149,3773,3227,3376,22.65771812080537,7 10 11 12 13,-1
641,w0,100,3027,2,149,0,COMPLETED_WALLTIME_REACHED,3624,149,3773,597,746,5.006711409395973,14 15,-1
81,w0,100,402,4,148,0,COMPLETED_WALLTIME_REACHED,3768,148,3916,3366,3514,23.743243243243242,3 4 8 9,-1
82,w0,100,404,7,149,0,COMPLETED_WALLTIME_REACHED,3773,149,3922,3369,3518,23.610738255033556,0 1 2 5 6 7 10,-1
83,w0,100,408,5,149,0,COMPLETED_WALLTIME_REACHED,3773,149,3922,3365,3514,23.583892617449663,11 12 13 14 15,-1
86,w0,100,413,4,154,0,COMPLETED_WALLTIME_REACHED,3916,154,4070,3503,3657,23.746753246753247,3 4 8 9,-1
84,w0,100,410,6,152,0,COMPLETED_WALLTIME_REACHED,3922,152,4074,3512,3664,24.105263157894736,0 1 2 5 6 7,-1
87,w0,100,414,3,150,0,COMPLETED_WALLTIME_REACHED,3922,150,4072,3508,3658,24.386666666666667,10 11 12,-1
102,w0,100,471,3,146,0,COMPLETED_WALLTIME_REACHED,3922,146,4068,3451,3597,24.636986301369863,13 14 15,-1
85,w0,100,412,7,151,0,COMPLETED_WALLTIME_REACHED,4070,151,4221,3658,3809,25.225165562913908,3 4 8 9 13 14 15,-1
107,w0,100,499,3,146,0,COMPLETED_WALLTIME_REACHED,4072,146,4218,3573,3719,25.472602739726028,10 11 12,-1
88,w0,100,425,6,150,0,COMPLETED_WALLTIME_REACHED,4074,150,4224,3649,3799,25.326666666666668,0 1 2 5 6 7,-1
109,w0,100,517,3,151,0,COMPLETED_WALLTIME_REACHED,4218,151,4369,3701,3852,25.509933774834437,10 11 12,-1
89,w0,100,430,6,151,0,COMPLETED_WALLTIME_REACHED,4221,151,4372,3791,3942,26.105960264900663,3 4 8 9 13 14,-1
90,w0,100,432,5,150,0,COMPLETED_WALLTIME_REACHED,4224,150,4374,3792,3942,26.28,0 1 2 5 6,-1
92,w0,100,445,5,147,0,COMPLETED_WALLTIME_REACHED,4372,147,4519,3927,4074,27.714285714285715,3 4 8 9 13,-1
91,w0,100,432,5,150,0,COMPLETED_WALLTIME_REACHED,4374,150,4524,3942,4092,27.28,7 10 11 12 15,-1
93,w0,100,454,4,147,0,COMPLETED_WALLTIME_REACHED,4374,147,4521,3920,4067,27.666666666666668,0 1 2 5,-1
654,w0,100,3085,2,154,0,COMPLETED_WALLTIME_REACHED,4374,154,4528,1289,1443,9.37012987012987,6 14,-1
94,w0,100,456,5,151,0,COMPLETED_WALLTIME_REACHED,4519,151,4670,4063,4214,27.90728476821192,3 4 8 9 13,-1
95,w0,100,460,4,151,0,COMPLETED_WALLTIME_REACHED,4521,151,4672,4061,4212,27.894039735099337,0 1 2 5,-1
96,w0,100,462,6,149,0,COMPLETED_WALLTIME_REACHED,4528,149,4677,4066,4215,28.288590604026847,6 7 10 11 12 14,-1
97,w0,100,463,5,150,0,COMPLETED_WALLTIME_REACHED,4670,150,4820,4207,4357,29.046666666666667,3 4 8 9 13,-1
98,w0,100,465,4,147,0,COMPLETED_WALLTIME_REACHED,4672,147,4819,4207,4354,29.61904761904762,0 1 2 5,-1
99,w0,100,466,5,151,0,COMPLETED_WALLTIME_REACHED,4677,151,4828,4211,4362,28.887417218543046,6 7 10 11 12,-1
722,w0,100,3445,2,152,0,COMPLETED_WALLTIME_REACHED,4682,152,4834,1237,1389,9.138157894736842,14 15,-1
100,w0,100,467,4,148,0,COMPLETED_WALLTIME_REACHED,4819,148,4967,4352,4500,30.405405405405407,0 1 2 5,-1
101,w0,100,467,5,152,0,COMPLETED_WALLTIME_REACHED,4820,152,4972,4353,4505,29.638157894736842,3 4 8 9 13,-1
103,w0,100,478,5,147,0,COMPLETED_WALLTIME_REACHED,4828,147,4975,4350,4497,30.591836734693878,6 7 10 11 12,-1
104,w0,100,484,5,146,0,COMPLETED_WALLTIME_REACHED,4972,146,5118,4488,4634,31.73972602739726,0 1 2 5 14,-1
106,w0,100,493,5,152,0,COMPLETED_WALLTIME_REACHED,4975,152,5127,4482,4634,30.486842105263158,6 7 10 11 12,-1
105,w0,100,491,6,150,0,COMPLETED_WALLTIME_REACHED,4977,150,5127,4486,4636,30.906666666666666,3 4 8 9 13 15,-1
108,w0,100,512,5,153,0,COMPLETED_WALLTIME_REACHED,5118,153,5271,4606,4759,31.104575163398692,0 1 2 5 14,-1
110,w0,100,518,4,152,0,COMPLETED_WALLTIME_REACHED,5127,152,5279,4609,4761,31.32236842105263,3 4 6 7,-1
111,w0,100,519,3,147,0,COMPLETED_WALLTIME_REACHED,5127,147,5274,4608,4755,32.3469387755102,8 9 10,-1
112,w0,100,526,4,152,0,COMPLETED_WALLTIME_REACHED,5127,152,5279,4601,4753,31.269736842105264,11 12 13 15,-1
113,w0,100,528,5,150,0,COMPLETED_WALLTIME_REACHED,5271,150,5421,4743,4893,32.62,0 1 2 5 14,-1
120,w0,100,571,3,150,0,COMPLETED_WALLTIME_REACHED,5274,150,5424,4703,4853,32.35333333333333,8 9 10,-1
114,w0,100,532,6,150,0,COMPLETED_WALLTIME_REACHED,5279,150,5429,4747,4897,32.64666666666667,3 4 6 7 11 12,-1
777,w0,100,3729,2,148,0,COMPLETED_WALLTIME_REACHED,5279,148,5427,1550,1698,11.472972972972974,13 15,-1
115,w0,100,534,5,152,0,COMPLETED_WALLTIME_REACHED,5421,152,5573,4887,5039,33.151315789473685,0 1 2 5 14,-1
116,w0,100,543,5,150,0,COMPLETED_WALLTIME_REACHED,5427,150,5577,4884,5034,33.56,8 9 10 13 15,-1
117,w0,100,549,4,148,0,COMPLETED_WALLTIME_REACHED,5429,148,5577,4880,5028,33.972972972972975,3 4 6 7,-1
785,w0,100,3802,2,150,0,COMPLETED_WALLTIME_REACHED,5429,150,5579,1627,1777,11.846666666666666,11 12,-1
121,w0,100,578,5,147,0,COMPLETED_WALLTIME_REACHED,5573,147,5720,4995,5142,34.97959183673469,0 1 2 5 14,-1
122,w0,100,590,3,146,0,COMPLETED_WALLTIME_REACHED,5577,146,5723,4987,5133,35.157534246575345,3 4 6,-1
123,w0,100,590,5,145,0,COMPLETED_WALLTIME_REACHED,5577,145,5722,4987,5132,35.39310344827586,7 8 9 10 13,-1
126,w0,100,597,3,148,0,COMPLETED_WALLTIME_REACHED,5579,148,5727,4982,5130,34.66216216216216,11 12 15,-1
124,w0,100,591,5,149,0,COMPLETED_WALLTIME_REACHED,5720,149,5869,5129,5278,35.422818791946305,0 1 2 5 14,-1
125,w0,100,597,4,153,0,COMPLETED_WALLTIME_REACHED,5722,153,5875,5125,5278,34.49673202614379,7 8 9 10,-1
127,w0,100,600,4,151,0,COMPLETED_WALLTIME_REACHED,5723,151,5874,5123,5274,34.9271523178808,3 4 6 13,-1
129,w0,100,606,3,146,0,COMPLETED_WALLTIME_REACHED,5727,146,5873,5121,5267,36.07534246575342,11 12 15,-1
128,w0,100,604,4,149,0,COMPLETED_WALLTIME_REACHED,5869,149,6018,5265,5414,36.33557046979866,0 1 2 5,-1
811,w0,100,3929,2,152,0,COMPLETED_WALLTIME_REACHED,5873,152,6025,1944,2096,13.789473684210526,11 12,-1
130,w0,100,608,6,148,0,COMPLETED_WALLTIME_REACHED,5874,148,6022,5266,5414,36.58108108108108,3 4 6 13 14 15,-1
895,w0,100,4316,2,151,0,COMPLETED_WALLTIME_REACHED,5875,151,6026,1559,1710,11.324503311258278,7 8,-1
132,w0,100,614,5,148,0,COMPLETED_WALLTIME_REACHED,6022,148,6170,5408,5556,37.54054054054054,3 4 6 13 14,-1
131,w0,100,608,6,152,0,COMPLETED_WALLTIME_REACHED,6023,152,6175,5415,5567,36.625,0 1 2 5 9 10,-1
133,w0,100,617,5,150,0,COMPLETED_WALLTIME_REACHED,6026,150,6176,5409,5559,37.06,7 8 11 12 15,-1
134,w0,100,634,4,154,0,COMPLETED_WALLTIME_REACHED,6170,154,6324,5536,5690,36.94805194805195,3 4 6 13,-1
135,w0,100,635,4,151,0,COMPLETED_WALLTIME_REACHED,6175,151,6326,5540,5691,37.688741721854306,0 1 2 5,-1
139,w0,100,651,3,148,0,COMPLETED_WALLTIME_REACHED,6175,148,6323,5524,5672,38.32432432432432,9 10 14,-1
136,w0,100,636,4,148,0,COMPLETED_WALLTIME_REACHED,6176,148,6324,5540,5688,38.432432432432435,7 8 11 12,-1
137,w0,100,642,6,148,0,COMPLETED_WALLTIME_REACHED,6324,148,6472,5682,5830,39.391891891891895,3 4 6 7 8 11,-1
138,w0,100,643,5,150,0,COMPLETED_WALLTIME_REACHED,6326,150,6476,5683,5833,38.88666666666666,0 1 2 5 12,-1
142,w0,100,656,4,148,0,COMPLETED_WALLTIME_REACHED,6328,148,6476,5672,5820,39.32432432432432,9 10 14 15,-1
140,w0,100,652,5,150,0,COMPLETED_WALLTIME_REACHED,6472,150,6622,5820,5970,39.8,3 4 6 7 8,-1
141,w0,100,652,5,148,0,COMPLETED_WALLTIME_REACHED,6476,148,6624,5824,5972,40.351351351351354,0 1 2 5 9,-1
143,w0,100,657,4,149,0,COMPLETED_WALLTIME_REACHED,6476,149,6625,5819,5968,40.053691275167786,10 12 14 15,-1
934,w0,100,4483,2,150,0,COMPLETED_WALLTIME_REACHED,6477,150,6627,1994,2144,14.293333333333333,11 13,-1
144,w0,100,658,4,150,0,COMPLETED_WALLTIME_REACHED,6622,150,6772,5964,6114,40.76,3 4 6 7,-1
145,w0,100,661,3,153,0,COMPLETED_WALLTIME_REACHED,6624,153,6777,5963,6116,39.97385620915033,0 1 2,-1
146,w0,100,666,3,149,0,COMPLETED_WALLTIME_REACHED,6624,149,6773,5958,6107,40.986577181208055,5 8 9,-1
147,w0,100,667,4,146,0,COMPLETED_WALLTIME_REACHED,6625,146,6771,5958,6104,41.80821917808219,10 12 14 15,-1
993,w0,100,4861,2,150,0,COMPLETED_WALLTIME_REACHED,6627,150,6777,1766,1916,12.773333333333333,11 13,-1
148,w0,100,669,4,149,0,COMPLETED_WALLTIME_REACHED,6771,149,6920,6102,6251,41.95302013422819,10 12 14 15,-1
149,w0,100,676,5,146,0,COMPLETED_WALLTIME_REACHED,6773,146,6919,6097,6243,42.76027397260274,3 4 5 6 7,-1
150,w0,100,684,4,149,0,COMPLETED_WALLTIME_REACHED,6777,149,6926,6093,6242,41.89261744966443,0 1 2 8,-1
153,w0,100,698,3,149,0,COMPLETED_WALLTIME_REACHED,6777,149,6926,6079,6228,41.79865771812081,9 11 13,-1
151,w0,100,693,4,146,0,COMPLETED_WALLTIME_REACHED,6919,146,7065,6226,6372,43.64383561643836,3 4 5 6,-1
152,w0,100,695,4,154,0,COMPLETED_WALLTIME_REACHED,6920,154,7074,6225,6379,41.422077922077925,7 10 12 14,-1
154,w0,100,701,5,151,0,COMPLETED_WALLTIME_REACHED,6926,151,7077,6225,6376,42.22516556291391,0 1 2 8 9,-1
157,w0,100,732,3,149,0,COMPLETED_WALLTIME_REACHED,6926,149,7075,6194,6343,42.57046979865772,11 13 15,-1
155,w0,100,704,4,149,0,COMPLETED_WALLTIME_REACHED,7065,149,7214,6361,6510,43.691275167785236,3 4 5 6,-1
156,w0,100,716,4,151,0,COMPLETED_WALLTIME_REACHED,7074,151,7225,6358,6509,43.10596026490066,7 10 12 14,-1
162,w0,100,767,3,150,0,COMPLETED_WALLTIME_REACHED,7075,150,7225,6308,6458,43.053333333333335,11 13 15,-1
158,w0,100,746,5,151,0,COMPLETED_WALLTIME_REACHED,7077,151,7228,6331,6482,42.9271523178808,0 1 2 8 9,-1
163,w0,100,785,3,156,0,COMPLETED_WALLTIME_REACHED,7214,156,7370,6429,6585,42.21153846153846,3 4 5,-1
159,w0,100,752,5,147,0,COMPLETED_WALLTIME_REACHED,7225,147,7372,6473,6620,45.034013605442176,6 7 10 11 12,-1
179,w0,100,881,3,151,0,COMPLETED_WALLTIME_REACHED,7225,151,7376,6344,6495,43.01324503311258,13 14 15,-1
160,w0,100,763,5,145,0,COMPLETED_WALLTIME_REACHED,7228,145,7373,6465,6610,45.58620689655172,0 1 2 8 9,-1
181,w0,100,892,3,150,0,COMPLETED_WALLTIME_REACHED,7370,150,7520,6478,6628,44.18666666666667,3 4 5,-1
161,w0,100,766,5,152,0,COMPLETED_WALLTIME_REACHED,7372,152,7524,6606,6758,44.46052631578947,6 7 10 11 12,-1
164,w0,100,792,4,151,0,COMPLETED_WALLTIME_REACHED,7373,151,7524,6581,6732,44.58278145695364,0 1 2 8,-1
165,w0,100,797,4,151,0,COMPLETED_WALLTIME_REACHED,7376,151,7527,6579,6730,44.56953642384106,9 13 14 15,-1
185,w0,100,905,3,154,0,COMPLETED_WALLTIME_REACHED,7520,154,7674,6615,6769,43.95454545454545,3 4 5,-1
166,w0,100,799,4,152,0,COMPLETED_WALLTIME_REACHED,7524,152,7676,6725,6877,45.24342105263158,0 1 2 6,-1
167,w0,100,806,4,149,0,COMPLETED_WALLTIME_REACHED,7524,149,7673,6718,6867,46.08724832214765,7 8 10 11,-1
169,w0,100,820,4,146,0,COMPLETED_WALLTIME_REACHED,7527,146,7673,6707,6853,46.93835616438356,9 12 13 14,-1
171,w0,100,826,5,147,0,COMPLETED_WALLTIME_REACHED,7673,147,7820,6847,6994,47.57823129251701,7 8 9 10 11,-1
173,w0,100,838,5,153,0,COMPLETED_WALLTIME_REACHED,7674,153,7827,6836,6989,45.6797385620915,3 4 5 12 13,-1
174,w0,100,849,5,149,0,COMPLETED_WALLTIME_REACHED,7676,149,7825,6827,6976,46.81879194630873,0 1 2 6 14,-1
175,w0,100,852,4,149,0,COMPLETED_WALLTIME_REACHED,7820,149,7969,6968,7117,47.76510067114094,7 8 9 10,-1
176,w0,100,852,5,150,0,COMPLETED_WALLTIME_REACHED,7825,150,7975,6973,7123,47.486666666666665,0 1 2 6 11,-1
177,w0,100,869,4,155,0,COMPLETED_WALLTIME_REACHED,7827,155,7982,6958,7113,45.89032258064516,3 4 5 12,-1
178,w0,100,880,5,152,0,COMPLETED_WALLTIME_REACHED,7974,152,8126,7094,7246,47.671052631578945,7 8 9 10 13,-1
180,w0,100,891,5,153,0,COMPLETED_WALLTIME_REACHED,7975,153,8128,7084,7237,47.30065359477124,0 1 2 6 11,-1
182,w0,100,895,4,152,0,COMPLETED_WALLTIME_REACHED,7982,152,8134,7087,7239,47.625,3 4 5 12,-1
183,w0,100,899,5,151,0,COMPLETED_WALLTIME_REACHED,8126,151,8277,7227,7378,48.86092715231788,7 8 9 10 13,-1
184,w0,100,901,5,150,0,COMPLETED_WALLTIME_REACHED,8128,150,8278,7227,7377,49.18,0 1 2 6 11,-1
186,w0,100,907,4,147,0,COMPLETED_WALLTIME_REACHED,8134,147,8281,7227,7374,50.16326530612245,3 4 5 12,-1
187,w0,100,907,5,147,0,COMPLETED_WALLTIME_REACHED,8277,147,8424,7370,7517,51.136054421768705,7 8 9 10 13,-1
188,w0,100,912,6,149,0,COMPLETED_WALLTIME_REACHED,8283,149,8432,7371,7520,50.46979865771812,0 1 2 6 11 14,-1
189,w0,100,917,5,149,0,COMPLETED_WALLTIME_REACHED,8286,149,8435,7369,7518,50.45637583892618,3 4 5 12 15,-1
190,w0,100,925,5,149,0,COMPLETED_WALLTIME_REACHED,8424,149,8573,7499,7648,51.328859060402685,7 8 9 10 13,-1
191,w0,100,928,4,152,0,COMPLETED_WALLTIME_REACHED,8432,152,8584,7504,7656,50.36842105263158,0 1 2 6,-1
192,w0,100,933,6,149,0,COMPLETED_WALLTIME_REACHED,8435,149,8584,7502,7651,51.348993288590606,3 4 5 11 12 14,-1
193,w0,100,941,6,148,0,COMPLETED_WALLTIME_REACHED,8578,148,8726,7637,7785,52.601351351351354,7 8 9 10 13 15,-1
194,w0,100,943,5,149,0,COMPLETED_WALLTIME_REACHED,8584,149,8733,7641,7790,52.281879194630875,0 1 2 3 4,-1
195,w0,100,946,4,152,0,COMPLETED_WALLTIME_REACHED,8584,152,8736,7638,7790,51.25,5 6 11 12,-1
196,w0,100,950,5,151,0,COMPLETED_WALLTIME_REACHED,8726,151,8877,7776,7927,52.496688741721854,7 8 9 10 13,-1
197,w0,100,953,3,150,0,COMPLETED_WALLTIME_REACHED,8733,150,8883,7780,7930,52.86666666666667,0 1 2,-1
211,w0,100,1033,3,151,0,COMPLETED_WALLTIME_REACHED,8736,151,8887,7703,7854,52.01324503311258,5 6 11,-1
198,w0,100,965,4,151,0,COMPLETED_WALLTIME_REACHED,8738,151,8889,7773,7924,52.47682119205298,3 4 14 15,-1
199,w0,100,972,6,149,0,COMPLETED_WALLTIME_REACHED,8882,149,9031,7910,8059,54.08724832214765,7 8 9 10 12 13,-1
200,w0,100,977,4,150,0,COMPLETED_WALLTIME_REACHED,8887,150,9037,7910,8060,53.733333333333334,0 1 2 5,-1
201,w0,100,977,5,149,0,COMPLETED_WALLTIME_REACHED,8889,149,9038,7912,8061,54.100671140939596,3 4 6 11 14,-1
202,w0,100,978,5,153,0,COMPLETED_WALLTIME_REACHED,9031,153,9184,8053,8206,53.63398692810458,7 8 9 10 12,-1
203,w0,100,984,4,148,0,COMPLETED_WALLTIME_REACHED,9037,148,9185,8053,8201,55.41216216216216,0 1 2 5,-1
204,w0,100,999,5,151,0,COMPLETED_WALLTIME_REACHED,9038,151,9189,8039,8190,54.23841059602649,3 4 6 11 13,-1
205,w0,100,1005,5,148,0,COMPLETED_WALLTIME_REACHED,9184,148,9332,8179,8327,56.263513513513516,7 8 9 10 12,-1
207,w0,100,1023,4,153,0,COMPLETED_WALLTIME_REACHED,9189,153,9342,8166,8319,54.372549019607845,3 4 6 11,-1
206,w0,100,1014,5,150,0,COMPLETED_WALLTIME_REACHED,9190,150,9340,8176,8326,55.50666666666667,0 1 2 5 14,-1
208,w0,100,1025,4,154,0,COMPLETED_WALLTIME_REACHED,9332,154,9486,8307,8461,54.94155844155844,7 8 9 10,-1
218,w0,100,1064,3,152,0,COMPLETED_WALLTIME_REACHED,9337,152,9489,8273,8425,55.42763157894737,12 13 15,-1
209,w0,100,1032,5,146,0,COMPLETED_WALLTIME_REACHED,9340,146,9486,8308,8454,57.9041095890411,0 1 2 5 14,-1
213,w0,100,1037,4,152,0,COMPLETED_WALLTIME_REACHED,9342,152,9494,8305,8457,55.63815789473684,3 4 6 11,-1
210,w0,100,1032,5,147,0,COMPLETED_WALLTIME_REACHED,9486,147,9633,8454,8601,58.51020408163265,0 1 2 5 7,-1
212,w0,100,1034,5,147,0,COMPLETED_WALLTIME_REACHED,9489,147,9636,8455,8602,58.51700680272109,8 9 10 12 13,-1
214,w0,100,1042,4,150,0,COMPLETED_WALLTIME_REACHED,9494,150,9644,8452,8602,57.346666666666664,3 4 6 11,-1
216,w0,100,1045,4,150,0,COMPLETED_WALLTIME_REACHED,9636,150,9786,8591,8741,58.27333333333333,8 9 10 12,-1
215,w0,100,1042,6,147,0,COMPLETED_WALLTIME_REACHED,9638,147,9785,8596,8743,59.476190476190474,0 1 2 5 7 14,-1
217,w0,100,1052,5,148,0,COMPLETED_WALLTIME_REACHED,9644,148,9792,8592,8740,59.054054054054056,3 4 6 11 13,-1
219,w0,100,1065,4,147,0,COMPLETED_WALLTIME_REACHED,9785,147,9932,8720,8867,60.31972789115646,0 1 2 5,-1
220,w0,100,1079,4,148,0,COMPLETED_WALLTIME_REACHED,9786,148,9934,8707,8855,59.83108108108108,8 9 10 12,-1
255,w0,100,1277,3,151,0,COMPLETED_WALLTIME_REACHED,9790,151,9941,8513,8664,57.37748344370861,7 14 15,-1
221,w0,100,1086,7,149,0,COMPLETED_WALLTIME_REACHED,9937,149,10086,8851,9000,60.40268456375839,0 1 2 3 4 5 6,-1
222,w0,100,1087,6,148,0,COMPLETED_WALLTIME_REACHED,9939,148,10087,8852,9000,60.810810810810814,8 9 10 11 12 13,-1
256,w0,100,1279,3,149,0,COMPLETED_WALLTIME_REACHED,9941,149,10090,8662,8811,59.13422818791946,7 14 15,-1
223,w0,100,1096,4,150,0,COMPLETED_WALLTIME_REACHED,10086,150,10236,8990,9140,60.93333333333333,0 1 2 3,-1
257,w0,100,1283,3,154,0,COMPLETED_WALLTIME_REACHED,10086,154,10240,8803,8957,58.16233766233766,4 5 6,-1
224,w0,100,1097,6,150,0,COMPLETED_WALLTIME_REACHED,10087,150,10237,8990,9140,60.93333333333333,8 9 10 11 12 13,-1
582,w0,100,2768,3,146,0,COMPLETED_WALLTIME_REACHED,10090,146,10236,7322,7468,51.15068493150685,7 14 15,-1
225,w0,100,1107,5,148,0,COMPLETED_WALLTIME_REACHED,10236,148,10384,9129,9277,62.682432432432435,0 1 2 3 7,-1
226,w0,100,1114,4,151,0,COMPLETED_WALLTIME_REACHED,10237,151,10388,9123,9274,61.41721854304636,8 9 10 11,-1
227,w0,100,1115,5,150,0,COMPLETED_WALLTIME_REACHED,10240,150,10390,9125,9275,61.833333333333336,4 5 6 12 13,-1
228,w0,100,1121,4,148,0,COMPLETED_WALLTIME_REACHED,10384,148,10532,9263,9411,63.58783783783784,0 1 2 3,-1
229,w0,100,1123,4,151,0,COMPLETED_WALLTIME_REACHED,10388,151,10539,9265,9416,62.35761589403973,8 9 10 11,-1
258,w0,100,1297,3,148,0,COMPLETED_WALLTIME_REACHED,10389,148,10537,9092,9240,62.432432432432435,7 14 15,-1
230,w0,100,1124,5,150,0,COMPLETED_WALLTIME_REACHED,10390,150,10540,9266,9416,62.77333333333333,4 5 6 12 13,-1
231,w0,100,1127,4,151,0,COMPLETED_WALLTIME_REACHED,10532,151,10683,9405,9556,63.28476821192053,0 1 2 3,-1
267,w0,100,1331,3,148,0,COMPLETED_WALLTIME_REACHED,10537,148,10685,9206,9354,63.2027027027027,7 14 15,-1
232,w0,100,1134,4,152,0,COMPLETED_WALLTIME_REACHED,10539,152,10691,9405,9557,62.875,8 9 10 11,-1
233,w0,100,1143,5,149,0,COMPLETED_WALLTIME_REACHED,10540,149,10689,9397,9546,64.06711409395973,4 5 6 12 13,-1
234,w0,100,1151,6,147,0,COMPLETED_WALLTIME_REACHED,10685,147,10832,9534,9681,65.85714285714286,0 1 2 3 7 14,-1
235,w0,100,1159,4,147,0,COMPLETED_WALLTIME_REACHED,10689,147,10836,9530,9677,65.82993197278911,4 5 6 12,-1
236,w0,100,1171,4,148,0,COMPLETED_WALLTIME_REACHED,10691,148,10839,9520,9668,65.32432432432432,8 9 10 11,-1
237,w0,100,1172,6,150,0,COMPLETED_WALLTIME_REACHED,10837,150,10987,9665,9815,65.43333333333334,0 1 2 3 7 13,-1
239,w0,100,1183,4,148,0,COMPLETED_WALLTIME_REACHED,10839,148,10987,9656,9804,66.24324324324324,8 9 10 11,-1
238,w0,100,1179,6,150,0,COMPLETED_WALLTIME_REACHED,10841,150,10991,9662,9812,65.41333333333333,4 5 6 12 14 15,-1
240,w0,100,1185,5,148,0,COMPLETED_WALLTIME_REACHED,10987,148,11135,9802,9950,67.22972972972973,0 1 2 3 7,-1
241,w0,100,1195,4,151,0,COMPLETED_WALLTIME_REACHED,10987,151,11138,9792,9943,65.8476821192053,8 9 10 11,-1
242,w0,100,1198,4,149,0,COMPLETED_WALLTIME_REACHED,10991,149,11140,9793,9942,66.7248322147651,4 5 6 12,-1
269,w0,100,1339,3,152,0,COMPLETED_WALLTIME_REACHED,10991,152,11143,9652,9804,64.5,13 14 15,-1
243,w0,100,1216,5,151,0,COMPLETED_WALLTIME_REACHED,11135,151,11286,9919,10070,66.6887417218543,0 1 2 3 7,-1
272,w0,100,1350,3,149,0,COMPLETED_WALLTIME_REACHED,11138,149,11287,9788,9937,66.69127516778524,8 9 10,-1
244,w0,100,1219,5,149,0,COMPLETED_WALLTIME_REACHED,11140,149,11289,9921,10070,67.58389261744966,4 5 6 11 12,-1
280,w0,100,1392,3,150,0,COMPLETED_WALLTIME_REACHED,11143,150,11293,9751,9901,66.00666666666666,13 14 15,-1
245,w0,100,1233,4,152,0,COMPLETED_WALLTIME_REACHED,11286,152,11438,10053,10205,67.13815789473684,0 1 2 3,-1
249,w0,100,1250,4,149,0,COMPLETED_WALLTIME_REACHED,11287,149,11436,10037,10186,68.36241610738254,7 8 9 10,-1
246,w0,100,1237,5,151,0,COMPLETED_WALLTIME_REACHED,11289,151,11440,10052,10203,67.56953642384106,4 5 6 11 12,-1
262,w0,100,1315,4,150,0,COMPLETED_WALLTIME_REACHED,11440,150,11590,10125,10275,68.5,4 5 6 11,-1
247,w0,100,1246,5,148,0,COMPLETED_WALLTIME_REACHED,11441,148,11589,10195,10343,69.88513513513513,7 8 9 10 13,-1
248,w0,100,1248,5,149,0,COMPLETED_WALLTIME_REACHED,11443,149,11592,10195,10344,69.42281879194631,0 1 2 3 14,-1
273,w0,100,1361,4,150,0,COMPLETED_WALLTIME_REACHED,11590,150,11740,10229,10379,69.19333333333333,4 5 6 11,-1
251,w0,100,1267,5,150,0,COMPLETED_WALLTIME_REACHED,11592,150,11742,10325,10475,69.83333333333333,0 1 2 3 14,-1
250,w0,100,1254,7,150,0,COMPLETED_WALLTIME_REACHED,11594,150,11744,10340,10490,69.93333333333334,7 8 9 10 12 13 15,-1
276,w0,100,1379,4,148,0,COMPLETED_WALLTIME_REACHED,11740,148,11888,10361,10509,71.00675675675676,4 5 6 11,-1
252,w0,100,1270,5,150,0,COMPLETED_WALLTIME_REACHED,11742,150,11892,10472,10622,70.81333333333333,0 1 2 3 14,-1
253,w0,100,1272,6,150,0,COMPLETED_WALLTIME_REACHED,11744,150,11894,10472,10622,70.81333333333333,7 8 9 10 12 13,-1
283,w0,100,1413,3,149,0,COMPLETED_WALLTIME_REACHED,11888,149,12037,10475,10624,71.30201342281879,4 5 6,-1
259,w0,100,1298,6,151,0,COMPLETED_WALLTIME_REACHED,11892,151,12043,10594,10745,71.15894039735099,0 1 2 3 11 14,-1
260,w0,100,1307,5,150,0,COMPLETED_WALLTIME_REACHED,11894,150,12044,10587,10737,71.58,7 8 9 10 12,-1
261,w0,100,1311,5,152,0,COMPLETED_WALLTIME_REACHED,12042,152,12194,10731,10883,71.59868421052632,4 5 6 13 15,-1
263,w0,100,1317,6,150,0,COMPLETED_WALLTIME_REACHED,12043,150,12193,10726,10876,72.50666666666666,0 1 2 3 11 14,-1
265,w0,100,1326,5,152,0,COMPLETED_WALLTIME_REACHED,12044,152,12196,10718,10870,71.51315789473684,7 8 9 10 12,-1
268,w0,100,1335,6,149,0,COMPLETED_WALLTIME_REACHED,12193,149,12342,10858,11007,73.87248322147651,0 1 2 3 11 14,-1
287,w0,100,1439,3,149,0,COMPLETED_WALLTIME_REACHED,12194,149,12343,10755,10904,73.18120805369128,4 5 6,-1
270,w0,100,1343,6,150,0,COMPLETED_WALLTIME_REACHED,12196,150,12346,10853,11003,73.35333333333334,7 8 9 10 12 13,-1
271,w0,100,1347,5,153,0,COMPLETED_WALLTIME_REACHED,12342,153,12495,10995,11148,72.86274509803921,0 1 2 3 11,-1
274,w0,100,1366,6,148,0,COMPLETED_WALLTIME_REACHED,12346,148,12494,10980,11128,75.1891891891892,7 8 9 10 12 13,-1
275,w0,100,1373,5,150,0,COMPLETED_WALLTIME_REACHED,12348,150,12498,10975,11125,74.16666666666667,4 5 6 14 15,-1
277,w0,100,1385,5,149,0,COMPLETED_WALLTIME_REACHED,12494,149,12643,11109,11258,75.55704697986577,7 8 9 10 12,-1
278,w0,100,1385,5,149,0,COMPLETED_WALLTIME_REACHED,12495,149,12644,11110,11259,75.56375838926175,0 1 2 3 11,-1
279,w0,100,1387,5,148,0,COMPLETED_WALLTIME_REACHED,12498,148,12646,11111,11259,76.07432432432432,4 5 6 13 14,-1
281,w0,100,1396,5,152,0,COMPLETED_WALLTIME_REACHED,12643,152,12795,11247,11399,74.99342105263158,7 8 9 10 12,-1
288,w0,100,1439,4,150,0,COMPLETED_WALLTIME_REACHED,12646,150,12796,11207,11357,75.71333333333334,4 5 6 13,-1
282,w0,100,1399,6,150,0,COMPLETED_WALLTIME_REACHED,12649,150,12799,11250,11400,76.0,0 1 2 3 11 15,-1
290,w0,100,1457,3,151,0,COMPLETED_WALLTIME_REACHED,12796,151,12947,11339,11490,76.09271523178808,4 5 6,-1
285,w0,100,1428,6,146,0,COMPLETED_WALLTIME_REACHED,12799,146,12945,11371,11517,78.88356164383562,0 1 2 3 11 13,-1
284,w0,100,1427,6,147,0,COMPLETED_WALLTIME_REACHED,12800,147,12947,11373,11520,78.36734693877551,7 8 9 10 12 14,-1
286,w0,100,1429,6,152,0,COMPLETED_WALLTIME_REACHED,12945,152,13097,11516,11668,76.76315789473684,0 1 2 3 11 13,-1
289,w0,100,1448,5,148,0,COMPLETED_WALLTIME_REACHED,12947,148,13095,11499,11647,78.69594594594595,4 5 6 7 8,-1
291,w0,100,1459,5,152,0,COMPLETED_WALLTIME_REACHED,12952,152,13104,11493,11645,76.61184210526316,9 10 12 14 15,-1
292,w0,100,1467,4,149,0,COMPLETED_WALLTIME_REACHED,13095,149,13244,11628,11777,79.04026845637584,4 5 6 7,-1
293,w0,100,1471,5,152,0,COMPLETED_WALLTIME_REACHED,13097,152,13249,11626,11778,77.48684210526316,0 1 2 3 8,-1
294,w0,100,1472,5,151,0,COMPLETED_WALLTIME_REACHED,13104,151,13255,11632,11783,78.03311258278146,9 10 11 12 13,-1
295,w0,100,1477,5,154,0,COMPLETED_WALLTIME_REACHED,13249,154,13403,11772,11926,77.44155844155844,4 5 6 7 14,-1
296,w0,100,1480,5,145,0,COMPLETED_WALLTIME_REACHED,13249,145,13394,11769,11914,82.1655172413793,0 1 2 3 8,-1
297,w0,100,1481,6,150,0,COMPLETED_WALLTIME_REACHED,13260,150,13410,11779,11929,79.52666666666667,9 10 11 12 13 15,-1
298,w0,100,1487,4,152,0,COMPLETED_WALLTIME_REACHED,13394,152,13546,11907,12059,79.33552631578948,0 1 2 3,-1
299,w0,100,1488,6,148,0,COMPLETED_WALLTIME_REACHED,13403,148,13551,11915,12063,81.50675675675676,4 5 6 7 8 14,-1
300,w0,100,1492,4,154,0,COMPLETED_WALLTIME_REACHED,13410,154,13564,11918,12072,78.3896103896104,9 10 11 12,-1
301,w0,100,1503,6,150,0,COMPLETED_WALLTIME_REACHED,13551,150,13701,12048,12198,81.32,0 1 2 3 13 15,-1
302,w0,100,1507,5,152,0,COMPLETED_WALLTIME_REACHED,13551,152,13703,12044,12196,80.23684210526316,4 5 6 7 8,-1
303,w0,100,1514,5,151,0,COMPLETED_WALLTIME_REACHED,13564,151,13715,12050,12201,80.80132450331126,9 10 11 12 14,-1
304,w0,100,1518,5,148,0,COMPLETED_WALLTIME_REACHED,13701,148,13849,12183,12331,83.31756756756756,0 1 2 3 13,-1
305,w0,100,1521,6,151,0,COMPLETED_WALLTIME_REACHED,13703,151,13854,12182,12333,81.67549668874172,4 5 6 7 8 15,-1
308,w0,100,1530,4,149,0,COMPLETED_WALLTIME_REACHED,13715,149,13864,12185,12334,82.77852348993288,9 10 11 12,-1
306,w0,100,1522,6,151,0,COMPLETED_WALLTIME_REACHED,13854,151,14005,12332,12483,82.66887417218543,0 1 2 3 13 14,-1
307,w0,100,1529,5,149,0,COMPLETED_WALLTIME_REACHED,13854,149,14003,12325,12474,83.71812080536913,4 5 6 7 8,-1
309,w0,100,1537,4,150,0,COMPLETED_WALLTIME_REACHED,13864,150,14014,12327,12477,83.18,9 10 11 12,-1
310,w0,100,1542,3,148,0,COMPLETED_WALLTIME_REACHED,14003,148,14151,12461,12609,85.19594594594595,4 5 6,-1
311,w0,100,1542,6,146,0,COMPLETED_WALLTIME_REACHED,14005,146,14151,12463,12609,86.36301369863014,0 1 2 3 13 14,-1
318,w0,100,1562,3,148,0,COMPLETED_WALLTIME_REACHED,14008,148,14156,12446,12594,85.0945945945946,7 8 15,-1
313,w0,100,1551,4,151,0,COMPLETED_WALLTIME_REACHED,14014,151,14165,12463,12614,83.5364238410596,9 10 11 12,-1
312,w0,100,1544,5,148,0,COMPLETED_WALLTIME_REACHED,14151,148,14299,12607,12755,86.18243243243244,0 1 2 3 4,-1
314,w0,100,1552,4,150,0,COMPLETED_WALLTIME_REACHED,14151,150,14301,12599,12749,84.99333333333334,5 6 13 14,-1
325,w0,100,1610,3,151,0,COMPLETED_WALLTIME_REACHED,14156,151,14307,12546,12697,84.08609271523179,7 8 15,-1
315,w0,100,1553,4,150,0,COMPLETED_WALLTIME_REACHED,14165,150,14315,12612,12762,85.08,9 10 11 12,-1
339,w0,100,1686,3,152,0,COMPLETED_WALLTIME_REACHED,14299,152,14451,12613,12765,83.98026315789474,0 1 2,-1
316,w0,100,1557,6,149,0,COMPLETED_WALLTIME_REACHED,14301,149,14450,12744,12893,86.53020134228188,3 4 5 6 13 14,-1
354,w0,100,1751,3,155,0,COMPLETED_WALLTIME_REACHED,14307,155,14462,12556,12711,82.00645161290322,7 8 15,-1
317,w0,100,1560,4,148,0,COMPLETED_WALLTIME_REACHED,14315,148,14463,12755,12903,87.18243243243244,9 10 11 12,-1
319,w0,100,1566,4,149,0,COMPLETED_WALLTIME_REACHED,14450,149,14599,12884,13033,87.46979865771812,3 4 5 6,-1
320,w0,100,1568,5,147,0,COMPLETED_WALLTIME_REACHED,14451,147,14598,12883,13030,88.63945578231292,0 1 2 13 14,-1
380,w0,100,1865,3,150,0,COMPLETED_WALLTIME_REACHED,14462,150,14612,12597,12747,84.98,7 8 15,-1
321,w0,100,1587,4,149,0,COMPLETED_WALLTIME_REACHED,14463,149,14612,12876,13025,87.41610738255034,9 10 11 12,-1
388,w0,100,1933,3,150,0,COMPLETED_WALLTIME_REACHED,14598,150,14748,12665,12815,85.43333333333334,0 1 2,-1
322,w0,100,1588,6,153,0,COMPLETED_WALLTIME_REACHED,14599,153,14752,13011,13164,86.03921568627452,3 4 5 6 13 14,-1
323,w0,100,1591,5,152,0,COMPLETED_WALLTIME_REACHED,14612,152,14764,13021,13173,86.66447368421052,7 8 9 10 11,-1
324,w0,100,1595,4,153,0,COMPLETED_WALLTIME_REACHED,14753,153,14906,13158,13311,87.0,0 1 2 12,-1
326,w0,100,1610,7,148,0,COMPLETED_WALLTIME_REACHED,14757,148,14905,13147,13295,89.83108108108108,3 4 5 6 13 14 15,-1
329,w0,100,1641,4,149,0,COMPLETED_WALLTIME_REACHED,14764,149,14913,13123,13272,89.0738255033557,7 8 9 10,-1
328,w0,100,1620,6,148,0,COMPLETED_WALLTIME_REACHED,14906,148,15054,13286,13434,90.77027027027027,0 1 2 12 14 15,-1
327,w0,100,1613,6,151,0,COMPLETED_WALLTIME_REACHED,14910,151,15061,13297,13448,89.05960264900662,3 4 5 6 11 13,-1
331,w0,100,1648,4,147,0,COMPLETED_WALLTIME_REACHED,14913,147,15060,13265,13412,91.23809523809524,7 8 9 10,-1
330,w0,100,1647,5,148,0,COMPLETED_WALLTIME_REACHED,15054,148,15202,13407,13555,91.58783783783784,0 1 2 12 14,-1
332,w0,100,1651,4,152,0,COMPLETED_WALLTIME_REACHED,15060,152,15212,13409,13561,89.21710526315789,7 8 9 10,-1
333,w0,100,1663,4,154,0,COMPLETED_WALLTIME_REACHED,15061,154,15215,13398,13552,88.0,3 4 5 6,-1
397,w0,100,1982,3,150,0,COMPLETED_WALLTIME_REACHED,15061,150,15211,13079,13229,88.19333333333333,11 13 15,-1
334,w0,100,1663,5,148,0,COMPLETED_WALLTIME_REACHED,15202,148,15350,13539,13687,92.47972972972973,0 1 2 12 14,-1
400,w0,100,1989,3,152,0,COMPLETED_WALLTIME_REACHED,15211,152,15363,13222,13374,87.98684210526316,11 13 15,-1
336,w0,100,1666,4,152,0,COMPLETED_WALLTIME_REACHED,15212,152,15364,13546,13698,90.11842105263158,7 8 9 10,-1
337,w0,100,1666,4,151,0,COMPLETED_WALLTIME_REACHED,15215,151,15366,13549,13700,90.72847682119205,3 4 5 6,-1
338,w0,100,1674,5,150,0,COMPLETED_WALLTIME_REACHED,15350,150,15500,13676,13826,92.17333333333333,0 1 2 12 14,-1
402,w0,100,1996,3,149,0,COMPLETED_WALLTIME_REACHED,15363,149,15512,13367,13516,90.71140939597315,11 13 15,-1
340,w0,100,1687,4,149,0,COMPLETED_WALLTIME_REACHED,15364,149,15513,13677,13826,92.79194630872483,7 8 9 10,-1
341,w0,100,1691,4,147,0,COMPLETED_WALLTIME_REACHED,15366,147,15513,13675,13822,94.02721088435374,3 4 5 6,-1
342,w0,100,1708,4,151,0,COMPLETED_WALLTIME_REACHED,15500,151,15651,13792,13943,92.33774834437087,0 1 2 12,-1
349,w0,100,1741,4,148,0,COMPLETED_WALLTIME_REACHED,15512,148,15660,13771,13919,94.04729729729729,11 13 14 15,-1
343,w0,100,1709,5,150,0,COMPLETED_WALLTIME_REACHED,15513,150,15663,13804,13954,93.02666666666667,3 4 5 6 7,-1
344,w0,100,1710,5,147,0,COMPLETED_WALLTIME_REACHED,15656,147,15803,13946,14093,95.87074829931973,0 1 2 8 9,-1
350,w0,100,1742,4,147,0,COMPLETED_WALLTIME_REACHED,15663,147,15810,13921,14068,95.70068027210884,3 4 5 6,-1
345,w0,100,1715,6,149,0,COMPLETED_WALLTIME_REACHED,15665,149,15814,13950,14099,94.6241610738255,10 11 12 13 14 15,-1
346,w0,100,1717,6,149,0,COMPLETED_WALLTIME_REACHED,15808,149,15957,14091,14240,95.57046979865771,0 1 2 7 8 9,-1
357,w0,100,1762,4,148,0,COMPLETED_WALLTIME_REACHED,15810,148,15958,14048,14196,95.91891891891892,3 4 5 6,-1
347,w0,100,1721,5,149,0,COMPLETED_WALLTIME_REACHED,15814,149,15963,14093,14242,95.58389261744966,10 11 12 13 14,-1
348,w0,100,1725,5,150,0,COMPLETED_WALLTIME_REACHED,15957,150,16107,14232,14382,95.88,0 1 2 7 8,-1
351,w0,100,1742,6,153,0,COMPLETED_WALLTIME_REACHED,15963,153,16116,14221,14374,93.94771241830065,3 4 5 6 9 15,-1
352,w0,100,1744,5,149,0,COMPLETED_WALLTIME_REACHED,15963,149,16112,14219,14368,96.42953020134229,10 11 12 13 14,-1
353,w0,100,1746,5,152,0,COMPLETED_WALLTIME_REACHED,16107,152,16259,14361,14513,95.48026315789474,0 1 2 7 8,-1
355,w0,100,1753,5,150,0,COMPLETED_WALLTIME_REACHED,16112,150,16262,14359,14509,96.72666666666667,10 11 12 13 14,-1
356,w0,100,1762,5,151,0,COMPLETED_WALLTIME_REACHED,16116,151,16267,14354,14505,96.05960264900662,3 4 5 6 9,-1
358,w0,100,1764,5,151,0,COMPLETED_WALLTIME_REACHED,16259,151,16410,14495,14646,96.99337748344371,0 1 2 7 8,-1
359,w0,100,1770,5,152,0,COMPLETED_WALLTIME_REACHED,16262,152,16414,14492,14644,96.34210526315789,10 11 12 13 14,-1
360,w0,100,1772,4,150,0,COMPLETED_WALLTIME_REACHED,16267,150,16417,14495,14645,97.63333333333334,3 4 5 6,-1
361,w0,100,1773,4,149,0,COMPLETED_WALLTIME_REACHED,16410,149,16559,14637,14786,99.23489932885906,0 1 2 7,-1
363,w0,100,1776,4,152,0,COMPLETED_WALLTIME_REACHED,16417,152,16569,14641,14793,97.32236842105263,3 4 5 6,-1
362,w0,100,1775,6,150,0,COMPLETED_WALLTIME_REACHED,16419,150,16569,14644,14794,98.62666666666667,8 9 10 11 12 13,-1
364,w0,100,1780,4,149,0,COMPLETED_WALLTIME_REACHED,16559,149,16708,14779,14928,100.18791946308725,0 1 2 7,-1
365,w0,100,1783,5,148,0,COMPLETED_WALLTIME_REACHED,16569,148,16717,14786,14934,100.9054054054054,3 4 5 6 8,-1
366,w0,100,1793,6,151,0,COMPLETED_WALLTIME_REACHED,16574,151,16725,14781,14932,98.88741721854305,9 10 11 12 13 14,-1
367,w0,100,1794,4,151,0,COMPLETED_WALLTIME_REACHED,16708,151,16859,14914,15065,99.76821192052981,0 1 2 7,-1
368,w0,100,1795,4,155,0,COMPLETED_WALLTIME_REACHED,16717,155,16872,14922,15077,97.27096774193548,3 4 5 6,-1
369,w0,100,1797,5,149,0,COMPLETED_WALLTIME_REACHED,16725,149,16874,14928,15077,101.18791946308725,8 9 10 11 12,-1
410,w0,100,2012,3,151,0,COMPLETED_WALLTIME_REACHED,16730,151,16881,14718,14869,98.47019867549669,13 14 15,-1
370,w0,100,1804,4,151,0,COMPLETED_WALLTIME_REACHED,16859,151,17010,15055,15206,100.70198675496688,0 1 2 7,-1
378,w0,100,1853,4,153,0,COMPLETED_WALLTIME_REACHED,16872,153,17025,15019,15172,99.16339869281046,3 4 5 6,-1
371,w0,100,1819,5,151,0,COMPLETED_WALLTIME_REACHED,16874,151,17025,15055,15206,100.70198675496688,8 9 10 11 12,-1
372,w0,100,1819,5,148,0,COMPLETED_WALLTIME_REACHED,17015,148,17163,15196,15344,103.67567567567568,0 1 2 7 13,-1
373,w0,100,1832,5,146,0,COMPLETED_WALLTIME_REACHED,17025,146,17171,15193,15339,105.06164383561644,3 4 5 6 8,-1
374,w0,100,1835,5,149,0,COMPLETED_WALLTIME_REACHED,17030,149,17179,15195,15344,102.97986577181209,9 10 11 12 14,-1
376,w0,100,1844,5,151,0,COMPLETED_WALLTIME_REACHED,17163,151,17314,15319,15470,102.45033112582782,0 1 2 7 13,-1
377,w0,100,1847,5,148,0,COMPLETED_WALLTIME_REACHED,17171,148,17319,15324,15472,104.54054054054055,3 4 5 6 8,-1
379,w0,100,1854,4,149,0,COMPLETED_WALLTIME_REACHED,17179,149,17328,15325,15474,103.85234899328859,9 10 11 12,-1
381,w0,100,1868,5,153,0,COMPLETED_WALLTIME_REACHED,17314,153,17467,15446,15599,101.95424836601308,0 1 2 7 13,-1
382,w0,100,1874,4,150,0,COMPLETED_WALLTIME_REACHED,17319,150,17469,15445,15595,103.96666666666667,3 4 5 6,-1
427,w0,100,2097,3,148,0,COMPLETED_WALLTIME_REACHED,17324,148,17472,15227,15375,103.88513513513513,8 14 15,-1
383,w0,100,1876,4,152,0,COMPLETED_WALLTIME_REACHED,17328,152,17480,15452,15604,102.65789473684211,9 10 11 12,-1
384,w0,100,1878,5,150,0,COMPLETED_WALLTIME_REACHED,17467,150,17617,15589,15739,104.92666666666666,0 1 2 7 13,-1
385,w0,100,1886,4,151,0,COMPLETED_WALLTIME_REACHED,17469,151,17620,15583,15734,104.19867549668874,3 4 5 6,-1
386,w0,100,1894,5,152,0,COMPLETED_WALLTIME_REACHED,17480,152,17632,15586,15738,103.53947368421052,8 9 10 11 12,-1
387,w0,100,1904,5,151,0,COMPLETED_WALLTIME_REACHED,17617,151,17768,15713,15864,105.05960264900662,0 1 2 7 13,-1
389,w0,100,1936,5,148,0,COMPLETED_WALLTIME_REACHED,17625,148,17773,15689,15837,107.00675675675676,3 4 5 6 14,-1
390,w0,100,1939,4,148,0,COMPLETED_WALLTIME_REACHED,17632,148,17780,15693,15841,107.03378378378379,8 9 10 11,-1
391,w0,100,1951,4,150,0,COMPLETED_WALLTIME_REACHED,17768,150,17918,15817,15967,106.44666666666667,0 1 2 7,-1
392,w0,100,1958,6,149,0,COMPLETED_WALLTIME_REACHED,17778,149,17927,15820,15969,107.1744966442953,3 4 5 6 12 13,-1
393,w0,100,1959,8,148,0,COMPLETED_WALLTIME_REACHED,17923,148,18071,15964,16112,108.86486486486487,0 1 2 7 8 9 10 11,-1
395,w0,100,1970,5,155,0,COMPLETED_WALLTIME_REACHED,17927,155,18082,15957,16112,103.9483870967742,3 4 5 6 12,-1
429,w0,100,2100,3,149,0,COMPLETED_WALLTIME_REACHED,17932,149,18081,15832,15981,107.25503355704699,13 14 15,-1
396,w0,100,1977,5,153,0,COMPLETED_WALLTIME_REACHED,18071,153,18224,16094,16247,106.18954248366013,0 1 2 7 8,-1
398,w0,100,1986,4,150,0,COMPLETED_WALLTIME_REACHED,18081,150,18231,16095,16245,108.3,9 10 11 13,-1
399,w0,100,1988,4,149,0,COMPLETED_WALLTIME_REACHED,18082,149,18231,16094,16243,109.01342281879195,3 4 5 6,-1
448,w0,100,2195,3,150,0,COMPLETED_WALLTIME_REACHED,18082,150,18232,15887,16037,106.91333333333333,12 14 15,-1
401,w0,100,1994,4,146,0,COMPLETED_WALLTIME_REACHED,18224,146,18370,16230,16376,112.16438356164383,0 1 2 7,-1
403,w0,100,1997,7,148,0,COMPLETED_WALLTIME_REACHED,18231,148,18379,16234,16382,110.6891891891892,3 4 5 6 8 9 10,-1
404,w0,100,1998,5,147,0,COMPLETED_WALLTIME_REACHED,18232,147,18379,16234,16381,111.43537414965986,11 12 13 14 15,-1
405,w0,100,2000,4,149,0,COMPLETED_WALLTIME_REACHED,18370,149,18519,16370,16519,110.86577181208054,0 1 2 7,-1
406,w0,100,2001,7,149,0,COMPLETED_WALLTIME_REACHED,18379,149,18528,16378,16527,110.91946308724832,3 4 5 6 8 9 10,-1
407,w0,100,2002,5,153,0,COMPLETED_WALLTIME_REACHED,18379,153,18532,16377,16530,108.03921568627452,11 12 13 14 15,-1
412,w0,100,2024,4,150,0,COMPLETED_WALLTIME_REACHED,18519,150,18669,16495,16645,110.96666666666667,0 1 2 7,-1
408,w0,100,2005,5,150,0,COMPLETED_WALLTIME_REACHED,18528,150,18678,16523,16673,111.15333333333334,3 4 5 6 8,-1
409,w0,100,2006,5,148,0,COMPLETED_WALLTIME_REACHED,18532,148,18680,16526,16674,112.66216216216216,9 10 11 12 13,-1
411,w0,100,2012,6,151,0,COMPLETED_WALLTIME_REACHED,18674,151,18825,16662,16813,111.34437086092716,0 1 2 7 14 15,-1
413,w0,100,2027,5,149,0,COMPLETED_WALLTIME_REACHED,18678,149,18827,16651,16800,112.75167785234899,3 4 5 6 8,-1
414,w0,100,2030,4,147,0,COMPLETED_WALLTIME_REACHED,18680,147,18827,16650,16797,114.26530612244898,9 10 11 12,-1
416,w0,100,2050,5,148,0,COMPLETED_WALLTIME_REACHED,18827,148,18975,16777,16925,114.35810810810811,3 4 5 6 8,-1
417,w0,100,2055,4,152,0,COMPLETED_WALLTIME_REACHED,18827,152,18979,16772,16924,111.34210526315789,9 10 11 12,-1
415,w0,100,2042,5,149,0,COMPLETED_WALLTIME_REACHED,18830,149,18979,16788,16937,113.67114093959732,0 1 2 7 13,-1
418,w0,100,2061,4,151,0,COMPLETED_WALLTIME_REACHED,18975,151,19126,16914,17065,113.01324503311258,3 4 5 6,-1
419,w0,100,2071,5,151,0,COMPLETED_WALLTIME_REACHED,18979,151,19130,16908,17059,112.97350993377484,0 1 2 7 9,-1
420,w0,100,2071,4,148,0,COMPLETED_WALLTIME_REACHED,18979,148,19127,16908,17056,115.24324324324324,10 11 12 13,-1
449,w0,100,2197,3,150,0,COMPLETED_WALLTIME_REACHED,18980,150,19130,16783,16933,112.88666666666667,8 14 15,-1
421,w0,100,2072,4,152,0,COMPLETED_WALLTIME_REACHED,19126,152,19278,17054,17206,113.19736842105263,3 4 5 6,-1
423,w0,100,2082,4,151,0,COMPLETED_WALLTIME_REACHED,19127,151,19278,17045,17196,113.88079470198676,10 11 12 13,-1
422,w0,100,2077,6,151,0,COMPLETED_WALLTIME_REACHED,19130,151,19281,17053,17204,113.93377483443709,0 1 2 7 8 9,-1
424,w0,100,2088,5,149,0,COMPLETED_WALLTIME_REACHED,19278,149,19427,17190,17339,116.36912751677852,3 4 5 6 10,-1
426,w0,100,2095,6,151,0,COMPLETED_WALLTIME_REACHED,19281,151,19432,17186,17337,114.81456953642385,0 1 2 7 8 9,-1
425,w0,100,2093,5,151,0,COMPLETED_WALLTIME_REACHED,19283,151,19434,17190,17341,114.84105960264901,11 12 13 14 15,-1
428,w0,100,2099,5,148,0,COMPLETED_WALLTIME_REACHED,19427,148,19575,17328,17476,118.08108108108108,3 4 5 6 10,-1
430,w0,100,2105,4,149,0,COMPLETED_WALLTIME_REACHED,19432,149,19581,17327,17476,117.28859060402685,0 1 2 7,-1
431,w0,100,2114,5,150,0,COMPLETED_WALLTIME_REACHED,19434,150,19584,17320,17470,116.46666666666667,8 9 11 12 13,-1
432,w0,100,2124,5,150,0,COMPLETED_WALLTIME_REACHED,19575,150,19725,17451,17601,117.34,3 4 5 6 10,-1
433,w0,100,2129,4,148,0,COMPLETED_WALLTIME_REACHED,19581,148,19729,17452,17600,118.91891891891892,0 1 2 7,-1
434,w0,100,2131,5,148,0,COMPLETED_WALLTIME_REACHED,19584,148,19732,17453,17601,118.92567567567568,8 9 11 12 13,-1
435,w0,100,2131,4,150,0,COMPLETED_WALLTIME_REACHED,19725,150,19875,17594,17744,118.29333333333334,3 4 5 6,-1
436,w0,100,2142,5,152,0,COMPLETED_WALLTIME_REACHED,19729,152,19881,17587,17739,116.70394736842105,0 1 2 7 10,-1
437,w0,100,2145,6,152,0,COMPLETED_WALLTIME_REACHED,19737,152,19889,17592,17744,116.73684210526316,8 9 11 12 13 14,-1
438,w0,100,2147,5,150,0,COMPLETED_WALLTIME_REACHED,19880,150,20030,17733,17883,119.22,3 4 5 6 15,-1
439,w0,100,2148,4,146,0,COMPLETED_WALLTIME_REACHED,19881,146,20027,17733,17879,122.45890410958904,0 1 2 7,-1
440,w0,100,2155,5,152,0,COMPLETED_WALLTIME_REACHED,19889,152,20041,17734,17886,117.67105263157895,8 9 10 11 12,-1
441,w0,100,2156,4,150,0,COMPLETED_WALLTIME_REACHED,20027,150,20177,17871,18021,120.14,0 1 2 7,-1
442,w0,100,2157,6,146,0,COMPLETED_WALLTIME_REACHED,20035,146,20181,17878,18024,123.45205479452055,3 4 5 6 13 14,-1
443,w0,100,2168,4,151,0,COMPLETED_WALLTIME_REACHED,20041,151,20192,17873,18024,119.36423841059603,8 9 10 11,-1
445,w0,100,2181,4,154,0,COMPLETED_WALLTIME_REACHED,20181,154,20335,18000,18154,117.88311688311688,3 4 5 6,-1
444,w0,100,2169,5,147,0,COMPLETED_WALLTIME_REACHED,20182,147,20329,18013,18160,123.5374149659864,0 1 2 7 12,-1
446,w0,100,2184,6,149,0,COMPLETED_WALLTIME_REACHED,20192,149,20341,18008,18157,121.85906040268456,8 9 10 11 13 14,-1
447,w0,100,2192,6,150,0,COMPLETED_WALLTIME_REACHED,20334,150,20484,18142,18292,121.94666666666667,0 1 2 7 12 15,-1
451,w0,100,2204,3,149,0,COMPLETED_WALLTIME_REACHED,20335,149,20484,18131,18280,122.68456375838926,3 4 5,-1
450,w0,100,2202,6,150,0,COMPLETED_WALLTIME_REACHED,20341,150,20491,18139,18289,121.92666666666666,6 8 9 10 11 13,-1
452,w0,100,2210,3,152,0,COMPLETED_WALLTIME_REACHED,20484,152,20636,18274,18426,121.22368421052632,0 1 2,-1
453,w0,100,2214,4,150,0,COMPLETED_WALLTIME_REACHED,20484,150,20634,18270,18420,122.8,3 4 5 7,-1
464,w0,100,2279,3,150,0,COMPLETED_WALLTIME_REACHED,20489,150,20639,18210,18360,122.4,12 14 15,-1
454,w0,100,2220,4,149,0,COMPLETED_WALLTIME_REACHED,20491,149,20640,18271,18420,123.6241610738255,6 8 9 10,-1
455,w0,100,2223,5,149,0,COMPLETED_WALLTIME_REACHED,20639,149,20788,18416,18565,124.59731543624162,3 4 5 7 11,-1
457,w0,100,2238,5,149,0,COMPLETED_WALLTIME_REACHED,20640,149,20789,18402,18551,124.50335570469798,6 8 9 10 14,-1
456,w0,100,2234,5,149,0,COMPLETED_WALLTIME_REACHED,20644,149,20793,18410,18559,124.55704697986577,0 1 2 12 13,-1
459,w0,100,2249,4,149,0,COMPLETED_WALLTIME_REACHED,20789,149,20938,18540,18689,125.42953020134229,6 8 9 10,-1
458,w0,100,2239,6,149,0,COMPLETED_WALLTIME_REACHED,20793,149,20942,18554,18703,125.52348993288591,3 4 5 7 11 15,-1
460,w0,100,2249,4,153,0,COMPLETED_WALLTIME_REACHED,20793,153,20946,18544,18697,122.20261437908496,0 1 2 12,-1
462,w0,100,2261,4,146,0,COMPLETED_WALLTIME_REACHED,20942,146,21088,18681,18827,128.95205479452054,3 4 5 7,-1
461,w0,100,2252,6,148,0,COMPLETED_WALLTIME_REACHED,20943,148,21091,18691,18839,127.29054054054055,6 8 9 10 13 14,-1
463,w0,100,2261,5,151,0,COMPLETED_WALLTIME_REACHED,20946,151,21097,18685,18836,124.74172185430463,0 1 2 11 12,-1
465,w0,100,2285,4,151,0,COMPLETED_WALLTIME_REACHED,21088,151,21239,18803,18954,125.52317880794702,3 4 5 7,-1
466,w0,100,2298,4,149,0,COMPLETED_WALLTIME_REACHED,21091,149,21240,18793,18942,127.12751677852349,6 8 9 10,-1
486,w0,100,2358,3,151,0,COMPLETED_WALLTIME_REACHED,21096,151,21247,18738,18889,125.09271523178808,13 14 15,-1
467,w0,100,2301,5,151,0,COMPLETED_WALLTIME_REACHED,21097,151,21248,18796,18947,125.47682119205298,0 1 2 11 12,-1
468,w0,100,2302,6,150,0,COMPLETED_WALLTIME_REACHED,21240,150,21390,18938,19088,127.25333333333333,3 4 5 6 7 8,-1
472,w0,100,2308,4,150,0,COMPLETED_WALLTIME_REACHED,21247,150,21397,18939,19089,127.26,9 10 13 14,-1
469,w0,100,2304,6,149,0,COMPLETED_WALLTIME_REACHED,21248,149,21397,18944,19093,128.14093959731542,0 1 2 11 12 15,-1
471,w0,100,2305,5,148,0,COMPLETED_WALLTIME_REACHED,21390,148,21538,19085,19233,129.9527027027027,3 4 5 6 7,-1
473,w0,100,2309,5,152,0,COMPLETED_WALLTIME_REACHED,21397,152,21549,19088,19240,126.57894736842105,0 1 2 8 9,-1
474,w0,100,2313,4,150,0,COMPLETED_WALLTIME_REACHED,21397,150,21547,19084,19234,128.22666666666666,10 11 12 13,-1
475,w0,100,2318,7,152,0,COMPLETED_WALLTIME_REACHED,21543,152,21695,19225,19377,127.48026315789474,3 4 5 6 7 14 15,-1
478,w0,100,2330,4,150,0,COMPLETED_WALLTIME_REACHED,21547,150,21697,19217,19367,129.11333333333334,10 11 12 13,-1
476,w0,100,2321,5,153,0,COMPLETED_WALLTIME_REACHED,21549,153,21702,19228,19381,126.67320261437908,0 1 2 8 9,-1
477,w0,100,2329,5,150,0,COMPLETED_WALLTIME_REACHED,21695,150,21845,19366,19516,130.10666666666665,3 4 5 6 7,-1
479,w0,100,2332,6,145,0,COMPLETED_WALLTIME_REACHED,21697,145,21842,19365,19510,134.55172413793105,10 11 12 13 14 15,-1
481,w0,100,2342,5,147,0,COMPLETED_WALLTIME_REACHED,21702,147,21849,19360,19507,132.70068027210885,0 1 2 8 9,-1
480,w0,100,2339,6,149,0,COMPLETED_WALLTIME_REACHED,21842,149,21991,19503,19652,131.89261744966444,10 11 12 13 14 15,-1
485,w0,100,2355,4,150,0,COMPLETED_WALLTIME_REACHED,21845,150,21995,19490,19640,130.93333333333334,3 4 5 6,-1
482,w0,100,2344,6,150,0,COMPLETED_WALLTIME_REACHED,21849,150,21999,19505,19655,131.03333333333333,0 1 2 7 8 9,-1
483,w0,100,2347,5,152,0,COMPLETED_WALLTIME_REACHED,21991,152,22143,19644,19796,130.23684210526315,10 11 12 13 14,-1
487,w0,100,2360,5,149,0,COMPLETED_WALLTIME_REACHED,21995,149,22144,19635,19784,132.7785234899329,3 4 5 6 15,-1
484,w0,100,2352,6,155,0,COMPLETED_WALLTIME_REACHED,21999,155,22154,19647,19802,127.75483870967741,0 1 2 7 8 9,-1
488,w0,100,2367,4,149,0,COMPLETED_WALLTIME_REACHED,22143,149,22292,19776,19925,133.7248322147651,10 11 12 13,-1
489,w0,100,2367,5,148,0,COMPLETED_WALLTIME_REACHED,22144,148,22292,19777,19925,134.6283783783784,3 4 5 6 14,-1
490,w0,100,2369,4,151,0,COMPLETED_WALLTIME_REACHED,22154,151,22305,19785,19936,132.02649006622516,0 1 2 7,-1
496,w0,100,2390,3,150,0,COMPLETED_WALLTIME_REACHED,22154,150,22304,19764,19914,132.76,8 9 15,-1
491,w0,100,2374,4,150,0,COMPLETED_WALLTIME_REACHED,22292,150,22442,19918,20068,133.78666666666666,3 4 5 6,-1
492,w0,100,2375,5,151,0,COMPLETED_WALLTIME_REACHED,22292,151,22443,19917,20068,132.90066225165563,10 11 12 13 14,-1
493,w0,100,2385,5,150,0,COMPLETED_WALLTIME_REACHED,22305,150,22455,19920,20070,133.8,0 1 2 7 8,-1
494,w0,100,2386,4,151,0,COMPLETED_WALLTIME_REACHED,22442,151,22593,20056,20207,133.82119205298014,3 4 5 6,-1
495,w0,100,2390,4,154,0,COMPLETED_WALLTIME_REACHED,22448,154,22602,20058,20212,131.24675324675326,9 10 11 12,-1
499,w0,100,2397,3,152,0,COMPLETED_WALLTIME_REACHED,22448,152,22600,20051,20203,132.91447368421052,13 14 15,-1
497,w0,100,2393,4,150,0,COMPLETED_WALLTIME_REACHED,22455,150,22605,20062,20212,134.74666666666667,0 1 2 7,-1
500,w0,100,2398,4,154,0,COMPLETED_WALLTIME_REACHED,22602,154,22756,20204,20358,132.19480519480518,9 10 11 12,-1
498,w0,100,2393,7,151,0,COMPLETED_WALLTIME_REACHED,22605,151,22756,20212,20363,134.8543046357616,3 4 5 6 8 13 14,-1
501,w0,100,2399,4,148,0,COMPLETED_WALLTIME_REACHED,22605,148,22753,20206,20354,137.52702702702703,0 1 2 7,-1
503,w0,100,2409,5,148,0,COMPLETED_WALLTIME_REACHED,22756,148,22904,20347,20495,138.47972972972974,3 4 5 6 8,-1
504,w0,100,2412,4,152,0,COMPLETED_WALLTIME_REACHED,22756,152,22908,20344,20496,134.8421052631579,9 10 11 12,-1
502,w0,100,2401,5,151,0,COMPLETED_WALLTIME_REACHED,22758,151,22909,20357,20508,135.81456953642385,0 1 2 7 15,-1
505,w0,100,2413,4,153,0,COMPLETED_WALLTIME_REACHED,22904,153,23057,20491,20644,134.9281045751634,3 4 5 6,-1
506,w0,100,2422,5,148,0,COMPLETED_WALLTIME_REACHED,22908,148,23056,20486,20634,139.4189189189189,8 9 10 11 12,-1
507,w0,100,2431,4,149,0,COMPLETED_WALLTIME_REACHED,22909,149,23058,20478,20627,138.43624161073825,0 1 2 7,-1
511,w0,100,2437,3,147,0,COMPLETED_WALLTIME_REACHED,22914,147,23061,20477,20624,140.29931972789115,13 14 15,-1
508,w0,100,2432,7,149,0,COMPLETED_WALLTIME_REACHED,23057,149,23206,20625,20774,139.4228187919463,3 4 5 6 8 9 10,-1
509,w0,100,2433,5,152,0,COMPLETED_WALLTIME_REACHED,23058,152,23210,20625,20777,136.69078947368422,0 1 2 7 11,-1
512,w0,100,2440,4,148,0,COMPLETED_WALLTIME_REACHED,23061,148,23209,20621,20769,140.3310810810811,12 13 14 15,-1
510,w0,100,2434,6,148,0,COMPLETED_WALLTIME_REACHED,23206,148,23354,20772,20920,141.35135135135135,3 4 5 6 8 9,-1
513,w0,100,2443,3,153,0,COMPLETED_WALLTIME_REACHED,23209,153,23362,20766,20919,136.72549019607843,10 12 13,-1
514,w0,100,2462,5,147,0,COMPLETED_WALLTIME_REACHED,23210,147,23357,20748,20895,142.14285714285714,0 1 2 7 11,-1
515,w0,100,2472,3,150,0,COMPLETED_WALLTIME_REACHED,23354,150,23504,20882,21032,140.21333333333334,3 4 5,-1
518,w0,100,2483,4,146,0,COMPLETED_WALLTIME_REACHED,23359,146,23505,20876,21022,143.986301369863,6 8 9 14,-1
516,w0,100,2475,6,150,0,COMPLETED_WALLTIME_REACHED,23362,150,23512,20887,21037,140.24666666666667,0 1 2 7 11 15,-1
517,w0,100,2479,5,149,0,COMPLETED_WALLTIME_REACHED,23509,149,23658,21030,21179,142.14093959731542,3 4 5 10 12,-1
519,w0,100,2485,4,151,0,COMPLETED_WALLTIME_REACHED,23510,151,23661,21025,21176,140.23841059602648,6 8 9 13,-1
520,w0,100,2485,4,152,0,COMPLETED_WALLTIME_REACHED,23512,152,23664,21027,21179,139.33552631578948,0 1 2 7,-1
528,w0,100,2527,3,152,0,COMPLETED_WALLTIME_REACHED,23512,152,23664,20985,21137,139.05921052631578,11 14 15,-1
521,w0,100,2492,5,147,0,COMPLETED_WALLTIME_REACHED,23658,147,23805,21166,21313,144.98639455782313,3 4 5 10 12,-1
523,w0,100,2506,4,149,0,COMPLETED_WALLTIME_REACHED,23661,149,23810,21155,21304,142.9798657718121,6 8 9 13,-1
522,w0,100,2502,5,150,0,COMPLETED_WALLTIME_REACHED,23664,150,23814,21162,21312,142.08,0 1 2 7 11,-1
524,w0,100,2517,6,152,0,COMPLETED_WALLTIME_REACHED,23810,152,23962,21293,21445,141.08552631578948,3 4 5 10 12 14,-1
527,w0,100,2521,4,150,0,COMPLETED_WALLTIME_REACHED,23810,150,23960,21289,21439,142.92666666666668,6 8 9 13,-1
525,w0,100,2518,6,150,0,COMPLETED_WALLTIME_REACHED,23819,150,23969,21301,21451,143.00666666666666,0 1 2 7 11 15,-1
531,w0,100,2544,4,148,0,COMPLETED_WALLTIME_REACHED,23960,148,24108,21416,21564,145.7027027027027,6 8 9 13,-1
526,w0,100,2520,5,148,0,COMPLETED_WALLTIME_REACHED,23962,148,24110,21442,21590,145.8783783783784,3 4 5 10 12,-1
529,w0,100,2529,5,149,0,COMPLETED_WALLTIME_REACHED,23969,149,24118,21440,21589,144.89261744966444,0 1 2 7 11,-1
532,w0,100,2548,4,149,0,COMPLETED_WALLTIME_REACHED,24110,149,24259,21562,21711,145.71140939597316,3 4 5 10,-1
530,w0,100,2540,5,149,0,COMPLETED_WALLTIME_REACHED,24113,149,24262,21573,21722,145.78523489932886,6 8 9 13 14,-1
533,w0,100,2551,5,152,0,COMPLETED_WALLTIME_REACHED,24118,152,24270,21567,21719,142.88815789473685,0 1 2 7 11,-1
535,w0,100,2563,5,148,0,COMPLETED_WALLTIME_REACHED,24264,148,24412,21701,21849,147.6283783783784,3 4 5 10 12,-1
536,w0,100,2563,6,146,0,COMPLETED_WALLTIME_REACHED,24267,146,24413,21704,21850,149.65753424657535,6 8 9 13 14 15,-1
537,w0,100,2571,3,147,0,COMPLETED_WALLTIME_REACHED,24270,147,24417,21699,21846,148.6122448979592,0 1 2,-1
538,w0,100,2574,5,149,0,COMPLETED_WALLTIME_REACHED,24417,149,24566,21843,21992,147.59731543624162,3 4 5 7 10,-1
541,w0,100,2592,3,150,0,COMPLETED_WALLTIME_REACHED,24417,150,24567,21825,21975,146.5,0 1 2,-1
539,w0,100,2583,6,153,0,COMPLETED_WALLTIME_REACHED,24418,153,24571,21835,21988,143.71241830065358,6 8 9 11 12 13,-1
540,w0,100,2588,6,153,0,COMPLETED_WALLTIME_REACHED,24571,153,24724,21983,22136,144.6797385620915,3 4 5 7 10 14,-1
542,w0,100,2592,5,151,0,COMPLETED_WALLTIME_REACHED,24571,151,24722,21979,22130,146.5562913907285,6 8 9 11 12,-1
544,w0,100,2599,4,148,0,COMPLETED_WALLTIME_REACHED,24572,148,24720,21973,22121,149.46621621621622,0 1 2 15,-1
547,w0,100,2617,3,153,0,COMPLETED_WALLTIME_REACHED,24720,153,24873,22103,22256,145.4640522875817,0 1 2,-1
545,w0,100,2602,6,150,0,COMPLETED_WALLTIME_REACHED,24724,150,24874,22122,22272,148.48,3 4 5 7 10 14,-1
543,w0,100,2595,6,151,0,COMPLETED_WALLTIME_REACHED,24727,151,24878,22132,22283,147.56953642384107,6 8 9 11 12 13,-1
546,w0,100,2607,6,149,0,COMPLETED_WALLTIME_REACHED,24874,149,25023,22267,22416,150.44295302013424,3 4 5 7 10 14,-1
548,w0,100,2617,4,151,0,COMPLETED_WALLTIME_REACHED,24878,151,25029,22261,22412,148.42384105960264,0 1 2 15,-1
549,w0,100,2628,5,148,0,COMPLETED_WALLTIME_REACHED,24878,148,25026,22250,22398,151.33783783783784,6 8 9 11 12,-1
550,w0,100,2632,5,150,0,COMPLETED_WALLTIME_REACHED,25023,150,25173,22391,22541,150.27333333333334,3 4 5 7 10,-1
551,w0,100,2634,4,149,0,COMPLETED_WALLTIME_REACHED,25026,149,25175,22392,22541,151.28187919463087,6 8 9 11,-1
552,w0,100,2638,6,153,0,COMPLETED_WALLTIME_REACHED,25034,153,25187,22396,22549,147.37908496732027,0 1 2 12 13 14,-1
554,w0,100,2646,3,150,0,COMPLETED_WALLTIME_REACHED,25175,150,25325,22529,22679,151.19333333333333,6 8 9,-1
553,w0,100,2644,6,149,0,COMPLETED_WALLTIME_REACHED,25178,149,25327,22534,22683,152.23489932885906,3 4 5 7 10 15,-1
555,w0,100,2652,5,148,0,COMPLETED_WALLTIME_REACHED,25187,148,25335,22535,22683,153.26351351351352,0 1 2 11 12,-1
557,w0,100,2671,4,148,0,COMPLETED_WALLTIME_REACHED,25327,148,25475,22656,22804,154.0810810810811,3 4 5 7,-1
556,w0,100,2656,5,147,0,COMPLETED_WALLTIME_REACHED,25330,147,25477,22674,22821,155.24489795918367,6 8 9 13 14,-1
558,w0,100,2672,5,153,0,COMPLETED_WALLTIME_REACHED,25335,153,25488,22663,22816,149.12418300653596,0 1 2 10 11,-1
559,w0,100,2676,5,151,0,COMPLETED_WALLTIME_REACHED,25480,151,25631,22804,22955,152.01986754966887,3 4 5 7 12,-1
560,w0,100,2679,6,150,0,COMPLETED_WALLTIME_REACHED,25482,150,25632,22803,22953,153.02,6 8 9 13 14 15,-1
561,w0,100,2688,5,149,0,COMPLETED_WALLTIME_REACHED,25488,149,25637,22800,22949,154.0201342281879,0 1 2 10 11,-1
562,w0,100,2693,5,151,0,COMPLETED_WALLTIME_REACHED,25631,151,25782,22938,23089,152.90728476821192,3 4 5 7 12,-1
563,w0,100,2695,4,148,0,COMPLETED_WALLTIME_REACHED,25632,148,25780,22937,23085,155.97972972972974,6 8 9 13,-1
564,w0,100,2697,4,147,0,COMPLETED_WALLTIME_REACHED,25637,147,25784,22940,23087,157.05442176870747,0 1 2 10,-1
570,w0,100,2725,3,149,0,COMPLETED_WALLTIME_REACHED,25637,149,25786,22912,23061,154.7718120805369,11 14 15,-1
565,w0,100,2704,4,150,0,COMPLETED_WALLTIME_REACHED,25780,150,25930,23076,23226,154.84,6 8 9 13,-1
566,w0,100,2705,4,150,0,COMPLETED_WALLTIME_REACHED,25782,150,25932,23077,23227,154.84666666666666,3 4 5 7,-1
567,w0,100,2707,4,150,0,COMPLETED_WALLTIME_REACHED,25784,150,25934,23077,23227,154.84666666666666,0 1 2 10,-1
568,w0,100,2722,4,152,0,COMPLETED_WALLTIME_REACHED,25786,152,25938,23064,23216,152.73684210526315,11 12 14 15,-1
569,w0,100,2724,6,148,0,COMPLETED_WALLTIME_REACHED,25932,148,26080,23208,23356,157.8108108108108,3 4 5 6 7 8,-1
571,w0,100,2728,4,150,0,COMPLETED_WALLTIME_REACHED,25934,150,26084,23206,23356,155.70666666666668,0 1 2 9,-1
572,w0,100,2734,5,151,0,COMPLETED_WALLTIME_REACHED,25938,151,26089,23204,23355,154.66887417218544,10 11 12 13 14,-1
573,w0,100,2734,3,149,0,COMPLETED_WALLTIME_REACHED,26080,149,26229,23346,23495,157.68456375838926,3 4 5,-1
578,w0,100,2759,3,147,0,COMPLETED_WALLTIME_REACHED,26084,147,26231,23325,23472,159.6734693877551,0 1 2,-1
574,w0,100,2741,4,147,0,COMPLETED_WALLTIME_REACHED,26085,147,26232,23344,23491,159.80272108843536,6 7 8 15,-1
575,w0,100,2748,6,150,0,COMPLETED_WALLTIME_REACHED,26089,150,26239,23341,23491,156.60666666666665,9 10 11 12 13 14,-1
576,w0,100,2749,5,153,0,COMPLETED_WALLTIME_REACHED,26231,153,26384,23482,23635,154.47712418300654,0 1 2 3 4,-1
577,w0,100,2749,5,152,0,COMPLETED_WALLTIME_REACHED,26232,152,26384,23483,23635,155.4934210526316,5 6 7 8 15,-1
579,w0,100,2762,6,151,0,COMPLETED_WALLTIME_REACHED,26239,151,26390,23477,23628,156.47682119205297,9 10 11 12 13 14,-1
580,w0,100,2766,5,149,0,COMPLETED_WALLTIME_REACHED,26384,149,26533,23618,23767,159.51006711409397,0 1 2 3 4,-1
581,w0,100,2767,4,151,0,COMPLETED_WALLTIME_REACHED,26384,151,26535,23617,23768,157.40397350993376,5 6 7 8,-1
583,w0,100,2771,5,147,0,COMPLETED_WALLTIME_REACHED,26390,147,26537,23619,23766,161.6734693877551,9 10 11 12 13,-1
584,w0,100,2776,4,150,0,COMPLETED_WALLTIME_REACHED,26533,150,26683,23757,23907,159.38,0 1 2 3,-1
585,w0,100,2780,5,151,0,COMPLETED_WALLTIME_REACHED,26535,151,26686,23755,23906,158.31788079470198,4 5 6 7 8,-1
586,w0,100,2780,6,152,0,COMPLETED_WALLTIME_REACHED,26542,152,26694,23762,23914,157.32894736842104,9 10 11 12 13 14,-1
588,w0,100,2788,5,150,0,COMPLETED_WALLTIME_REACHED,26686,150,26836,23898,24048,160.32,4 5 6 7 8,-1
587,w0,100,2782,5,151,0,COMPLETED_WALLTIME_REACHED,26688,151,26839,23906,24057,159.31788079470198,0 1 2 3 15,-1
589,w0,100,2788,5,154,0,COMPLETED_WALLTIME_REACHED,26694,154,26848,23906,24060,156.23376623376623,9 10 11 12 13,-1
590,w0,100,2790,3,146,0,COMPLETED_WALLTIME_REACHED,26836,146,26982,24046,24192,165.6986301369863,4 5 6,-1
592,w0,100,2794,4,152,0,COMPLETED_WALLTIME_REACHED,26839,152,26991,24045,24197,159.19078947368422,0 1 2 3,-1
591,w0,100,2791,3,150,0,COMPLETED_WALLTIME_REACHED,26841,150,26991,24050,24200,161.33333333333334,7 8 14,-1
593,w0,100,2806,4,152,0,COMPLETED_WALLTIME_REACHED,26848,152,27000,24042,24194,159.17105263157896,9 10 11 12,-1
594,w0,100,2807,5,147,0,COMPLETED_WALLTIME_REACHED,26987,147,27134,24180,24327,165.48979591836735,4 5 6 13 15,-1
595,w0,100,2814,5,151,0,COMPLETED_WALLTIME_REACHED,26991,151,27142,24177,24328,161.11258278145695,0 1 2 3 7,-1
596,w0,100,2815,4,151,0,COMPLETED_WALLTIME_REACHED,27000,151,27151,24185,24336,161.16556291390728,8 9 10 11,-1
597,w0,100,2818,5,152,0,COMPLETED_WALLTIME_REACHED,27139,152,27291,24321,24473,161.0065789473684,4 5 6 12 13,-1
598,w0,100,2824,5,148,0,COMPLETED_WALLTIME_REACHED,27142,148,27290,24318,24466,165.3108108108108,0 1 2 3 7,-1
599,w0,100,2824,5,149,0,COMPLETED_WALLTIME_REACHED,27156,149,27305,24332,24481,164.3020134228188,8 9 10 11 14,-1
600,w0,100,2847,4,150,0,COMPLETED_WALLTIME_REACHED,27290,150,27440,24443,24593,163.95333333333335,0 1 2 3,-1
601,w0,100,2847,5,152,0,COMPLETED_WALLTIME_REACHED,27291,152,27443,24444,24596,161.81578947368422,4 5 6 7 12,-1
602,w0,100,2852,5,150,0,COMPLETED_WALLTIME_REACHED,27305,150,27455,24453,24603,164.02,8 9 10 11 13,-1
604,w0,100,2873,3,153,0,COMPLETED_WALLTIME_REACHED,27443,153,27596,24570,24723,161.58823529411765,4 5 6,-1
603,w0,100,2867,6,151,0,COMPLETED_WALLTIME_REACHED,27445,151,27596,24578,24729,163.7682119205298,0 1 2 3 14 15,-1
605,w0,100,2878,4,151,0,COMPLETED_WALLTIME_REACHED,27455,151,27606,24577,24728,163.76158940397352,7 8 9 10,-1
607,w0,100,2889,3,149,0,COMPLETED_WALLTIME_REACHED,27455,149,27604,24566,24715,165.8724832214765,11 12 13,-1
606,w0,100,2887,4,150,0,COMPLETED_WALLTIME_REACHED,27596,150,27746,24709,24859,165.72666666666666,0 1 2 3,-1
608,w0,100,2891,5,152,0,COMPLETED_WALLTIME_REACHED,27596,152,27748,24705,24857,163.5328947368421,4 5 6 14 15,-1
609,w0,100,2893,5,151,0,COMPLETED_WALLTIME_REACHED,27606,151,27757,24713,24864,164.66225165562915,7 8 9 10 11,-1
610,w0,100,2895,3,147,0,COMPLETED_WALLTIME_REACHED,27746,147,27893,24851,24998,170.05442176870747,0 1 2,-1
611,w0,100,2900,4,151,0,COMPLETED_WALLTIME_REACHED,27748,151,27899,24848,24999,165.5562913907285,4 5 6 14,-1
628,w0,100,2999,3,151,0,COMPLETED_WALLTIME_REACHED,27751,151,27902,24752,24903,164.9205298013245,3 12 13,-1
612,w0,100,2900,4,153,0,COMPLETED_WALLTIME_REACHED,27757,153,27910,24857,25010,163.4640522875817,7 8 9 10,-1
613,w0,100,2908,5,148,0,COMPLETED_WALLTIME_REACHED,27898,148,28046,24990,25138,169.85135135135135,0 1 2 11 15,-1
614,w0,100,2917,5,152,0,COMPLETED_WALLTIME_REACHED,27902,152,28054,24985,25137,165.375,3 4 5 6 12,-1
615,w0,100,2924,4,150,0,COMPLETED_WALLTIME_REACHED,27910,150,28060,24986,25136,167.57333333333332,7 8 9 10,-1
616,w0,100,2925,5,151,0,COMPLETED_WALLTIME_REACHED,28051,151,28202,25126,25277,167.39735099337747,0 1 2 11 13,-1
617,w0,100,2935,5,151,0,COMPLETED_WALLTIME_REACHED,28054,151,28205,25119,25270,167.35099337748343,3 4 5 6 12,-1
618,w0,100,2935,5,147,0,COMPLETED_WALLTIME_REACHED,28065,147,28212,25130,25277,171.95238095238096,7 8 9 10 14,-1
620,w0,100,2950,5,148,0,COMPLETED_WALLTIME_REACHED,28205,148,28353,25255,25403,171.6418918918919,3 4 5 6 12,-1
619,w0,100,2940,6,152,0,COMPLETED_WALLTIME_REACHED,28207,152,28359,25267,25419,167.23026315789474,0 1 2 11 13 15,-1
621,w0,100,2952,5,149,0,COMPLETED_WALLTIME_REACHED,28212,149,28361,25260,25409,170.53020134228188,7 8 9 10 14,-1
622,w0,100,2952,5,151,0,COMPLETED_WALLTIME_REACHED,28353,151,28504,25401,25552,169.2185430463576,3 4 5 6 12,-1
623,w0,100,2967,4,149,0,COMPLETED_WALLTIME_REACHED,28359,149,28508,25392,25541,171.41610738255034,0 1 2 11,-1
624,w0,100,2967,6,148,0,COMPLETED_WALLTIME_REACHED,28361,148,28509,25394,25542,172.5810810810811,7 8 9 10 13 14,-1
625,w0,100,2982,5,144,0,COMPLETED_WALLTIME_REACHED,28504,144,28648,25522,25666,178.23611111111111,3 4 5 6 12,-1
626,w0,100,2988,4,149,0,COMPLETED_WALLTIME_REACHED,28508,149,28657,25520,25669,172.2751677852349,0 1 2 11,-1
627,w0,100,2995,5,151,0,COMPLETED_WALLTIME_REACHED,28509,151,28660,25514,25665,169.96688741721854,7 8 9 10 13,-1
629,w0,100,3000,5,148,0,COMPLETED_WALLTIME_REACHED,28648,148,28796,25648,25796,174.2972972972973,3 4 5 6 12,-1
630,w0,100,3002,3,154,0,COMPLETED_WALLTIME_REACHED,28657,154,28811,25655,25809,167.5909090909091,0 1 2,-1
631,w0,100,3006,6,149,0,COMPLETED_WALLTIME_REACHED,28660,149,28809,25654,25803,173.1744966442953,7 8 9 10 11 13,-1
632,w0,100,3006,4,149,0,COMPLETED_WALLTIME_REACHED,28796,149,28945,25790,25939,174.08724832214764,3 4 5 6,-1
648,w0,100,3057,3,148,0,COMPLETED_WALLTIME_REACHED,28801,148,28949,25744,25892,174.94594594594594,12 14 15,-1
633,w0,100,3007,4,149,0,COMPLETED_WALLTIME_REACHED,28809,149,28958,25802,25951,174.16778523489933,7 8 9 10,-1
634,w0,100,3007,5,149,0,COMPLETED_WALLTIME_REACHED,28811,149,28960,25804,25953,174.18120805369128,0 1 2 11 13,-1
635,w0,100,3008,4,148,0,COMPLETED_WALLTIME_REACHED,28945,148,29093,25937,26085,176.25,3 4 5 6,-1
636,w0,100,3012,5,149,0,COMPLETED_WALLTIME_REACHED,28958,149,29107,25946,26095,175.13422818791946,7 8 9 10 12,-1
637,w0,100,3017,7,150,0,COMPLETED_WALLTIME_REACHED,28960,150,29110,25943,26093,173.95333333333335,0 1 2 11 13 14 15,-1
638,w0,100,3024,4,147,0,COMPLETED_WALLTIME_REACHED,29093,147,29240,26069,26216,178.34013605442178,3 4 5 6,-1
639,w0,100,3025,5,152,0,COMPLETED_WALLTIME_REACHED,29107,152,29259,26082,26234,172.5921052631579,7 8 9 10 12,-1
640,w0,100,3026,5,150,0,COMPLETED_WALLTIME_REACHED,29110,150,29260,26084,26234,174.89333333333335,0 1 2 11 13,-1
642,w0,100,3035,5,148,0,COMPLETED_WALLTIME_REACHED,29245,148,29393,26210,26358,178.09459459459458,3 4 5 6 14,-1
644,w0,100,3041,4,152,0,COMPLETED_WALLTIME_REACHED,29259,152,29411,26218,26370,173.48684210526315,7 8 9 10,-1
643,w0,100,3036,7,151,0,COMPLETED_WALLTIME_REACHED,29265,151,29416,26229,26380,174.7019867549669,0 1 2 11 12 13 15,-1
645,w0,100,3043,5,147,0,COMPLETED_WALLTIME_REACHED,29393,147,29540,26350,26497,180.2517006802721,3 4 5 6 14,-1
650,w0,100,3059,3,153,0,COMPLETED_WALLTIME_REACHED,29411,153,29564,26352,26505,173.23529411764707,7 8 9,-1
646,w0,100,3050,6,149,0,COMPLETED_WALLTIME_REACHED,29416,149,29565,26366,26515,177.95302013422818,0 1 2 10 11 12,-1
647,w0,100,3054,5,151,0,COMPLETED_WALLTIME_REACHED,29545,151,29696,26491,26642,176.43708609271522,3 4 5 6 13,-1
652,w0,100,3079,5,152,0,COMPLETED_WALLTIME_REACHED,29565,152,29717,26486,26638,175.25,0 1 2 10 11,-1
649,w0,100,3058,5,149,0,COMPLETED_WALLTIME_REACHED,29569,149,29718,26511,26660,178.9261744966443,7 8 9 14 15,-1
653,w0,100,3082,5,153,0,COMPLETED_WALLTIME_REACHED,29701,153,29854,26619,26772,174.98039215686273,3 4 5 6 12,-1
655,w0,100,3085,5,147,0,COMPLETED_WALLTIME_REACHED,29717,147,29864,26632,26779,182.17006802721087,0 1 2 10 11,-1
656,w0,100,3099,5,149,0,COMPLETED_WALLTIME_REACHED,29718,149,29867,26619,26768,179.6510067114094,7 8 9 13 14,-1
657,w0,100,3102,5,152,0,COMPLETED_WALLTIME_REACHED,29854,152,30006,26752,26904,177.0,3 4 5 6 12,-1
658,w0,100,3103,5,152,0,COMPLETED_WALLTIME_REACHED,29864,152,30016,26761,26913,177.05921052631578,0 1 2 10 11,-1
659,w0,100,3104,3,147,0,COMPLETED_WALLTIME_REACHED,29867,147,30014,26763,26910,183.0612244897959,7 8 9,-1
678,w0,100,3183,3,148,0,COMPLETED_WALLTIME_REACHED,29872,148,30020,26689,26837,181.3310810810811,13 14 15,-1
660,w0,100,3106,4,151,0,COMPLETED_WALLTIME_REACHED,30006,151,30157,26900,27051,179.1456953642384,3 4 5 6,-1
684,w0,100,3225,3,151,0,COMPLETED_WALLTIME_REACHED,30014,151,30165,26789,26940,178.41059602649005,7 8 9,-1
661,w0,100,3112,6,150,0,COMPLETED_WALLTIME_REACHED,30016,150,30166,26904,27054,180.36,0 1 2 10 11 12,-1
662,w0,100,3116,5,149,0,COMPLETED_WALLTIME_REACHED,30162,149,30311,27046,27195,182.51677852348993,3 4 5 6 13,-1
664,w0,100,3129,4,150,0,COMPLETED_WALLTIME_REACHED,30170,150,30320,27041,27191,181.27333333333334,7 8 9 14,-1
663,w0,100,3125,7,147,0,COMPLETED_WALLTIME_REACHED,30171,147,30318,27046,27193,184.98639455782313,0 1 2 10 11 12 15,-1
665,w0,100,3129,5,148,0,COMPLETED_WALLTIME_REACHED,30311,148,30459,27182,27330,184.66216216216216,3 4 5 6 13,-1
666,w0,100,3131,5,147,0,COMPLETED_WALLTIME_REACHED,30318,147,30465,27187,27334,185.94557823129253,0 1 2 10 11,-1
667,w0,100,3138,4,148,0,COMPLETED_WALLTIME_REACHED,30320,148,30468,27182,27330,184.66216216216216,7 8 9 12,-1
668,w0,100,3144,5,154,0,COMPLETED_WALLTIME_REACHED,30459,154,30613,27315,27469,178.37012987012986,3 4 5 6 13,-1
669,w0,100,3149,4,152,0,COMPLETED_WALLTIME_REACHED,30465,152,30617,27316,27468,180.71052631578948,0 1 2 10,-1
670,w0,100,3150,4,149,0,COMPLETED_WALLTIME_REACHED,30468,149,30617,27318,27467,184.34228187919464,7 8 9 12,-1
685,w0,100,3236,3,151,0,COMPLETED_WALLTIME_REACHED,30470,151,30621,27234,27385,181.35761589403972,11 14 15,-1
671,w0,100,3150,5,148,0,COMPLETED_WALLTIME_REACHED,30613,148,30761,27463,27611,186.5608108108108,3 4 5 6 13,-1
672,w0,100,3152,4,148,0,COMPLETED_WALLTIME_REACHED,30617,148,30765,27465,27613,186.57432432432432,0 1 2 7,-1
673,w0,100,3152,4,148,0,COMPLETED_WALLTIME_REACHED,30617,148,30765,27465,27613,186.57432432432432,8 9 10 12,-1
675,w0,100,3171,6,151,0,COMPLETED_WALLTIME_REACHED,30765,151,30916,27594,27745,183.74172185430464,0 1 2 7 8 9,-1
674,w0,100,3157,6,145,0,COMPLETED_WALLTIME_REACHED,30766,145,30911,27609,27754,191.40689655172415,3 4 5 6 11 13,-1
680,w0,100,3191,4,148,0,COMPLETED_WALLTIME_REACHED,30770,148,30918,27579,27727,187.34459459459458,10 12 14 15,-1
676,w0,100,3172,5,151,0,COMPLETED_WALLTIME_REACHED,30911,151,31062,27739,27890,184.7019867549669,3 4 5 6 11,-1
677,w0,100,3179,6,148,0,COMPLETED_WALLTIME_REACHED,30916,148,31064,27737,27885,188.41216216216216,0 1 2 7 8 9,-1
679,w0,100,3187,5,149,0,COMPLETED_WALLTIME_REACHED,30918,149,31067,27731,27880,187.11409395973155,10 12 13 14 15,-1
681,w0,100,3211,5,149,0,COMPLETED_WALLTIME_REACHED,31062,149,31211,27851,28000,187.91946308724832,3 4 5 6 11,-1
682,w0,100,3212,6,152,0,COMPLETED_WALLTIME_REACHED,31064,152,31216,27852,28004,184.23684210526315,0 1 2 7 8 9,-1
683,w0,100,3219,4,150,0,COMPLETED_WALLTIME_REACHED,31067,150,31217,27848,27998,186.65333333333334,10 12 13 14,-1
686,w0,100,3250,5,149,0,COMPLETED_WALLTIME_REACHED,31211,149,31360,27961,28110,188.65771812080536,3 4 5 6 11,-1
687,w0,100,3256,5,148,0,COMPLETED_WALLTIME_REACHED,31216,148,31364,27960,28108,189.9189189189189,0 1 2 7 8,-1
688,w0,100,3277,5,150,0,COMPLETED_WALLTIME_REACHED,31217,150,31367,27940,28090,187.26666666666668,9 10 12 13 14,-1
689,w0,100,3282,4,148,0,COMPLETED_WALLTIME_REACHED,31360,148,31508,28078,28226,190.71621621621622,3 4 5 6,-1
690,w0,100,3285,5,153,0,COMPLETED_WALLTIME_REACHED,31364,153,31517,28079,28232,184.52287581699346,0 1 2 7 8,-1
691,w0,100,3285,5,150,0,COMPLETED_WALLTIME_REACHED,31367,150,31517,28082,28232,188.21333333333334,9 10 11 12 13,-1
692,w0,100,3297,6,150,0,COMPLETED_WALLTIME_REACHED,31513,150,31663,28216,28366,189.10666666666665,3 4 5 6 14 15,-1
693,w0,100,3308,5,149,0,COMPLETED_WALLTIME_REACHED,31517,149,31666,28209,28358,190.3221476510067,0 1 2 7 8,-1
694,w0,100,3309,4,152,0,COMPLETED_WALLTIME_REACHED,31517,152,31669,28208,28360,186.57894736842104,9 10 11 12,-1
696,w0,100,3328,4,151,0,COMPLETED_WALLTIME_REACHED,31666,151,31817,28338,28489,188.66887417218544,0 1 2 7,-1
695,w0,100,3323,5,148,0,COMPLETED_WALLTIME_REACHED,31668,148,31816,28345,28493,192.52027027027026,3 4 5 6 13,-1
697,w0,100,3337,6,152,0,COMPLETED_WALLTIME_REACHED,31669,152,31821,28332,28484,187.39473684210526,8 9 10 11 12 14,-1
698,w0,100,3337,3,146,0,COMPLETED_WALLTIME_REACHED,31816,146,31962,28479,28625,196.06164383561645,3 4 5,-1
700,w0,100,3339,3,147,0,COMPLETED_WALLTIME_REACHED,31817,147,31964,28478,28625,194.7278911564626,0 1 2,-1
699,w0,100,3338,3,150,0,COMPLETED_WALLTIME_REACHED,31821,150,31971,28483,28633,190.88666666666666,6 13 15,-1
701,w0,100,3346,4,150,0,COMPLETED_WALLTIME_REACHED,31821,150,31971,28475,28625,190.83333333333334,7 8 9 10,-1
703,w0,100,3349,3,151,0,COMPLETED_WALLTIME_REACHED,31964,151,32115,28615,28766,190.50331125827816,0 1 2,-1
702,w0,100,3346,4,148,0,COMPLETED_WALLTIME_REACHED,31967,148,32115,28621,28769,194.38513513513513,3 4 5 11,-1
704,w0,100,3352,5,149,0,COMPLETED_WALLTIME_REACHED,31971,149,32120,28619,28768,193.0738255033557,6 7 8 9 10,-1
706,w0,100,3374,4,151,0,COMPLETED_WALLTIME_REACHED,31976,151,32127,28602,28753,190.41721854304635,12 13 14 15,-1
705,w0,100,3368,5,150,0,COMPLETED_WALLTIME_REACHED,32115,150,32265,28747,28897,192.64666666666668,0 1 2 3 4,-1
707,w0,100,3375,4,149,0,COMPLETED_WALLTIME_REACHED,32120,149,32269,28745,28894,193.91946308724832,5 6 7 8,-1
708,w0,100,3376,5,152,0,COMPLETED_WALLTIME_REACHED,32127,152,32279,28751,28903,190.15131578947367,9 10 11 12 13,-1
709,w0,100,3379,4,151,0,COMPLETED_WALLTIME_REACHED,32265,151,32416,28886,29037,192.2980132450331,0 1 2 3,-1
710,w0,100,3383,5,151,0,COMPLETED_WALLTIME_REACHED,32269,151,32420,28886,29037,192.2980132450331,4 5 6 7 8,-1
711,w0,100,3384,5,149,0,COMPLETED_WALLTIME_REACHED,32279,149,32428,28895,29044,194.9261744966443,9 10 11 12 13,-1
712,w0,100,3386,4,146,0,COMPLETED_WALLTIME_REACHED,32416,146,32562,29030,29176,199.83561643835617,0 1 2 3,-1
713,w0,100,3387,3,152,0,COMPLETED_WALLTIME_REACHED,32420,152,32572,29033,29185,192.0065789473684,4 5 6,-1
714,w0,100,3395,3,154,0,COMPLETED_WALLTIME_REACHED,32425,154,32579,29030,29184,189.5064935064935,7 8 14,-1
715,w0,100,3406,5,149,0,COMPLETED_WALLTIME_REACHED,32428,149,32577,29022,29171,195.7785234899329,9 10 11 12 13,-1
716,w0,100,3412,4,147,0,COMPLETED_WALLTIME_REACHED,32562,147,32709,29150,29297,199.29931972789115,0 1 2 3,-1
717,w0,100,3415,3,147,0,COMPLETED_WALLTIME_REACHED,32572,147,32719,29157,29304,199.3469387755102,4 5 6,-1
718,w0,100,3419,6,152,0,COMPLETED_WALLTIME_REACHED,32582,152,32734,29163,29315,192.86184210526315,9 10 11 12 13 15,-1
719,w0,100,3430,6,148,0,COMPLETED_WALLTIME_REACHED,32714,148,32862,29284,29432,198.86486486486487,0 1 2 3 7 8,-1
720,w0,100,3430,4,149,0,COMPLETED_WALLTIME_REACHED,32724,149,32873,29294,29443,197.60402684563758,4 5 6 14,-1
721,w0,100,3442,5,150,0,COMPLETED_WALLTIME_REACHED,32734,150,32884,29292,29442,196.28,9 10 11 12 13,-1
723,w0,100,3454,5,150,0,COMPLETED_WALLTIME_REACHED,32862,150,33012,29408,29558,197.05333333333334,0 1 2 3 7,-1
724,w0,100,3455,5,151,0,COMPLETED_WALLTIME_REACHED,32873,151,33024,29418,29569,195.82119205298014,4 5 6 8 14,-1
725,w0,100,3464,6,152,0,COMPLETED_WALLTIME_REACHED,32889,152,33041,29425,29577,194.58552631578948,9 10 11 12 13 15,-1
726,w0,100,3466,4,149,0,COMPLETED_WALLTIME_REACHED,33012,149,33161,29546,29695,199.29530201342283,0 1 2 3,-1
727,w0,100,3471,3,149,0,COMPLETED_WALLTIME_REACHED,33024,149,33173,29553,29702,199.34228187919464,4 5 6,-1
732,w0,100,3514,3,149,0,COMPLETED_WALLTIME_REACHED,33024,149,33173,29510,29659,199.05369127516778,7 8 14,-1
728,w0,100,3478,6,149,0,COMPLETED_WALLTIME_REACHED,33041,149,33190,29563,29712,199.40939597315437,9 10 11 12 13 15,-1
729,w0,100,3482,4,148,0,COMPLETED_WALLTIME_REACHED,33161,148,33309,29679,29827,201.53378378378378,0 1 2 3,-1
730,w0,100,3493,5,150,0,COMPLETED_WALLTIME_REACHED,33173,150,33323,29680,29830,198.86666666666667,4 5 6 7 8,-1
731,w0,100,3493,7,150,0,COMPLETED_WALLTIME_REACHED,33190,150,33340,29697,29847,198.98,9 10 11 12 13 14 15,-1
733,w0,100,3515,3,151,0,COMPLETED_WALLTIME_REACHED,33309,151,33460,29794,29945,198.3112582781457,0 1 2,-1
734,w0,100,3523,5,152,0,COMPLETED_WALLTIME_REACHED,33323,152,33475,29800,29952,197.05263157894737,3 4 5 6 7,-1
735,w0,100,3525,3,147,0,COMPLETED_WALLTIME_REACHED,33340,147,33487,29815,29962,203.8231292517007,8 9 10,-1
736,w0,100,3526,5,150,0,COMPLETED_WALLTIME_REACHED,33340,150,33490,29814,29964,199.76,11 12 13 14 15,-1
738,w0,100,3530,3,149,0,COMPLETED_WALLTIME_REACHED,33460,149,33609,29930,30079,201.8724832214765,0 1 2,-1
737,w0,100,3530,4,151,0,COMPLETED_WALLTIME_REACHED,33475,151,33626,29945,30096,199.3112582781457,3 4 5 6,-1
739,w0,100,3536,3,148,0,COMPLETED_WALLTIME_REACHED,33487,148,33635,29951,30099,203.3716216216216,7 8 9,-1
740,w0,100,3536,4,149,0,COMPLETED_WALLTIME_REACHED,33490,149,33639,29954,30103,202.03355704697987,10 11 12 13,-1
741,w0,100,3540,5,150,0,COMPLETED_WALLTIME_REACHED,33614,150,33764,30074,30224,201.49333333333334,0 1 2 14 15,-1
742,w0,100,3542,4,151,0,COMPLETED_WALLTIME_REACHED,33626,151,33777,30084,30235,200.2317880794702,3 4 5 6,-1
743,w0,100,3542,6,148,0,COMPLETED_WALLTIME_REACHED,33639,148,33787,30097,30245,204.3581081081081,7 8 9 10 11 12,-1
744,w0,100,3552,4,152,0,COMPLETED_WALLTIME_REACHED,33769,152,33921,30217,30369,199.79605263157896,0 1 2 13,-1
745,w0,100,3555,6,149,0,COMPLETED_WALLTIME_REACHED,33777,149,33926,30222,30371,203.83221476510067,3 4 5 6 14 15,-1
746,w0,100,3580,4,152,0,COMPLETED_WALLTIME_REACHED,33787,152,33939,30207,30359,199.73026315789474,7 8 9 10,-1
747,w0,100,3580,5,151,0,COMPLETED_WALLTIME_REACHED,33926,151,34077,30346,30497,201.96688741721854,0 1 2 11 12,-1
748,w0,100,3582,4,150,0,COMPLETED_WALLTIME_REACHED,33926,150,34076,30344,30494,203.29333333333332,3 4 5 6,-1
773,w0,100,3710,3,149,0,COMPLETED_WALLTIME_REACHED,33926,149,34075,30216,30365,203.79194630872485,13 14 15,-1
749,w0,100,3585,4,151,0,COMPLETED_WALLTIME_REACHED,33939,151,34090,30354,30505,202.01986754966887,7 8 9 10,-1
750,w0,100,3600,5,147,0,COMPLETED_WALLTIME_REACHED,34076,147,34223,30476,30623,208.31972789115648,3 4 5 6 13,-1
751,w0,100,3605,5,150,0,COMPLETED_WALLTIME_REACHED,34077,150,34227,30472,30622,204.14666666666668,0 1 2 11 12,-1
752,w0,100,3622,4,155,0,COMPLETED_WALLTIME_REACHED,34090,155,34245,30468,30623,197.56774193548387,7 8 9 10,-1
753,w0,100,3624,5,149,0,COMPLETED_WALLTIME_REACHED,34223,149,34372,30599,30748,206.36241610738256,3 4 5 6 13,-1
754,w0,100,3627,5,148,0,COMPLETED_WALLTIME_REACHED,34227,148,34375,30600,30748,207.75675675675674,0 1 2 11 12,-1
755,w0,100,3638,4,149,0,COMPLETED_WALLTIME_REACHED,34245,149,34394,30607,30756,206.41610738255034,7 8 9 10,-1
757,w0,100,3644,4,152,0,COMPLETED_WALLTIME_REACHED,34375,152,34527,30731,30883,203.17763157894737,0 1 2 11,-1
756,w0,100,3638,6,150,0,COMPLETED_WALLTIME_REACHED,34377,150,34527,30739,30889,205.92666666666668,3 4 5 6 13 14,-1
758,w0,100,3645,4,151,0,COMPLETED_WALLTIME_REACHED,34394,151,34545,30749,30900,204.63576158940398,7 8 9 10,-1
759,w0,100,3646,4,149,0,COMPLETED_WALLTIME_REACHED,34527,149,34676,30881,31030,208.25503355704697,0 1 2 3,-1
760,w0,100,3651,5,147,0,COMPLETED_WALLTIME_REACHED,34532,147,34679,30881,31028,211.0748299319728,4 5 6 11 12,-1
761,w0,100,3656,6,153,0,COMPLETED_WALLTIME_REACHED,34545,153,34698,30889,31042,202.88888888888889,7 8 9 10 13 14,-1
762,w0,100,3659,4,152,0,COMPLETED_WALLTIME_REACHED,34676,152,34828,31017,31169,205.05921052631578,0 1 2 3,-1
763,w0,100,3660,4,150,0,COMPLETED_WALLTIME_REACHED,34679,150,34829,31019,31169,207.79333333333332,4 5 6 11,-1
764,w0,100,3662,4,150,0,COMPLETED_WALLTIME_REACHED,34698,150,34848,31036,31186,207.90666666666667,7 8 9 10,-1
781,w0,100,3760,3,150,0,COMPLETED_WALLTIME_REACHED,34698,150,34848,30938,31088,207.25333333333333,12 13 14,-1
766,w0,100,3665,4,148,0,COMPLETED_WALLTIME_REACHED,34829,148,34977,31164,31312,211.56756756756758,4 5 6 11,-1
765,w0,100,3664,5,151,0,COMPLETED_WALLTIME_REACHED,34833,151,34984,31169,31320,207.41721854304635,0 1 2 3 15,-1
767,w0,100,3669,4,149,0,COMPLETED_WALLTIME_REACHED,34848,149,34997,31179,31328,210.25503355704697,7 8 9 10,-1
782,w0,100,3762,3,155,0,COMPLETED_WALLTIME_REACHED,34848,155,35003,31086,31241,201.55483870967743,12 13 14,-1
768,w0,100,3679,4,148,0,COMPLETED_WALLTIME_REACHED,34977,148,35125,31298,31446,212.47297297297297,4 5 6 11,-1
769,w0,100,3683,4,149,0,COMPLETED_WALLTIME_REACHED,34984,149,35133,31301,31450,211.0738255033557,0 1 2 3,-1
770,w0,100,3702,4,154,0,COMPLETED_WALLTIME_REACHED,34997,154,35151,31295,31449,204.21428571428572,7 8 9 10,-1
794,w0,100,3860,3,150,0,COMPLETED_WALLTIME_REACHED,35003,150,35153,31143,31293,208.62,12 13 14,-1
771,w0,100,3704,5,150,0,COMPLETED_WALLTIME_REACHED,35130,150,35280,31426,31576,210.50666666666666,4 5 6 11 15,-1
772,w0,100,3709,4,154,0,COMPLETED_WALLTIME_REACHED,35133,154,35287,31424,31578,205.05194805194805,0 1 2 3,-1
774,w0,100,3713,5,147,0,COMPLETED_WALLTIME_REACHED,35153,147,35300,31440,31587,214.87755102040816,7 8 9 10 12,-1
775,w0,100,3725,4,150,0,COMPLETED_WALLTIME_REACHED,35280,150,35430,31555,31705,211.36666666666667,4 5 6 11,-1
776,w0,100,3728,5,154,0,COMPLETED_WALLTIME_REACHED,35292,154,35446,31564,31718,205.96103896103895,0 1 2 3 13,-1
778,w0,100,3747,5,149,0,COMPLETED_WALLTIME_REACHED,35300,149,35449,31553,31702,212.76510067114094,7 8 9 10 12,-1
779,w0,100,3757,4,151,0,COMPLETED_WALLTIME_REACHED,35430,151,35581,31673,31824,210.75496688741723,4 5 6 11,-1
780,w0,100,3759,5,152,0,COMPLETED_WALLTIME_REACHED,35446,152,35598,31687,31839,209.4671052631579,0 1 2 3 13,-1
783,w0,100,3762,5,152,0,COMPLETED_WALLTIME_REACHED,35449,152,35601,31687,31839,209.4671052631579,7 8 9 10 12,-1
784,w0,100,3802,5,148,0,COMPLETED_WALLTIME_REACHED,35586,148,35734,31784,31932,215.75675675675674,4 5 6 11 14,-1
786,w0,100,3803,5,148,0,COMPLETED_WALLTIME_REACHED,35598,148,35746,31795,31943,215.8310810810811,0 1 2 3 13,-1
787,w0,100,3816,6,149,0,COMPLETED_WALLTIME_REACHED,35606,149,35755,31790,31939,214.35570469798657,7 8 9 10 12 15,-1
788,w0,100,3824,4,149,0,COMPLETED_WALLTIME_REACHED,35734,149,35883,31910,32059,215.16107382550337,4 5 6 11,-1
789,w0,100,3842,6,152,0,COMPLETED_WALLTIME_REACHED,35746,152,35898,31904,32056,210.89473684210526,0 1 2 3 13 14,-1
790,w0,100,3850,4,150,0,COMPLETED_WALLTIME_REACHED,35755,150,35905,31905,32055,213.7,7 8 9 10,-1
791,w0,100,3850,5,144,0,COMPLETED_WALLTIME_REACHED,35888,144,36032,32038,32182,223.48611111111111,4 5 6 11 12,-1
792,w0,100,3850,4,152,0,COMPLETED_WALLTIME_REACHED,35898,152,36050,32048,32200,211.8421052631579,0 1 2 3,-1
805,w0,100,3906,3,149,0,COMPLETED_WALLTIME_REACHED,35903,149,36052,31997,32146,215.74496644295303,13 14 15,-1
793,w0,100,3859,4,150,0,COMPLETED_WALLTIME_REACHED,35905,150,36055,32046,32196,214.64,7 8 9 10,-1
795,w0,100,3869,5,148,0,COMPLETED_WALLTIME_REACHED,36032,148,36180,32163,32311,218.31756756756758,4 5 6 11 12,-1
796,w0,100,3869,4,149,0,COMPLETED_WALLTIME_REACHED,36050,149,36199,32181,32330,216.9798657718121,0 1 2 3,-1
797,w0,100,3873,5,148,0,COMPLETED_WALLTIME_REACHED,36055,148,36203,32182,32330,218.44594594594594,7 8 9 10 13,-1
798,w0,100,3877,5,151,0,COMPLETED_WALLTIME_REACHED,36180,151,36331,32303,32454,214.9271523178808,4 5 6 11 12,-1
800,w0,100,3883,5,148,0,COMPLETED_WALLTIME_REACHED,36203,148,36351,32320,32468,219.3783783783784,7 8 9 10 13,-1
799,w0,100,3878,5,153,0,COMPLETED_WALLTIME_REACHED,36204,153,36357,32326,32479,212.281045751634,0 1 2 3 14,-1
801,w0,100,3884,5,153,0,COMPLETED_WALLTIME_REACHED,36331,153,36484,32447,32600,213.0718954248366,4 5 6 11 12,-1
802,w0,100,3898,5,151,0,COMPLETED_WALLTIME_REACHED,36351,151,36502,32453,32604,215.9205298013245,7 8 9 10 13,-1
806,w0,100,3908,3,150,0,COMPLETED_WALLTIME_REACHED,36357,150,36507,32449,32599,217.32666666666665,0 1 2,-1
803,w0,100,3904,7,153,0,COMPLETED_WALLTIME_REACHED,36489,153,36642,32585,32738,213.9738562091503,3 4 5 6 11 12 14,-1
804,w0,100,3905,7,149,0,COMPLETED_WALLTIME_REACHED,36507,149,36656,32602,32751,219.80536912751677,0 1 2 7 8 9 10,-1
807,w0,100,3912,5,150,0,COMPLETED_WALLTIME_REACHED,36642,150,36792,32730,32880,219.2,3 4 5 6 11,-1
813,w0,100,3936,3,150,0,COMPLETED_WALLTIME_REACHED,36647,150,36797,32711,32861,219.07333333333332,12 13 14,-1
808,w0,100,3917,5,152,0,COMPLETED_WALLTIME_REACHED,36656,152,36808,32739,32891,216.38815789473685,0 1 2 7 8,-1
819,w0,100,3952,3,145,0,COMPLETED_WALLTIME_REACHED,36661,145,36806,32709,32854,226.57931034482758,9 10 15,-1
809,w0,100,3919,5,150,0,COMPLETED_WALLTIME_REACHED,36792,150,36942,32873,33023,220.15333333333334,3 4 5 6 11,-1
810,w0,100,3919,5,154,0,COMPLETED_WALLTIME_REACHED,36806,154,36960,32887,33041,214.55194805194805,9 10 12 13 14,-1
812,w0,100,3931,5,152,0,COMPLETED_WALLTIME_REACHED,36808,152,36960,32877,33029,217.29605263157896,0 1 2 7 8,-1
814,w0,100,3943,5,148,0,COMPLETED_WALLTIME_REACHED,36942,148,37090,32999,33147,223.96621621621622,3 4 5 6 11,-1
815,w0,100,3944,5,147,0,COMPLETED_WALLTIME_REACHED,36960,147,37107,33016,33163,225.59863945578232,0 1 2 7 8,-1
816,w0,100,3945,5,148,0,COMPLETED_WALLTIME_REACHED,36960,148,37108,33015,33163,224.07432432432432,9 10 12 13 14,-1
817,w0,100,3945,6,153,0,COMPLETED_WALLTIME_REACHED,37095,153,37248,33150,33303,217.66666666666666,3 4 5 6 11 15,-1
818,w0,100,3949,4,152,0,COMPLETED_WALLTIME_REACHED,37107,152,37259,33158,33310,219.14473684210526,0 1 2 7,-1
820,w0,100,3956,4,151,0,COMPLETED_WALLTIME_REACHED,37108,151,37259,33152,33303,220.5496688741722,8 9 10 12,-1
821,w0,100,3956,5,151,0,COMPLETED_WALLTIME_REACHED,37248,151,37399,33292,33443,221.47682119205297,3 4 5 6 11,-1
823,w0,100,3963,3,151,0,COMPLETED_WALLTIME_REACHED,37253,151,37404,33290,33441,221.46357615894038,13 14 15,-1
822,w0,100,3962,4,149,0,COMPLETED_WALLTIME_REACHED,37259,149,37408,33297,33446,224.46979865771812,0 1 2 7,-1
824,w0,100,3968,4,151,0,COMPLETED_WALLTIME_REACHED,37259,151,37410,33291,33442,221.47019867549668,8 9 10 12,-1
825,w0,100,3972,4,150,0,COMPLETED_WALLTIME_REACHED,37399,150,37549,33427,33577,223.84666666666666,3 4 5 6,-1
826,w0,100,3972,3,147,0,COMPLETED_WALLTIME_REACHED,37404,147,37551,33432,33579,228.42857142857142,11 13 14,-1
827,w0,100,3975,4,149,0,COMPLETED_WALLTIME_REACHED,37408,149,37557,33433,33582,225.38255033557047,0 1 2 7,-1
831,w0,100,4009,3,149,0,COMPLETED_WALLTIME_REACHED,37410,149,37559,33401,33550,225.16778523489933,8 9 10,-1
828,w0,100,3984,6,149,0,COMPLETED_WALLTIME_REACHED,37554,149,37703,33570,33719,226.3020134228188,3 4 5 6 12 15,-1
829,w0,100,3996,5,146,0,COMPLETED_WALLTIME_REACHED,37557,146,37703,33561,33707,230.86986301369862,0 1 2 7 11,-1
830,w0,100,4007,5,153,0,COMPLETED_WALLTIME_REACHED,37559,153,37712,33552,33705,220.2941176470588,8 9 10 13 14,-1
832,w0,100,4011,3,152,0,COMPLETED_WALLTIME_REACHED,37703,152,37855,33692,33844,222.6578947368421,0 1 2,-1
833,w0,100,4013,5,154,0,COMPLETED_WALLTIME_REACHED,37703,154,37857,33690,33844,219.76623376623377,3 4 5 6 7,-1
841,w0,100,4044,3,149,0,COMPLETED_WALLTIME_REACHED,37703,149,37852,33659,33808,226.8993288590604,11 12 15,-1
834,w0,100,4015,4,150,0,COMPLETED_WALLTIME_REACHED,37712,150,37862,33697,33847,225.64666666666668,8 9 10 13,-1
835,w0,100,4023,4,150,0,COMPLETED_WALLTIME_REACHED,37857,150,38007,33834,33984,226.56,11 12 14 15,-1
836,w0,100,4030,6,148,0,COMPLETED_WALLTIME_REACHED,37857,148,38005,33827,33975,229.5608108108108,0 1 2 3 4 5,-1
837,w0,100,4030,6,155,0,COMPLETED_WALLTIME_REACHED,37862,155,38017,33832,33987,219.2709677419355,6 7 8 9 10 13,-1
838,w0,100,4036,6,149,0,COMPLETED_WALLTIME_REACHED,38005,149,38154,33969,34118,228.9798657718121,0 1 2 3 4 5,-1
839,w0,100,4038,4,152,0,COMPLETED_WALLTIME_REACHED,38007,152,38159,33969,34121,224.48026315789474,11 12 14 15,-1
840,w0,100,4038,4,152,0,COMPLETED_WALLTIME_REACHED,38017,152,38169,33979,34131,224.54605263157896,6 7 8 9,-1
842,w0,100,4046,5,152,0,COMPLETED_WALLTIME_REACHED,38154,152,38306,34108,34260,225.39473684210526,0 1 2 3 4,-1
843,w0,100,4047,3,149,0,COMPLETED_WALLTIME_REACHED,38159,149,38308,34112,34261,229.93959731543623,5 10 13,-1
844,w0,100,4050,4,147,0,COMPLETED_WALLTIME_REACHED,38159,147,38306,34109,34256,233.03401360544217,11 12 14 15,-1
848,w0,100,4066,4,149,0,COMPLETED_WALLTIME_REACHED,38169,149,38318,34103,34252,229.8791946308725,6 7 8 9,-1
845,w0,100,4051,6,149,0,COMPLETED_WALLTIME_REACHED,38306,149,38455,34255,34404,230.8993288590604,0 1 2 3 4 11,-1
846,w0,100,4056,5,151,0,COMPLETED_WALLTIME_REACHED,38308,151,38459,34252,34403,227.83443708609272,5 10 12 13 14,-1
847,w0,100,4064,5,154,0,COMPLETED_WALLTIME_REACHED,38318,154,38472,34254,34408,223.42857142857142,6 7 8 9 15,-1
849,w0,100,4067,5,147,0,COMPLETED_WALLTIME_REACHED,38455,147,38602,34388,34535,234.93197278911563,0 1 2 3 4,-1
850,w0,100,4069,5,149,0,COMPLETED_WALLTIME_REACHED,38459,149,38608,34390,34539,231.80536912751677,5 10 11 12 13,-1
851,w0,100,4070,6,152,0,COMPLETED_WALLTIME_REACHED,38472,152,38624,34402,34554,227.32894736842104,6 7 8 9 14 15,-1
852,w0,100,4078,3,151,0,COMPLETED_WALLTIME_REACHED,38602,151,38753,34524,34675,229.63576158940398,0 1 2,-1
853,w0,100,4078,4,149,0,COMPLETED_WALLTIME_REACHED,38608,149,38757,34530,34679,232.74496644295303,3 4 5 10,-1
856,w0,100,4099,3,154,0,COMPLETED_WALLTIME_REACHED,38608,154,38762,34509,34663,225.08441558441558,11 12 13,-1
854,w0,100,4082,4,149,0,COMPLETED_WALLTIME_REACHED,38624,149,38773,34542,34691,232.8255033557047,6 7 8 9,-1
857,w0,100,4108,3,152,0,COMPLETED_WALLTIME_REACHED,38757,152,38909,34649,34801,228.95394736842104,3 4 5,-1
855,w0,100,4083,5,152,0,COMPLETED_WALLTIME_REACHED,38758,152,38910,34675,34827,229.125,0 1 2 14 15,-1
861,w0,100,4128,3,147,0,COMPLETED_WALLTIME_REACHED,38762,147,38909,34634,34781,236.60544217687075,10 11 12,-1
858,w0,100,4112,5,150,0,COMPLETED_WALLTIME_REACHED,38773,150,38923,34661,34811,232.07333333333332,6 7 8 9 13,-1
859,w0,100,4113,5,152,0,COMPLETED_WALLTIME_REACHED,38909,152,39061,34796,34948,229.92105263157896,3 4 5 10 11,-1
860,w0,100,4127,4,153,0,COMPLETED_WALLTIME_REACHED,38910,153,39063,34783,34936,228.33986928104576,0 1 2 12,-1
862,w0,100,4132,3,150,0,COMPLETED_WALLTIME_REACHED,38923,150,39073,34791,34941,232.94,6 7 8,-1
863,w0,100,4145,4,150,0,COMPLETED_WALLTIME_REACHED,38923,150,39073,34778,34928,232.85333333333332,9 13 14 15,-1
864,w0,100,4149,5,154,0,COMPLETED_WALLTIME_REACHED,39061,154,39215,34912,35066,227.7012987012987,3 4 5 10 11,-1
866,w0,100,4156,4,150,0,COMPLETED_WALLTIME_REACHED,39063,150,39213,34907,35057,233.71333333333334,0 1 2 12,-1
865,w0,100,4150,6,149,0,COMPLETED_WALLTIME_REACHED,39073,149,39222,34923,35072,235.38255033557047,6 7 8 9 13 14,-1
867,w0,100,4160,4,146,0,COMPLETED_WALLTIME_REACHED,39213,146,39359,35053,35199,241.08904109589042,0 1 2 12,-1
868,w0,100,4161,5,149,0,COMPLETED_WALLTIME_REACHED,39215,149,39364,35054,35203,236.26174496644296,3 4 5 10 11,-1
869,w0,100,4161,4,149,0,COMPLETED_WALLTIME_REACHED,39222,149,39371,35061,35210,236.30872483221478,6 7 8 9,-1
882,w0,100,4238,3,148,0,COMPLETED_WALLTIME_REACHED,39227,148,39375,34989,35137,237.41216216216216,13 14 15,-1
870,w0,100,4168,4,153,0,COMPLETED_WALLTIME_REACHED,39359,153,39512,35191,35344,231.00653594771242,0 1 2 12,-1
871,w0,100,4180,5,152,0,COMPLETED_WALLTIME_REACHED,39364,152,39516,35184,35336,232.47368421052633,3 4 5 10 11,-1
872,w0,100,4191,6,148,0,COMPLETED_WALLTIME_REACHED,39375,148,39523,35184,35332,238.72972972972974,6 7 8 9 13 14,-1
874,w0,100,4197,4,148,0,COMPLETED_WALLTIME_REACHED,39512,148,39660,35315,35463,239.61486486486487,0 1 2 12,-1
873,w0,100,4196,6,146,0,COMPLETED_WALLTIME_REACHED,39521,146,39667,35325,35471,242.95205479452054,3 4 5 10 11 15,-1
875,w0,100,4204,4,152,0,COMPLETED_WALLTIME_REACHED,39523,152,39675,35319,35471,233.36184210526315,6 7 8 9,-1
876,w0,100,4208,4,152,0,COMPLETED_WALLTIME_REACHED,39660,152,39812,35452,35604,234.23684210526315,0 1 2 12,-1
877,w0,100,4215,4,151,0,COMPLETED_WALLTIME_REACHED,39667,151,39818,35452,35603,235.7814569536424,3 4 5 10,-1
878,w0,100,4222,4,148,0,COMPLETED_WALLTIME_REACHED,39672,148,39820,35450,35598,240.52702702702703,11 13 14 15,-1
879,w0,100,4225,4,150,0,COMPLETED_WALLTIME_REACHED,39675,150,39825,35450,35600,237.33333333333334,6 7 8 9,-1
889,w0,100,4266,3,151,0,COMPLETED_WALLTIME_REACHED,39812,151,39963,35546,35697,236.40397350993376,0 1 2,-1
880,w0,100,4236,5,151,0,COMPLETED_WALLTIME_REACHED,39818,151,39969,35582,35733,236.64238410596028,3 4 5 10 12,-1
881,w0,100,4237,4,150,0,COMPLETED_WALLTIME_REACHED,39820,150,39970,35583,35733,238.22,11 13 14 15,-1
883,w0,100,4239,5,147,0,COMPLETED_WALLTIME_REACHED,39968,147,40115,35729,35876,244.05442176870747,0 1 2 6 7,-1
885,w0,100,4248,4,148,0,COMPLETED_WALLTIME_REACHED,39970,148,40118,35722,35870,242.36486486486487,10 11 12 13,-1
884,w0,100,4248,5,151,0,COMPLETED_WALLTIME_REACHED,39974,151,40125,35726,35877,237.59602649006624,3 4 5 8 9,-1
887,w0,100,4251,4,153,0,COMPLETED_WALLTIME_REACHED,40118,153,40271,35867,36020,235.4248366013072,10 11 12 13,-1
886,w0,100,4250,6,151,0,COMPLETED_WALLTIME_REACHED,40120,151,40271,35870,36021,238.5496688741722,0 1 2 6 7 14,-1
888,w0,100,4256,5,151,0,COMPLETED_WALLTIME_REACHED,40125,151,40276,35869,36020,238.5430463576159,3 4 5 8 9,-1
890,w0,100,4266,5,152,0,COMPLETED_WALLTIME_REACHED,40271,152,40423,36005,36157,237.875,0 1 2 6 7,-1
891,w0,100,4272,5,152,0,COMPLETED_WALLTIME_REACHED,40271,152,40423,35999,36151,237.83552631578948,10 11 12 13 14,-1
892,w0,100,4302,5,152,0,COMPLETED_WALLTIME_REACHED,40276,152,40428,35974,36126,237.67105263157896,3 4 5 8 9,-1
893,w0,100,4311,4,150,0,COMPLETED_WALLTIME_REACHED,40423,150,40573,36112,36262,241.74666666666667,0 1 2 6,-1
894,w0,100,4315,5,151,0,COMPLETED_WALLTIME_REACHED,40423,151,40574,36108,36259,240.12582781456953,7 10 11 12 13,-1
896,w0,100,4318,3,154,0,COMPLETED_WALLTIME_REACHED,40428,154,40582,36110,36264,235.4805194805195,3 4 5,-1
897,w0,100,4322,3,146,0,COMPLETED_WALLTIME_REACHED,40428,146,40574,36106,36252,248.3013698630137,8 9 14,-1
898,w0,100,4333,3,148,0,COMPLETED_WALLTIME_REACHED,40573,148,40721,36240,36388,245.86486486486487,0 1 2,-1
899,w0,100,4333,5,149,0,COMPLETED_WALLTIME_REACHED,40574,149,40723,36241,36390,244.2281879194631,6 7 8 9 10,-1
900,w0,100,4335,5,150,0,COMPLETED_WALLTIME_REACHED,40579,150,40729,36244,36394,242.62666666666667,11 12 13 14 15,-1
901,w0,100,4335,5,151,0,COMPLETED_WALLTIME_REACHED,40726,151,40877,36391,36542,242.0,0 1 2 3 4,-1
902,w0,100,4338,4,144,0,COMPLETED_WALLTIME_REACHED,40728,144,40872,36390,36534,253.70833333333334,5 6 7 8,-1
903,w0,100,4341,5,153,0,COMPLETED_WALLTIME_REACHED,40729,153,40882,36388,36541,238.83006535947712,9 10 11 12 13,-1
904,w0,100,4347,6,151,0,COMPLETED_WALLTIME_REACHED,40877,151,41028,36530,36681,242.9205298013245,5 6 7 8 14 15,-1
905,w0,100,4352,5,149,0,COMPLETED_WALLTIME_REACHED,40877,149,41026,36525,36674,246.13422818791946,0 1 2 3 4,-1
906,w0,100,4353,5,150,0,COMPLETED_WALLTIME_REACHED,40882,150,41032,36529,36679,244.52666666666667,9 10 11 12 13,-1
907,w0,100,4356,5,150,0,COMPLETED_WALLTIME_REACHED,41026,150,41176,36670,36820,245.46666666666667,0 1 2 3 4,-1
908,w0,100,4358,5,150,0,COMPLETED_WALLTIME_REACHED,41028,150,41178,36670,36820,245.46666666666667,5 6 7 8 14,-1
909,w0,100,4365,3,147,0,COMPLETED_WALLTIME_REACHED,41032,147,41179,36667,36814,250.43537414965985,9 10 11,-1
910,w0,100,4366,3,150,0,COMPLETED_WALLTIME_REACHED,41032,150,41182,36666,36816,245.44,12 13 15,-1
911,w0,100,4368,4,152,0,COMPLETED_WALLTIME_REACHED,41176,152,41328,36808,36960,243.1578947368421,0 1 2 3,-1
912,w0,100,4371,6,152,0,COMPLETED_WALLTIME_REACHED,41178,152,41330,36807,36959,243.15131578947367,4 5 6 7 8 14,-1
913,w0,100,4379,4,154,0,COMPLETED_WALLTIME_REACHED,41182,154,41336,36803,36957,239.9805194805195,9 10 11 12,-1
915,w0,100,4389,5,154,0,COMPLETED_WALLTIME_REACHED,41330,154,41484,36941,37095,240.87662337662337,4 5 6 7 8,-1
914,w0,100,4382,6,150,0,COMPLETED_WALLTIME_REACHED,41333,150,41483,36951,37101,247.34,0 1 2 3 13 15,-1
916,w0,100,4392,3,152,0,COMPLETED_WALLTIME_REACHED,41336,152,41488,36944,37096,244.05263157894737,9 10 11,-1
918,w0,100,4397,4,151,0,COMPLETED_WALLTIME_REACHED,41484,151,41635,37087,37238,246.60927152317882,4 5 6 7,-1
917,w0,100,4396,5,150,0,COMPLETED_WALLTIME_REACHED,41488,150,41638,37092,37242,248.28,0 1 2 3 12,-1
919,w0,100,4402,3,152,0,COMPLETED_WALLTIME_REACHED,41488,152,41640,37086,37238,244.98684210526315,13 14 15,-1
960,w0,100,4715,4,147,0,COMPLETED_WALLTIME_REACHED,41488,147,41635,36773,36920,251.156462585034,8 9 10 11,-1
920,w0,100,4402,7,150,0,COMPLETED_WALLTIME_REACHED,41635,150,41785,37233,37383,249.22,4 5 6 7 8 9 10,-1
921,w0,100,4402,4,149,0,COMPLETED_WALLTIME_REACHED,41638,149,41787,37236,37385,250.90604026845637,0 1 2 3,-1
922,w0,100,4404,3,149,0,COMPLETED_WALLTIME_REACHED,41640,149,41789,37236,37385,250.90604026845637,11 12 13,-1
923,w0,100,4408,5,151,0,COMPLETED_WALLTIME_REACHED,41785,151,41936,37377,37528,248.52980132450332,4 5 6 7 8,-1
925,w0,100,4419,4,153,0,COMPLETED_WALLTIME_REACHED,41787,153,41940,37368,37521,245.23529411764707,0 1 2 3,-1
924,w0,100,4416,3,151,0,COMPLETED_WALLTIME_REACHED,41790,151,41941,37374,37525,248.50993377483445,9 10 14,-1
926,w0,100,4424,4,149,0,COMPLETED_WALLTIME_REACHED,41794,149,41943,37370,37519,251.80536912751677,11 12 13 15,-1
927,w0,100,4428,4,151,0,COMPLETED_WALLTIME_REACHED,41936,151,42087,37508,37659,249.39735099337747,4 5 6 7,-1
928,w0,100,4431,5,152,0,COMPLETED_WALLTIME_REACHED,41940,152,42092,37509,37661,247.76973684210526,0 1 2 3 8,-1
929,w0,100,4433,5,151,0,COMPLETED_WALLTIME_REACHED,41943,151,42094,37510,37661,249.41059602649005,9 10 11 12 13,-1
930,w0,100,4443,4,150,0,COMPLETED_WALLTIME_REACHED,42087,150,42237,37644,37794,251.96,4 5 6 7,-1
931,w0,100,4458,5,148,0,COMPLETED_WALLTIME_REACHED,42092,148,42240,37634,37782,255.28378378378378,0 1 2 3 8,-1
932,w0,100,4472,5,151,0,COMPLETED_WALLTIME_REACHED,42094,151,42245,37622,37773,250.1523178807947,9 10 11 12 13,-1
935,w0,100,4490,5,151,0,COMPLETED_WALLTIME_REACHED,42240,151,42391,37750,37901,251.0,0 1 2 3 8,-1
933,w0,100,4474,5,150,0,COMPLETED_WALLTIME_REACHED,42242,150,42392,37768,37918,252.78666666666666,4 5 6 7 14,-1
936,w0,100,4500,5,148,0,COMPLETED_WALLTIME_REACHED,42245,148,42393,37745,37893,256.0337837837838,9 10 11 12 13,-1
938,w0,100,4513,5,151,0,COMPLETED_WALLTIME_REACHED,42392,151,42543,37879,38030,251.8543046357616,4 5 6 7 14,-1
939,w0,100,4523,4,150,0,COMPLETED_WALLTIME_REACHED,42393,150,42543,37870,38020,253.46666666666667,9 10 11 12,-1
937,w0,100,4509,6,150,0,COMPLETED_WALLTIME_REACHED,42396,150,42546,37887,38037,253.58,0 1 2 3 8 15,-1
940,w0,100,4528,3,151,0,COMPLETED_WALLTIME_REACHED,42543,151,42694,38015,38166,252.75496688741723,4 5 6,-1
942,w0,100,4539,5,149,0,COMPLETED_WALLTIME_REACHED,42546,149,42695,38007,38156,256.08053691275165,0 1 2 3 8,-1
941,w0,100,4533,7,149,0,COMPLETED_WALLTIME_REACHED,42548,149,42697,38015,38164,256.13422818791946,7 9 10 11 12 13 14,-1
947,w0,100,4592,3,149,0,COMPLETED_WALLTIME_REACHED,42694,149,42843,38102,38251,256.71812080536915,4 5 6,-1
944,w0,100,4562,5,149,0,COMPLETED_WALLTIME_REACHED,42697,149,42846,38135,38284,256.93959731543623,7 9 10 11 12,-1
943,w0,100,4552,6,148,0,COMPLETED_WALLTIME_REACHED,42700,148,42848,38148,38296,258.7567567567568,0 1 2 3 8 15,-1
945,w0,100,4570,4,149,0,COMPLETED_WALLTIME_REACHED,42848,149,42997,38278,38427,257.8993288590604,4 5 6 13,-1
948,w0,100,4599,5,153,0,COMPLETED_WALLTIME_REACHED,42848,153,43001,38249,38402,250.99346405228758,0 1 2 3 8,-1
946,w0,100,4573,6,151,0,COMPLETED_WALLTIME_REACHED,42851,151,43002,38278,38429,254.49668874172184,7 9 10 11 12 14,-1
950,w0,100,4618,3,155,0,COMPLETED_WALLTIME_REACHED,43001,155,43156,38383,38538,248.63225806451612,0 1 2,-1
949,w0,100,4610,5,149,0,COMPLETED_WALLTIME_REACHED,43002,149,43151,38392,38541,258.66442953020135,4 5 6 13 15,-1
951,w0,100,4623,6,147,0,COMPLETED_WALLTIME_REACHED,43002,147,43149,38379,38526,262.0816326530612,3 7 8 9 10 11,-1
952,w0,100,4633,5,154,0,COMPLETED_WALLTIME_REACHED,43149,154,43303,38516,38670,251.1038961038961,3 7 8 9 10,-1
953,w0,100,4634,4,150,0,COMPLETED_WALLTIME_REACHED,43151,150,43301,38517,38667,257.78,4 5 6 13,-1
965,w0,100,4741,3,152,0,COMPLETED_WALLTIME_REACHED,43154,152,43306,38413,38565,253.7171052631579,11 12 14,-1
967,w0,100,4756,3,149,0,COMPLETED_WALLTIME_REACHED,43156,149,43305,38400,38549,258.71812080536915,0 1 2,-1
955,w0,100,4645,4,149,0,COMPLETED_WALLTIME_REACHED,43303,149,43452,38658,38807,260.4496644295302,3 7 8 9,-1
956,w0,100,4651,4,150,0,COMPLETED_WALLTIME_REACHED,43305,150,43455,38654,38804,258.6933333333333,0 1 2 10,-1
954,w0,100,4636,5,150,0,COMPLETED_WALLTIME_REACHED,43306,150,43456,38670,38820,258.8,4 5 6 13 15,-1
983,w0,100,4820,3,144,0,COMPLETED_WALLTIME_REACHED,43306,144,43450,38486,38630,268.2638888888889,11 12 14,-1
957,w0,100,4670,6,152,0,COMPLETED_WALLTIME_REACHED,43452,152,43604,38782,38934,256.14473684210526,3 7 8 9 11 12,-1
958,w0,100,4696,5,150,0,COMPLETED_WALLTIME_REACHED,43455,150,43605,38759,38909,259.3933333333333,0 1 2 10 14,-1
959,w0,100,4697,4,152,0,COMPLETED_WALLTIME_REACHED,43456,152,43608,38759,38911,255.9934210526316,4 5 6 13,-1
961,w0,100,4725,5,149,0,COMPLETED_WALLTIME_REACHED,43604,149,43753,38879,39028,261.93288590604027,3 7 8 9 11,-1
962,w0,100,4730,5,154,0,COMPLETED_WALLTIME_REACHED,43605,154,43759,38875,39029,253.43506493506493,0 1 2 10 12,-1
963,w0,100,4737,4,148,0,COMPLETED_WALLTIME_REACHED,43608,148,43756,38871,39019,263.6418918918919,4 5 6 13,-1
964,w0,100,4738,4,153,0,COMPLETED_WALLTIME_REACHED,43753,153,43906,39015,39168,256.0,3 7 8 9,-1
966,w0,100,4749,5,150,0,COMPLETED_WALLTIME_REACHED,43756,150,43906,39007,39157,261.0466666666667,4 5 6 11 13,-1
968,w0,100,4769,5,146,0,COMPLETED_WALLTIME_REACHED,43759,146,43905,38990,39136,268.05479452054794,0 1 2 10 12,-1
969,w0,100,4779,3,148,0,COMPLETED_WALLTIME_REACHED,43905,148,44053,39126,39274,265.36486486486484,0 1 2,-1
971,w0,100,4784,3,148,0,COMPLETED_WALLTIME_REACHED,43906,148,44054,39122,39270,265.3378378378378,3 4 5,-1
972,w0,100,4786,4,149,0,COMPLETED_WALLTIME_REACHED,43906,149,44055,39120,39269,263.5503355704698,6 7 8 9,-1
970,w0,100,4782,4,153,0,COMPLETED_WALLTIME_REACHED,43910,153,44063,39128,39281,256.73856209150324,10 12 14 15,-1
977,w0,100,4796,3,151,0,COMPLETED_WALLTIME_REACHED,44054,151,44205,39258,39409,260.9867549668874,3 4 5,-1
973,w0,100,4793,4,148,0,COMPLETED_WALLTIME_REACHED,44058,148,44206,39265,39413,266.30405405405406,0 1 2 11,-1
974,w0,100,4793,5,149,0,COMPLETED_WALLTIME_REACHED,44060,149,44209,39267,39416,264.53691275167785,6 7 8 9 13,-1
975,w0,100,4793,4,147,0,COMPLETED_WALLTIME_REACHED,44063,147,44210,39270,39417,268.14285714285717,10 12 14 15,-1
976,w0,100,4795,5,153,0,COMPLETED_WALLTIME_REACHED,44206,153,44359,39411,39564,258.5882352941176,0 1 2 3 4,-1
978,w0,100,4797,6,151,0,COMPLETED_WALLTIME_REACHED,44209,151,44360,39412,39563,262.0066225165563,5 6 7 8 9 11,-1
980,w0,100,4800,5,148,0,COMPLETED_WALLTIME_REACHED,44210,148,44358,39410,39558,267.2837837837838,10 12 13 14 15,-1
981,w0,100,4808,4,151,0,COMPLETED_WALLTIME_REACHED,44358,151,44509,39550,39701,262.9205298013245,10 12 13 14,-1
979,w0,100,4800,6,151,0,COMPLETED_WALLTIME_REACHED,44359,151,44510,39559,39710,262.9801324503311,0 1 2 3 4 15,-1
982,w0,100,4815,5,149,0,COMPLETED_WALLTIME_REACHED,44360,149,44509,39545,39694,266.4026845637584,5 6 7 8 9,-1
984,w0,100,4821,3,149,0,COMPLETED_WALLTIME_REACHED,44509,149,44658,39688,39837,267.36241610738256,5 6 7,-1
985,w0,100,4823,3,150,0,COMPLETED_WALLTIME_REACHED,44509,150,44659,39686,39836,265.5733333333333,8 9 10,-1
986,w0,100,4823,5,155,0,COMPLETED_WALLTIME_REACHED,44510,155,44665,39687,39842,257.0451612903226,0 1 2 3 4,-1
987,w0,100,4824,3,152,0,COMPLETED_WALLTIME_REACHED,44514,152,44666,39690,39842,262.11842105263156,11 12 13,-1
988,w0,100,4840,5,149,0,COMPLETED_WALLTIME_REACHED,44663,149,44812,39823,39972,268.2684563758389,5 6 7 14 15,-1
989,w0,100,4844,5,150,0,COMPLETED_WALLTIME_REACHED,44665,150,44815,39821,39971,266.47333333333336,0 1 2 3 4,-1
990,w0,100,4858,4,151,0,COMPLETED_WALLTIME_REACHED,44666,151,44817,39808,39959,264.6291390728477,8 9 10 11,-1
992,w0,100,4861,5,150,0,COMPLETED_WALLTIME_REACHED,44815,150,44965,39954,40104,267.36,0 1 2 3 4,-1
991,w0,100,4860,4,151,0,COMPLETED_WALLTIME_REACHED,44817,151,44968,39957,40108,265.6158940397351,5 6 7 12,-1
994,w0,100,4866,5,153,0,COMPLETED_WALLTIME_REACHED,44822,153,44975,39956,40109,262.1503267973856,8 9 10 11 13,-1
995,w0,100,4866,5,150,0,COMPLETED_WALLTIME_REACHED,44965,150,45115,40099,40249,268.32666666666665,0 1 2 3 4,-1
996,w0,100,4890,4,155,0,COMPLETED_WALLTIME_REACHED,44968,155,45123,40078,40233,259.56774193548387,5 6 7 12,-1
997,w0,100,4893,4,152,0,COMPLETED_WALLTIME_REACHED,44975,152,45127,40082,40234,264.69736842105266,8 9 10 11,-1
998,w0,100,4920,4,152,0,COMPLETED_WALLTIME_REACHED,45115,152,45267,40195,40347,265.4407894736842,0 1 2 3,-1
999,w0,100,4931,6,148,0,COMPLETED_WALLTIME_REACHED,45128,148,45276,40197,40345,272.60135135135135,4 5 6 7 12 13,-1
1000,w0,100,4932,5,150,0,COMPLETED_WALLTIME_REACHED,45132,150,45282,40200,40350,269.0,8 9 10 11 14,-1
