job_id,workload_name,profile,submission_time,requested_number_of_resources,requested_time,success,final_state,starting_time,execution_time,finish_time,waiting_time,turnaround_time,stretch,allocated_resources,consumed_energy
1,w0,100,49,2,49,0,COMPLETED_WALLTIME_REACHED,54,49,103,5,54,1.1020408163265305,0 1,-1
2,w0,100,50,3,51,0,COMPLETED_WALLTIME_REACHED,108,51,159,58,109,2.1372549019607843,0 1 2,-1
6,w0,100,108,1,51,0,COMPLETED_WALLTIME_REACHED,113,51,164,5,56,1.0980392156862746,3,-1
3,w0,100,52,2,50,0,COMPLETED_WALLTIME_REACHED,159,50,209,107,157,3.14,0 1,-1
9,w0,100,162,1,51,0,COMPLETED_WALLTIME_REACHED,162,51,213,0,51,1.0,2,-1
4,w0,100,85,3,52,0,COMPLETED_WALLTIME_REACHED,214,52,266,129,181,3.480769230769231,0 1 3,-1
5,w0,100,87,3,53,0,COMPLETED_WALLTIME_REACHED,271,53,324,184,237,4.471698113207547,0 1 2,-1
7,w0,100,134,2,52,0,COMPLETED_WALLTIME_REACHED,324,52,376,190,242,4.653846153846154,0 1,-1
8,w0,100,139,3,49,0,COMPLETED_WALLTIME_REACHED,381,49,430,242,291,5.938775510204081,0 1 2,-1
10,w0,100,168,3,48,0,COMPLETED_WALLTIME_REACHED,430,48,478,262,310,6.458333333333333,0 1 2,-1
